決算年度,業務コード,団体コード ,県名,団体名,団体区分,表番号,表名称,行番号,行名称,001:歳入総額,002:歳出総額,003:歳入歳出差引,004:翌年度に繰り越すべき財源,005:実質収支,006:単年度収支,007:積立金,008:繰上償還金,009:積立金取崩し額,010:実質単年度収支
2022,61,11002,北海道,札幌市,1,2,決算収支の状況,1,令和4年度,1227839677,1215838738,12000939,4179589,7821350,-2140318,534,0,3200000,-5339784
2022,61,12025,北海道,函館市,8,2,決算収支の状況,1,令和4年度,150163194,146551705,3611489,374120,3237369,92751,1561865,0,1000000,654616
2022,61,12033,北海道,小樽市,3,2,決算収支の状況,1,令和4年度,66320792,64823425,1497367,52844,1444523,-280327,847602,0,0,567275
2022,61,12041,北海道,旭川市,8,2,決算収支の状況,1,令和4年度,192603474,188381368,4222106,337105,3885001,-2624611,13068,0,0,-2611543
2022,61,12050,北海道,室蘭市,4,2,決算収支の状況,1,令和4年度,47139489,46144771,994718,31360,963358,84580,155060,0,0,239640
2022,61,12068,北海道,釧路市,3,2,決算収支の状況,1,令和4年度,101629191,99630262,1998929,27942,1970987,-2296856,594,0,0,-2296262
2022,61,12076,北海道,帯広市,3,2,決算収支の状況,1,令和4年度,91151075,89097684,2053391,39612,2013779,-242532,1229457,0,0,986925
2022,61,12084,北海道,北見市,3,2,決算収支の状況,1,令和4年度,78459451,76923679,1535772,50213,1485559,476560,27,0,0,476587
2022,61,12092,北海道,夕張市,4,2,決算収支の状況,1,令和4年度,13570482,13239601,330881,3683,327198,-318385,322828,0,0,4443
2022,61,12106,北海道,岩見沢市,4,2,決算収支の状況,1,令和4年度,49897096,49378412,518684,145125,373559,-24921,199351,12000,200000,-13570
2022,61,12114,北海道,網走市,4,2,決算収支の状況,1,令和4年度,27440345,27253830,186515,92095,94420,-28691,3201,0,0,-25490
2022,61,12122,北海道,留萌市,4,2,決算収支の状況,1,令和4年度,16249208,15764347,484861,14866,469995,-102474,311277,0,0,208803
2022,61,12131,北海道,苫小牧市,3,2,決算収支の状況,1,令和4年度,85930720,84213211,1717509,122247,1595262,-344681,1354672,0,1085910,-75919
2022,61,12149,北海道,稚内市,4,2,決算収支の状況,1,令和4年度,29563644,29188834,374810,104032,270778,22639,124084,0,0,146723
2022,61,12157,北海道,美唄市,4,2,決算収支の状況,1,令和4年度,19531985,19107822,424163,24204,399959,64135,168448,0,0,232583
2022,61,12165,北海道,芦別市,4,2,決算収支の状況,1,令和4年度,12653233,12428853,224380,0,224380,-97599,55230,0,0,-42369
2022,61,12173,北海道,江別市,3,2,決算収支の状況,1,令和4年度,54640855,53269100,1371755,75567,1296188,-223844,778565,0,2951,551770
2022,61,12181,北海道,赤平市,4,2,決算収支の状況,1,令和4年度,11569581,11125146,444435,900,443535,-118443,1767,0,150000,-266676
2022,61,12190,北海道,紋別市,4,2,決算収支の状況,1,令和4年度,43952845,43786396,166449,56744,109705,-526266,322053,0,250000,-454213
2022,61,12203,北海道,士別市,4,2,決算収支の状況,1,令和4年度,17770164,17339012,431152,5571,425581,-273037,90127,0,0,-182910
2022,61,12211,北海道,名寄市,4,2,決算収支の状況,1,令和4年度,25059418,24702214,357204,6965,350239,-111816,1875,0,125643,-235584
2022,61,12220,北海道,三笠市,4,2,決算収支の状況,1,令和4年度,14186929,13984612,202317,12940,189377,6404,626876,0,546153,87127
2022,61,12238,北海道,根室市,4,2,決算収支の状況,1,令和4年度,49047033,48070865,976168,11561,964607,-164799,560022,0,0,395223
2022,61,12246,北海道,千歳市,4,2,決算収支の状況,1,令和4年度,54887118,53231337,1655781,913208,742573,291374,10073,0,100000,201447
2022,61,12254,北海道,滝川市,4,2,決算収支の状況,1,令和4年度,24581322,23307845,1273477,5981,1267496,155091,106297,0,0,261388
2022,61,12262,北海道,砂川市,4,2,決算収支の状況,1,令和4年度,16254109,15689417,564692,3862,560830,-251726,485295,0,0,233569
2022,61,12271,北海道,歌志内市,4,2,決算収支の状況,1,令和4年度,5209696,5041985,167711,93,167618,-152558,0,0,0,-152558
2022,61,12289,北海道,深川市,4,2,決算収支の状況,1,令和4年度,20045616,19912306,133310,10175,123135,-321409,58426,0,0,-262983
2022,61,12297,北海道,富良野市,4,2,決算収支の状況,1,令和4年度,17140036,16931913,208123,50653,157470,-135315,38,53467,0,-81810
2022,61,12301,北海道,登別市,4,2,決算収支の状況,1,令和4年度,24985416,24201212,784204,45560,738644,-115254,6984,0,0,-108270
2022,61,12319,北海道,恵庭市,4,2,決算収支の状況,1,令和4年度,37443152,36269507,1173645,13407,1160238,-458415,74,0,42382,-500723
2022,61,12335,北海道,伊達市,4,2,決算収支の状況,1,令和4年度,23070724,22137988,932736,294496,638240,-507101,254,0,0,-506847
2022,61,12343,北海道,北広島市,4,2,決算収支の状況,1,令和4年度,32026040,31420878,605162,283650,321512,-301043,600020,0,0,298977
2022,61,12351,北海道,石狩市,4,2,決算収支の状況,1,令和4年度,35743012,34398138,1344874,128165,1216709,593416,16,0,0,593432
2022,61,12360,北海道,北斗市,4,2,決算収支の状況,1,令和4年度,23870944,23222589,648355,52411,595944,46089,118,0,198607,-152400
2022,61,13030,北海道,当別町,5,2,決算収支の状況,1,令和4年度,15137000,14848364,288636,2201,286435,-124180,88360,0,88345,-124165
2022,61,13048,北海道,新篠津村,5,2,決算収支の状況,1,令和4年度,4393441,4307590,85851,0,85851,7932,44058,0,40000,11990
2022,61,13315,北海道,松前町,5,2,決算収支の状況,1,令和4年度,6346441,5961609,384832,6561,378271,-178310,21,0,0,-178289
2022,61,13323,北海道,福島町,5,2,決算収支の状況,1,令和4年度,5003406,4876016,127390,19958,107432,10358,50127,0,0,60485
2022,61,13331,北海道,知内町,5,2,決算収支の状況,1,令和4年度,4937281,4776137,161144,5104,156040,-34192,184845,0,0,150653
2022,61,13340,北海道,木古内町,5,2,決算収支の状況,1,令和4年度,4850430,4550627,299803,25228,274575,-5992,13468,0,0,7476
2022,61,13374,北海道,七飯町,5,2,決算収支の状況,1,令和4年度,13197007,12861309,335698,7528,328170,-50800,192000,122941,48000,216141
2022,61,13439,北海道,鹿部町,5,2,決算収支の状況,1,令和4年度,4620904,4518938,101966,4600,97366,46554,10159,0,0,56713
2022,61,13455,北海道,森町,5,2,決算収支の状況,1,令和4年度,14591151,14302004,289147,183725,105422,23059,418,0,0,23477
2022,61,13463,北海道,八雲町,5,2,決算収支の状況,1,令和4年度,16371046,15822256,548790,50888,497902,230844,0,0,250000,-19156
2022,61,13471,北海道,長万部町,5,2,決算収支の状況,1,令和4年度,7124038,6927094,196944,30582,166362,8099,384230,0,561000,-168671
2022,61,13617,北海道,江差町,5,2,決算収支の状況,1,令和4年度,6371485,6104137,267348,25690,241658,66711,82,0,30000,36793
2022,61,13625,北海道,上ノ国町,5,2,決算収支の状況,1,令和4年度,6353601,6248319,105282,7764,97518,-8406,431561,0,500000,-76845
2022,61,13633,北海道,厚沢部町,5,2,決算収支の状況,1,令和4年度,5517592,5405971,111621,33600,78021,-1072,283054,0,150000,131982
2022,61,13641,北海道,乙部町,5,2,決算収支の状況,1,令和4年度,4923534,4824341,99193,1000,98193,-5477,15764,0,12912,-2625
2022,61,13676,北海道,奥尻町,5,2,決算収支の状況,1,令和4年度,5268298,5113676,154622,50,154572,6314,73525,0,300,79539
2022,61,13706,北海道,今金町,5,2,決算収支の状況,1,令和4年度,8128242,7910287,217955,197010,20945,-19538,2166,0,13032,-30404
2022,61,13714,北海道,せたな町,5,2,決算収支の状況,1,令和4年度,9701603,9386182,315421,35616,279805,-82663,1169,0,233882,-315376
2022,61,13919,北海道,島牧村,5,2,決算収支の状況,1,令和4年度,2878601,2787803,90798,0,90798,-2165,18,0,177204,-179351
2022,61,13927,北海道,寿都町,5,2,決算収支の状況,1,令和4年度,7158234,7107194,51040,0,51040,-153,2,0,0,-151
2022,61,13935,北海道,黒松内町,5,2,決算収支の状況,1,令和4年度,5175666,4926867,248799,27787,221012,76392,111020,0,128783,58629
2022,61,13943,北海道,蘭越町,5,2,決算収支の状況,1,令和4年度,7679669,7250532,429137,60698,368439,20507,201003,0,150000,71510
2022,61,13951,北海道,ニセコ町,5,2,決算収支の状況,1,令和4年度,5632108,5443632,188476,916,187560,2963,5,0,0,2968
2022,61,13960,北海道,真狩村,5,2,決算収支の状況,1,令和4年度,2826137,2733482,92655,1895,90760,17525,20000,0,30000,7525
2022,61,13978,北海道,留寿都村,5,2,決算収支の状況,1,令和4年度,3213001,3075613,137388,169,137219,27958,7221,0,0,35179
2022,61,13986,北海道,喜茂別町,5,2,決算収支の状況,1,令和4年度,3055732,3012249,43483,0,43483,-17048,33789,0,0,16741
2022,61,13994,北海道,京極町,5,2,決算収支の状況,1,令和4年度,4650114,4400780,249334,3452,245882,53414,73,0,100000,-46513
2022,61,14001,北海道,倶知安町,5,2,決算収支の状況,1,令和4年度,11826735,11366251,460484,37570,422914,59608,353450,0,350000,63058
2022,61,14010,北海道,共和町,5,2,決算収支の状況,1,令和4年度,7367410,7226731,140679,9129,131550,11924,1021,0,103142,-90197
2022,61,14028,北海道,岩内町,5,2,決算収支の状況,1,令和4年度,9567729,8958269,609460,974,608486,-2802,300182,0,0,297380
2022,61,14036,北海道,泊村,5,2,決算収支の状況,1,令和4年度,5005831,4966866,38965,0,38965,3284,114150,0,0,117434
2022,61,14044,北海道,神恵内村,5,2,決算収支の状況,1,令和4年度,3666189,3303045,363144,17160,345984,187739,40000,0,161620,66119
2022,61,14052,北海道,積丹町,5,2,決算収支の状況,1,令和4年度,3339046,3198511,140535,15125,125410,-23858,6,0,0,-23852
2022,61,14061,北海道,古平町,5,2,決算収支の状況,1,令和4年度,4276965,4066003,210962,9466,201496,60644,153240,0,0,213884
2022,61,14079,北海道,仁木町,5,2,決算収支の状況,1,令和4年度,4753630,4728690,24940,0,24940,-21569,106,0,0,-21463
2022,61,14087,北海道,余市町,5,2,決算収支の状況,1,令和4年度,11615538,11224280,391258,8602,382656,-106998,5,326706,40000,179713
2022,61,14095,北海道,赤井川村,5,2,決算収支の状況,1,令和4年度,2796527,2708329,88198,7252,80946,-52598,2,0,0,-52596
2022,61,14231,北海道,南幌町,5,2,決算収支の状況,1,令和4年度,8245066,8119396,125670,0,125670,-26356,76029,0,17984,31689
2022,61,14249,北海道,奈井江町,5,2,決算収支の状況,1,令和4年度,5811702,5664608,147094,0,147094,1354,156511,0,0,157865
2022,61,14257,北海道,上砂川町,5,2,決算収支の状況,1,令和4年度,3465047,3349777,115270,0,115270,21893,35,0,0,21928
2022,61,14273,北海道,由仁町,5,2,決算収支の状況,1,令和4年度,5863937,5762871,101066,11257,89809,17770,162416,0,0,180186
2022,61,14281,北海道,長沼町,5,2,決算収支の状況,1,令和4年度,9303098,9240524,62574,16717,45857,-215,134282,0,813,133254
2022,61,14290,北海道,栗山町,5,2,決算収支の状況,1,令和4年度,10896748,10570203,326545,207,326338,15033,400858,0,0,415891
2022,61,14303,北海道,月形町,5,2,決算収支の状況,1,令和4年度,4440370,4344343,96027,2006,94021,2346,43,0,0,2389
2022,61,14311,北海道,浦臼町,5,2,決算収支の状況,1,令和4年度,4061163,3770508,290655,196994,93661,-161217,453,86907,158750,-232607
2022,61,14320,北海道,新十津川町,5,2,決算収支の状況,1,令和4年度,8097452,7689528,407924,43952,363972,-25014,948,154800,180000,-49266
2022,61,14338,北海道,妹背牛町,5,2,決算収支の状況,1,令和4年度,4067432,4008808,58624,0,58624,-591,40121,0,0,39530
2022,61,14346,北海道,秩父別町,5,2,決算収支の状況,1,令和4年度,4118075,4062780,55295,14541,40754,-68106,518,96908,50000,-20680
2022,61,14362,北海道,雨竜町,5,2,決算収支の状況,1,令和4年度,4010580,3900639,109941,940,109001,42301,34143,0,0,76444
2022,61,14371,北海道,北竜町,5,2,決算収支の状況,1,令和4年度,3886654,3835026,51628,397,51231,-592,170,0,0,-422
2022,61,14389,北海道,沼田町,5,2,決算収支の状況,1,令和4年度,6402711,6187265,215446,46497,168949,46317,150072,61010,0,257399
2022,61,14524,北海道,鷹栖町,5,2,決算収支の状況,1,令和4年度,6570319,6286714,283605,15270,268335,90110,141694,0,0,231804
2022,61,14532,北海道,東神楽町,5,2,決算収支の状況,1,令和4年度,9512624,8838521,674103,351949,322154,33138,333000,0,380000,-13862
2022,61,14541,北海道,当麻町,5,2,決算収支の状況,1,令和4年度,7394184,7189505,204679,4023,200656,-33040,16,0,226399,-259423
2022,61,14559,北海道,比布町,5,2,決算収支の状況,1,令和4年度,4109764,3825059,284705,9898,274807,-15966,710,0,149000,-164256
2022,61,14567,北海道,愛別町,5,2,決算収支の状況,1,令和4年度,3552219,3408516,143703,1000,142703,41653,487,0,101080,-58940
2022,61,14575,北海道,上川町,5,2,決算収支の状況,1,令和4年度,6049547,5772591,276956,4855,272101,102651,423,0,0,103074
2022,61,14583,北海道,東川町,5,2,決算収支の状況,1,令和4年度,16092496,15411899,680597,37032,643565,254773,503,0,0,255276
2022,61,14591,北海道,美瑛町,5,2,決算収支の状況,1,令和4年度,11894728,11635030,259698,3747,255951,-20141,3,0,0,-20138
2022,61,14605,北海道,上富良野町,5,2,決算収支の状況,1,令和4年度,9323142,8757073,566069,68615,497454,43695,34,0,0,43729
2022,61,14613,北海道,中富良野町,5,2,決算収支の状況,1,令和4年度,6464562,6243285,221277,1,221276,-8301,147652,0,75956,63395
2022,61,14621,北海道,南富良野町,5,2,決算収支の状況,1,令和4年度,4459515,4352117,107398,39784,67614,-43969,1,0,0,-43968
2022,61,14630,北海道,占冠村,5,2,決算収支の状況,1,令和4年度,2710056,2656707,53349,1120,52229,-8434,4,0,15060,-23490
2022,61,14648,北海道,和寒町,5,2,決算収支の状況,1,令和4年度,4845692,4716749,128943,10986,117957,7380,86588,15161,147112,-37983
2022,61,14656,北海道,剣淵町,5,2,決算収支の状況,1,令和4年度,4581923,4439147,142776,3658,139118,4619,95346,0,80000,19965
2022,61,14681,北海道,下川町,5,2,決算収支の状況,1,令和4年度,6093600,5857349,236251,450,235801,65615,20,0,28570,37065
2022,61,14699,北海道,美深町,5,2,決算収支の状況,1,令和4年度,5787262,5206470,580792,25566,555226,161486,27,0,0,161513
2022,61,14702,北海道,音威子府村,5,2,決算収支の状況,1,令和4年度,2196900,2077961,118939,99,118840,14028,5364,0,75069,-55677
2022,61,14711,北海道,中川町,5,2,決算収支の状況,1,令和4年度,5101787,5010373,91414,9648,81766,-58107,70023,0,0,11916
2022,61,14729,北海道,幌加内町,5,2,決算収支の状況,1,令和4年度,4259567,4175016,84551,0,84551,-6039,50197,0,0,44158
2022,61,14818,北海道,増毛町,5,2,決算収支の状況,1,令和4年度,6708243,6533725,174518,0,174518,-41971,1366,0,373519,-414124
2022,61,14826,北海道,小平町,5,2,決算収支の状況,1,令和4年度,4722722,4380435,342287,11548,330739,-44928,121,0,0,-44807
2022,61,14834,北海道,苫前町,5,2,決算収支の状況,1,令和4年度,6513950,6387157,126793,1,126792,-23273,1825,0,0,-21448
2022,61,14842,北海道,羽幌町,5,2,決算収支の状況,1,令和4年度,7197315,6963339,233976,6815,227161,34874,2,0,0,34876
2022,61,14851,北海道,初山別村,5,2,決算収支の状況,1,令和4年度,2711349,2676959,34390,16274,18116,-6523,22,0,0,-6501
2022,61,14869,北海道,遠別町,5,2,決算収支の状況,1,令和4年度,4872272,4732176,140096,4957,135139,11918,12336,0,0,24254
2022,61,14877,北海道,天塩町,5,2,決算収支の状況,1,令和4年度,6222819,6067240,155579,38781,116798,-233690,40007,0,0,-193683
2022,61,15113,北海道,猿払村,5,2,決算収支の状況,1,令和4年度,5560474,5458169,102305,774,101531,21955,40498,0,0,62453
2022,61,15121,北海道,浜頓別町,5,2,決算収支の状況,1,令和4年度,5110620,4941794,168826,0,168826,-93893,137965,0,0,44072
2022,61,15130,北海道,中頓別町,5,2,決算収支の状況,1,令和4年度,4284352,4181732,102620,4727,97893,-76164,18,0,0,-76146
2022,61,15148,北海道,枝幸町,5,2,決算収支の状況,1,令和4年度,12566750,12383803,182947,99712,83235,-300,42515,0,47777,-5562
2022,61,15164,北海道,豊富町,5,2,決算収支の状況,1,令和4年度,6968701,6362455,606246,0,606246,-75518,263013,0,0,187495
2022,61,15172,北海道,礼文町,5,2,決算収支の状況,1,令和4年度,5487151,5402778,84373,0,84373,9294,256616,0,369285,-103375
2022,61,15181,北海道,利尻町,5,2,決算収支の状況,1,令和4年度,4595968,4441250,154718,9747,144971,20686,200001,0,0,220687
2022,61,15199,北海道,利尻富士町,5,2,決算収支の状況,1,令和4年度,5687043,5624948,62095,400,61695,-4299,104853,0,0,100554
2022,61,15202,北海道,幌延町,5,2,決算収支の状況,1,令和4年度,5104505,4932985,171520,20364,151156,16968,131,22950,0,40049
2022,61,15431,北海道,美幌町,5,2,決算収支の状況,1,令和4年度,13120188,12914745,205443,30950,174493,86750,90741,0,40,177451
2022,61,15440,北海道,津別町,5,2,決算収支の状況,1,令和4年度,8654093,8441677,212416,2003,210413,35367,465219,138240,315662,323164
2022,61,15458,北海道,斜里町,5,2,決算収支の状況,1,令和4年度,10003757,9653520,350237,3004,347233,-17165,64066,0,63093,-16192
2022,61,15466,北海道,清里町,5,2,決算収支の状況,1,令和4年度,5791354,5381884,409470,111378,298092,-53963,33,0,94733,-148663
2022,61,15474,北海道,小清水町,5,2,決算収支の状況,1,令和4年度,8014315,7634731,379584,8297,371287,-43730,8,0,0,-43722
2022,61,15491,北海道,訓子府町,5,2,決算収支の状況,1,令和4年度,5427757,5154814,272943,10400,262543,26438,3979,0,6600,23817
2022,61,15504,北海道,置戸町,5,2,決算収支の状況,1,令和4年度,5073445,4929059,144386,0,144386,8634,0,0,45205,-36571
2022,61,15521,北海道,佐呂間町,5,2,決算収支の状況,1,令和4年度,5966938,5769671,197267,0,197267,-13585,4889,0,0,-8696
2022,61,15555,北海道,遠軽町,5,2,決算収支の状況,1,令和4年度,18337761,17141265,1196496,10220,1186276,205004,324,100678,337327,-31321
2022,61,15598,北海道,湧別町,5,2,決算収支の状況,1,令和4年度,11767477,11166023,601454,35405,566049,159296,435831,0,0,595127
2022,61,15601,北海道,滝上町,5,2,決算収支の状況,1,令和4年度,5096752,4764471,332281,687,331594,-56470,250599,0,0,194129
2022,61,15610,北海道,興部町,5,2,決算収支の状況,1,令和4年度,5884175,5635006,249169,3000,246169,-1984,39830,0,0,37846
2022,61,15628,北海道,西興部村,5,2,決算収支の状況,1,令和4年度,3169185,3124409,44776,12265,32511,-37665,12561,0,41822,-66926
2022,61,15636,北海道,雄武町,5,2,決算収支の状況,1,令和4年度,7532108,7079479,452629,55062,397567,17803,1510,0,380000,-360687
2022,61,15644,北海道,大空町,5,2,決算収支の状況,1,令和4年度,11988760,11735044,253716,33965,219751,24396,383,0,0,24779
2022,61,15717,北海道,豊浦町,5,2,決算収支の状況,1,令和4年度,5628084,5594135,33949,11478,22471,-22019,342,0,0,-21677
2022,61,15750,北海道,壮瞥町,5,2,決算収支の状況,1,令和4年度,4128266,4020101,108165,8664,99501,39760,105502,0,0,145262
2022,61,15784,北海道,白老町,5,2,決算収支の状況,1,令和4年度,12970222,12625348,344874,8424,336450,27513,81460,0,100200,8773
2022,61,15814,北海道,厚真町,5,2,決算収支の状況,1,令和4年度,10557619,9996754,560865,287043,273822,-389752,1804,0,0,-387948
2022,61,15849,北海道,洞爺湖町,5,2,決算収支の状況,1,令和4年度,8162322,7879426,282896,16926,265970,68330,1175,0,0,69505
2022,61,15857,北海道,安平町,5,2,決算収支の状況,1,令和4年度,10713099,10488407,224692,75696,148996,19393,214324,0,0,233717
2022,61,15865,北海道,むかわ町,5,2,決算収支の状況,1,令和4年度,10072649,9799691,272958,24121,248837,-4838,1818,0,224580,-227600
2022,61,16012,北海道,日高町,5,2,決算収支の状況,1,令和4年度,13137372,12768855,368517,21596,346921,29848,158966,174358,218016,145156
2022,61,16021,北海道,平取町,5,2,決算収支の状況,1,令和4年度,8090084,8011960,78124,1383,76741,-37253,3416,0,0,-33837
2022,61,16047,北海道,新冠町,5,2,決算収支の状況,1,令和4年度,7993959,7889619,104340,811,103529,-16411,212213,0,5654,190148
2022,61,16071,北海道,浦河町,5,2,決算収支の状況,1,令和4年度,10487817,10183724,304093,14090,290003,-9530,56,0,183591,-193065
2022,61,16080,北海道,様似町,5,2,決算収支の状況,1,令和4年度,5276205,5198383,77822,97,77725,23811,26,0,0,23837
2022,61,16098,北海道,えりも町,5,2,決算収支の状況,1,令和4年度,5865792,5798830,66962,17276,49686,-19428,344000,0,337000,-12428
2022,61,16101,北海道,新ひだか町,5,2,決算収支の状況,1,令和4年度,19351503,18961090,390413,843,389570,-98592,25786,154542,0,81736
2022,61,16314,北海道,音更町,5,2,決算収支の状況,1,令和4年度,23428584,22799598,628986,23851,605135,25524,8,0,0,25532
2022,61,16322,北海道,士幌町,5,2,決算収支の状況,1,令和4年度,8377707,8016603,361104,85606,275498,6300,50057,0,0,56357
2022,61,16331,北海道,上士幌町,5,2,決算収支の状況,1,令和4年度,9610230,9237001,373229,10,373219,-137218,100441,0,143286,-180063
2022,61,16349,北海道,鹿追町,5,2,決算収支の状況,1,令和4年度,8205392,7598928,606464,9107,597357,65109,65,0,89865,-24691
2022,61,16357,北海道,新得町,5,2,決算収支の状況,1,令和4年度,8793437,8418526,374911,193181,181730,117162,924,0,0,118086
2022,61,16365,北海道,清水町,5,2,決算収支の状況,1,令和4年度,9960159,9588542,371617,270,371347,-11820,212968,704,417020,-215168
2022,61,16373,北海道,芽室町,5,2,決算収支の状況,1,令和4年度,13425604,12881822,543782,135153,408629,-203340,22,0,0,-203318
2022,61,16381,北海道,中札内村,5,2,決算収支の状況,1,令和4年度,6916871,6538280,378591,227967,150624,-168787,19,115482,154000,-207286
2022,61,16390,北海道,更別村,5,2,決算収支の状況,1,令和4年度,6183413,5985416,197997,8942,189055,-21048,156082,55936,0,190970
2022,61,16411,北海道,大樹町,5,2,決算収支の状況,1,令和4年度,9162334,8843447,318887,14805,304082,-55481,191901,500000,0,636420
2022,61,16420,北海道,広尾町,5,2,決算収支の状況,1,令和4年度,7901350,7707403,193947,3806,190141,-36513,8,0,0,-36505
2022,61,16438,北海道,幕別町,5,2,決算収支の状況,1,令和4年度,19484047,18684132,799915,19784,780131,274570,1000,114600,460000,-69830
2022,61,16446,北海道,池田町,5,2,決算収支の状況,1,令和4年度,8246448,8026930,219518,7682,211836,-3376,106979,0,0,103603
2022,61,16454,北海道,豊頃町,5,2,決算収支の状況,1,令和4年度,7410992,7307584,103408,2138,101270,7133,528,0,0,7661
2022,61,16462,北海道,本別町,5,2,決算収支の状況,1,令和4年度,7816144,7673748,142396,14325,128071,-3848,265426,0,270832,-9254
2022,61,16471,北海道,足寄町,5,2,決算収支の状況,1,令和4年度,9858390,9710684,147706,32101,115605,-24629,192678,0,0,168049
2022,61,16489,北海道,陸別町,5,2,決算収支の状況,1,令和4年度,5596640,5501696,94944,2095,92849,-8826,113908,0,200000,-94918
2022,61,16497,北海道,浦幌町,5,2,決算収支の状況,1,令和4年度,7567743,7325539,242204,8698,233506,19437,105678,0,0,125115
2022,61,16616,北海道,釧路町,5,2,決算収支の状況,1,令和4年度,11555979,11202219,353760,8792,344968,-38581,193647,0,10000,145066
2022,61,16624,北海道,厚岸町,5,2,決算収支の状況,1,令和4年度,12069237,11422507,646730,27155,619575,26898,100000,0,302200,-175302
2022,61,16632,北海道,浜中町,5,2,決算収支の状況,1,令和4年度,9846233,9716558,129675,396,129279,-13853,65129,0,0,51276
2022,61,16641,北海道,標茶町,5,2,決算収支の状況,1,令和4年度,13959993,13813037,146956,41650,105306,-83536,366152,0,660000,-377384
2022,61,16659,北海道,弟子屈町,5,2,決算収支の状況,1,令和4年度,15312823,15144521,168302,95,168207,44172,187792,0,0,231964
2022,61,16675,北海道,鶴居村,5,2,決算収支の状況,1,令和4年度,5603976,5481083,122893,52900,69993,-3124,36575,0,58599,-25148
2022,61,16683,北海道,白糠町,5,2,決算収支の状況,1,令和4年度,25945897,25738642,207255,70,207185,88906,1272,0,132343,-42165
2022,61,16918,北海道,別海町,5,2,決算収支の状況,1,令和4年度,28747216,28412400,334816,10385,324431,-11924,1601,0,0,-10323
2022,61,16926,北海道,中標津町,5,2,決算収支の状況,1,令和4年度,17003178,16745332,257846,93840,164006,-457205,89621,133459,1211,-235336
2022,61,16934,北海道,標津町,5,2,決算収支の状況,1,令和4年度,7124292,6823643,300649,23342,277307,-52426,1,0,0,-52425
2022,61,16942,北海道,羅臼町,5,2,決算収支の状況,1,令和4年度,6186239,5815738,370501,5539,364962,16403,174426,0,98217,92612
2022,61,18015,北海道,日高中部広域連合,6,2,決算収支の状況,1,令和4年度,452719,452248,471,0,471,144,0,0,0,144
2022,61,18023,北海道,北海道市町村総合事務組合,6,2,決算収支の状況,1,令和4年度,1077036,1062357,14679,0,14679,-5446,5590,0,3300,-3156
2022,61,18031,北海道,南空知葬斎組合,6,2,決算収支の状況,1,令和4年度,52207,46659,5548,0,5548,1637,0,0,0,1637
2022,61,18058,北海道,北海道市町村備荒資金組合,6,2,決算収支の状況,1,令和4年度,19417951,19414433,3518,3518,0,0,0,0,0,0
2022,61,18074,北海道,北海道市町村職員退職手当組合,6,2,決算収支の状況,1,令和4年度,24608835,22377618,2231217,0,2231217,269363,0,0,0,269363
2022,61,18104,北海道,北後志衛生施設組合,6,2,決算収支の状況,1,令和4年度,174913,159848,15065,0,15065,-1016,0,0,0,-1016
2022,61,18121,北海道,空知中部広域連合,6,2,決算収支の状況,1,令和4年度,105183,104094,1089,0,1089,-335,4000,0,0,3665
2022,61,18139,北海道,根室北部廃棄物処理広域連合,6,2,決算収支の状況,1,令和4年度,890437,860816,29621,0,29621,11943,0,0,0,11943
2022,61,18155,北海道,後志広域連合,6,2,決算収支の状況,1,令和4年度,200161,194438,5723,0,5723,4170,0,0,0,4170
2022,61,18163,北海道,とかち広域消防事務組合,6,2,決算収支の状況,1,令和4年度,7217249,6782428,434821,166691,268130,-98643,0,0,0,-98643
2022,61,18198,北海道,名寄地区衛生施設事務組合,6,2,決算収支の状況,1,令和4年度,753008,711120,41888,0,41888,-27522,0,0,0,-27522
2022,61,18236,北海道,富良野広域連合,6,2,決算収支の状況,1,令和4年度,2288946,2252086,36860,0,36860,-7030,0,0,0,-7030
2022,61,18244,北海道,釧路・根室広域地方税滞納整理機構,6,2,決算収支の状況,1,令和4年度,36676,34974,1702,0,1702,-653,2355,0,2089,-387
2022,61,18279,北海道,大雪浄化組合,6,2,決算収支の状況,1,令和4年度,104509,99942,4567,0,4567,315,1,0,0,316
2022,61,18295,北海道,日高東部衛生組合,6,2,決算収支の状況,1,令和4年度,181817,180741,1076,0,1076,-4471,1,0,2000,-6470
2022,61,18309,北海道,上川中部福祉事務組合,6,2,決算収支の状況,1,令和4年度,106787,106787,0,0,0,0,0,0,0,0
2022,61,18325,北海道,大雪地区広域連合,6,2,決算収支の状況,1,令和4年度,1329104,1323397,5707,0,5707,3708,0,0,0,3708
2022,61,18333,北海道,上川広域滞納整理機構,6,2,決算収支の状況,1,令和4年度,20560,19193,1367,0,1367,-2,0,0,0,-2
2022,61,18384,北海道,北空知衛生センター組合,6,2,決算収支の状況,1,令和4年度,540286,514930,25356,0,25356,-8462,0,0,0,-8462
2022,61,18481,北海道,北しりべし廃棄物処理広域連合,6,2,決算収支の状況,1,令和4年度,1360853,1324079,36774,0,36774,-9811,0,0,0,-9811
2022,61,18490,北海道,南空知公衆衛生組合,6,2,決算収支の状況,1,令和4年度,440255,422209,18046,0,18046,-3289,0,0,0,-3289
2022,61,18554,北海道,南部後志環境衛生組合,6,2,決算収支の状況,1,令和4年度,107061,106400,661,0,661,-546,0,0,0,-546
2022,61,18571,北海道,中空知広域市町村圏組合（事業会計分）,7,2,決算収支の状況,1,令和4年度,0,0,0,0,0,0,0,0,0,0
2022,61,18597,北海道,岩内地方衛生組合,6,2,決算収支の状況,1,令和4年度,534558,514186,20372,0,20372,-33197,0,0,0,-33197
2022,61,18601,北海道,北部桧山衛生センター組合,6,2,決算収支の状況,1,令和4年度,503984,490851,13133,0,13133,10291,0,0,0,10291
2022,61,18619,北海道,羽幌町外２町村衛生施設組合,6,2,決算収支の状況,1,令和4年度,971931,951655,20276,0,20276,416,0,0,0,416
2022,61,18635,北海道,空知教育センター組合,6,2,決算収支の状況,1,令和4年度,19783,17924,1859,0,1859,203,0,0,0,203
2022,61,18643,北海道,北海道町村議会議員公務災害補償等組合,6,2,決算収支の状況,1,令和4年度,44510,39577,4933,0,4933,1562,1000,0,3500,-938
2022,61,18651,北海道,羊蹄山麓環境衛生組合,6,2,決算収支の状況,1,令和4年度,160690,146397,14293,0,14293,2471,0,0,0,2471
2022,61,18678,北海道,北海道後期高齢者医療広域連合,7,2,決算収支の状況,1,令和4年度,617799,402920,214879,0,214879,-87709,160092,0,242796,-170413
2022,61,18686,北海道,南渡島衛生施設組合,6,2,決算収支の状況,1,令和4年度,161939,150401,11538,0,11538,-1506,2001,0,0,495
2022,61,18694,北海道,砂川地区保健衛生組合,6,2,決算収支の状況,1,令和4年度,337121,337121,0,0,0,0,0,0,0,0
2022,61,18716,北海道,苫小牧港管理組合,6,2,決算収支の状況,1,令和4年度,4180250,4033939,146311,11402,134909,-149561,0,0,0,-149561
2022,61,18732,北海道,斜里郡３町終末処理事業組合,6,2,決算収支の状況,1,令和4年度,132950,130959,1991,0,1991,-1275,0,0,0,-1275
2022,61,18759,北海道,西天北五町衛生施設組合,6,2,決算収支の状況,1,令和4年度,569843,552784,17059,0,17059,-1958,10,0,5000,-6948
2022,61,18775,北海道,南十勝複合事務組合,6,2,決算収支の状況,1,令和4年度,313252,304156,9096,0,9096,3545,0,0,0,3545
2022,61,18791,北海道,安平・厚真行政事務組合,6,2,決算収支の状況,1,令和4年度,264230,258445,5785,0,5785,-6520,1,0,11167,-17686
2022,61,18830,北海道,中空知衛生施設組合,6,2,決算収支の状況,1,令和4年度,705450,656591,48859,0,48859,-19523,0,0,0,-19523
2022,61,18856,北海道,十勝圏複合事務組合,6,2,決算収支の状況,1,令和4年度,3062300,2799555,262745,0,262745,81697,0,0,0,81697
2022,61,18899,北海道,南部檜山衛生処理組合,6,2,決算収支の状況,1,令和4年度,677361,643615,33746,0,33746,1599,0,0,0,1599
2022,61,18902,北海道,中・北空知廃棄物処理広域連合,6,2,決算収支の状況,1,令和4年度,896860,888705,8155,0,8155,1788,0,0,0,1788
2022,61,18911,北海道,北空知衛生施設組合,6,2,決算収支の状況,1,令和4年度,36084,29118,6966,0,6966,631,0,0,0,631
2022,61,18929,北海道,南宗谷衛生施設組合,6,2,決算収支の状況,1,令和4年度,538173,538173,0,0,0,0,0,0,0,0
2022,61,18937,北海道,函館圏公立大学広域連合,6,2,決算収支の状況,1,令和4年度,2012257,2009987,2270,0,2270,-751,0,0,0,-751
2022,61,18945,北海道,西胆振行政事務組合,6,2,決算収支の状況,1,令和4年度,1420197,1338911,81286,0,81286,-7324,5780,0,0,-1544
2022,61,18953,北海道,根室北部衛生組合,6,2,決算収支の状況,1,令和4年度,1118816,527632,591184,589714,1470,-670,0,0,0,-670
2022,61,18961,北海道,江差町・上ノ国町学校給食組合,6,2,決算収支の状況,1,令和4年度,528264,528164,100,0,100,-1551,0,0,0,-1551
2022,61,18970,北海道,渡島・檜山地方税滞納整理機構,6,2,決算収支の状況,1,令和4年度,43051,39321,3730,0,3730,-1696,0,0,0,-1696
2022,61,19003,北海道,川上郡衛生処理組合,6,2,決算収支の状況,1,令和4年度,92638,86889,5749,0,5749,263,0,0,0,263
2022,61,19011,北海道,石狩北部地区消防事務組合,6,2,決算収支の状況,1,令和4年度,1991783,1907364,84419,0,84419,19849,0,0,0,19849
2022,61,19020,北海道,渡島西部広域事務組合,6,2,決算収支の状況,1,令和4年度,1954560,1937624,16936,0,16936,-3087,0,0,0,-3087
2022,61,19046,北海道,中空知広域市町村圏組合（普通会計分）,6,2,決算収支の状況,1,令和4年度,64700,25295,39405,0,39405,775,0,0,0,775
2022,61,19101,北海道,日高東部消防組合,6,2,決算収支の状況,1,令和4年度,832796,825725,7071,0,7071,1569,0,0,0,1569
2022,61,19135,北海道,日高中部消防組合,6,2,決算収支の状況,1,令和4年度,967488,953436,14052,0,14052,3681,0,0,0,3681
2022,61,19143,北海道,胆振東部消防組合,6,2,決算収支の状況,1,令和4年度,1146206,1130190,16016,0,16016,-10607,0,0,0,-10607
2022,61,19160,北海道,日高中部衛生施設組合,6,2,決算収支の状況,1,令和4年度,836615,798193,38422,0,38422,24415,0,0,0,24415
2022,61,19186,北海道,上川北部消防事務組合,6,2,決算収支の状況,1,令和4年度,1295430,1277079,18351,0,18351,-2046,0,0,0,-2046
2022,61,19194,北海道,遠軽地区広域組合,6,2,決算収支の状況,1,令和4年度,2072381,1998228,74153,0,74153,21832,0,0,0,21832
2022,61,19208,北海道,美幌・津別広域事務組合,6,2,決算収支の状況,1,令和4年度,790368,776588,13780,0,13780,-1010,0,0,0,-1010
2022,61,19216,北海道,網走地区消防組合,6,2,決算収支の状況,1,令和4年度,1351330,1338000,13330,342,12988,-1556,0,0,0,-1556
2022,61,19224,北海道,網走地方教育研修センター組合,6,2,決算収支の状況,1,令和4年度,17439,14208,3231,0,3231,-307,0,0,0,-307
2022,61,19232,北海道,愛別町外３町塵芥処理組合,6,2,決算収支の状況,1,令和4年度,423250,412367,10883,0,10883,-542,61377,0,0,60835
2022,61,19241,北海道,滝川地区広域消防事務組合,6,2,決算収支の状況,1,令和4年度,2038109,1947814,90295,0,90295,13194,0,0,0,13194
2022,61,19259,北海道,北見地区消防組合,6,2,決算収支の状況,1,令和4年度,3069290,2994707,74583,0,74583,10419,0,0,0,10419
2022,61,19267,北海道,南空知消防組合,6,2,決算収支の状況,1,令和4年度,1073420,1053366,20054,0,20054,1246,0,0,0,1246
2022,61,19275,北海道,深川地区消防組合,6,2,決算収支の状況,1,令和4年度,1000203,959004,41199,0,41199,2135,0,0,0,2135
2022,61,19283,北海道,岩見沢地区消防事務組合,6,2,決算収支の状況,1,令和4年度,1431240,1407425,23815,0,23815,4299,0,0,0,4299
2022,61,19291,北海道,砂川地区広域消防組合,6,2,決算収支の状況,1,令和4年度,825951,825951,0,0,0,0,0,0,0,0
2022,61,19305,北海道,根室北部消防事務組合,6,2,決算収支の状況,1,令和4年度,1647345,1647345,0,0,0,0,0,0,0,0
2022,61,19313,北海道,士別地方消防事務組合,6,2,決算収支の状況,1,令和4年度,1002726,998543,4183,0,4183,-25,0,0,0,-25
2022,61,19321,北海道,胆振東部日高西部衛生組合,6,2,決算収支の状況,1,令和4年度,172490,168269,4221,0,4221,-1866,115,0,4000,-5751
2022,61,19330,北海道,西いぶり広域連合,6,2,決算収支の状況,1,令和4年度,7230065,7229267,798,0,798,-246,0,0,0,-246
2022,61,19348,北海道,利尻郡清掃施設組合,6,2,決算収支の状況,1,令和4年度,284753,282675,2078,0,2078,-18,0,0,0,-18
2022,61,19364,北海道,上川教育研修センター組合,6,2,決算収支の状況,1,令和4年度,34169,31589,2580,0,2580,-492,3079,0,2686,-99
2022,61,19372,北海道,南渡島消防事務組合,6,2,決算収支の状況,1,令和4年度,1995247,1968639,26608,0,26608,3764,0,0,0,3764
2022,61,19381,北海道,斜里地区消防組合,6,2,決算収支の状況,1,令和4年度,855884,854772,1112,0,1112,-217,0,0,0,-217
2022,61,19402,北海道,羊蹄山ろく消防組合,6,2,決算収支の状況,1,令和4年度,1899130,1888692,10438,0,10438,-3218,0,0,0,-3218
2022,61,19411,北海道,南部後志衛生施設組合,6,2,決算収支の状況,1,令和4年度,249516,237011,12505,0,12505,1498,0,0,3780,-2282
2022,61,19429,北海道,大雪消防組合,6,2,決算収支の状況,1,令和4年度,1419414,1393390,26024,0,26024,-2310,0,0,0,-2310
2022,61,19437,北海道,大雪清掃組合,6,2,決算収支の状況,1,令和4年度,476377,462838,13539,0,13539,3743,0,0,0,3743
2022,61,19445,北海道,北留萌消防組合,6,2,決算収支の状況,1,令和4年度,980250,942783,37467,0,37467,3295,0,0,0,3295
2022,61,19453,北海道,稚内地区消防事務組合,6,2,決算収支の状況,1,令和4年度,1081412,1053165,28247,0,28247,6092,0,0,0,6092
2022,61,19461,北海道,利尻礼文消防事務組合,6,2,決算収支の状況,1,令和4年度,514401,505228,9173,0,9173,-1712,0,0,0,-1712
2022,61,19470,北海道,南宗谷消防組合,6,2,決算収支の状況,1,令和4年度,635467,620832,14635,0,14635,3879,0,0,0,3879
2022,61,19488,北海道,紋別地区消防組合,6,2,決算収支の状況,1,令和4年度,1352861,1289622,63239,27586,35653,5049,0,0,0,5049
2022,61,19496,北海道,日高西部消防組合,6,2,決算収支の状況,1,令和4年度,865300,844243,21057,880,20177,801,0,0,0,801
2022,61,19500,北海道,平取町外２町衛生施設組合,6,2,決算収支の状況,1,令和4年度,732564,707537,25027,0,25027,-20196,0,0,0,-20196
2022,61,19518,北海道,釧路北部消防事務組合,6,2,決算収支の状況,1,令和4年度,921855,908228,13627,0,13627,907,0,0,0,907
2022,61,19534,北海道,利尻郡学校給食組合,6,2,決算収支の状況,1,令和4年度,116939,114772,2167,0,2167,965,0,0,0,965
2022,61,19551,北海道,渡島廃棄物処理広域連合,6,2,決算収支の状況,1,令和4年度,1429280,1152820,276460,242000,34460,3734,0,0,0,3734
2022,61,19577,北海道,留萌南部衛生組合,6,2,決算収支の状況,1,令和4年度,839828,822613,17215,0,17215,139,0,0,0,139
2022,61,19585,北海道,道央廃棄物処理組合,6,2,決算収支の状況,1,令和4年度,4509697,4504572,5125,0,5125,871,0,0,0,871
2022,61,19593,北海道,檜山広域行政組合,6,2,決算収支の状況,1,令和4年度,1615842,1577359,38483,0,38483,-8371,0,0,0,-8371
2022,61,19607,北海道,北十勝２町環境衛生処理組合,6,2,決算収支の状況,1,令和4年度,189347,184027,5320,0,5320,79,0,0,0,79
2022,61,19631,北海道,留萌消防組合,6,2,決算収支の状況,1,令和4年度,543294,536152,7142,0,7142,-4399,0,0,0,-4399
2022,61,19640,北海道,岩内・寿都地方消防組合,6,2,決算収支の状況,1,令和4年度,1215108,1153471,61637,0,61637,17276,0,0,0,17276
2022,61,19658,北海道,北後志消防組合,6,2,決算収支の状況,1,令和4年度,1331469,1256928,74541,0,74541,11409,0,0,0,11409
2022,61,19666,北海道,釧路東部消防組合,6,2,決算収支の状況,1,令和4年度,1328753,1308891,19862,0,19862,1211,0,0,0,1211
2022,61,19712,北海道,中標津町外２町葬斎組合,6,2,決算収支の状況,1,令和4年度,93084,93084,0,0,0,0,0,0,0,0
2022,61,19721,北海道,釧路広域連合,6,2,決算収支の状況,1,令和4年度,1709371,1706869,2502,0,2502,114,0,0,0,114
2022,61,19739,北海道,石狩教育研修センター組合,6,2,決算収支の状況,1,令和4年度,32484,30587,1897,0,1897,-961,0,0,0,-961
2022,61,19747,北海道,後志教育研修センター組合,6,2,決算収支の状況,1,令和4年度,14740,14410,330,0,330,-405,0,0,0,-405
2022,61,19755,北海道,西紋別地区環境衛生施設組合,6,2,決算収支の状況,1,令和4年度,561870,504141,57729,0,57729,-22092,0,0,0,-22092
2022,61,19771,北海道,日高管内地方税滞納整理機構,6,2,決算収支の状況,1,令和4年度,24458,23935,523,523,0,0,0,0,0,0
2022,61,19780,北海道,大雪葬斎組合,6,2,決算収支の状況,1,令和4年度,21973,19809,2164,0,2164,204,0,0,0,204
2022,61,19810,北海道,石狩湾新港管理組合,6,2,決算収支の状況,1,令和4年度,2115350,2050450,64900,50,64850,18067,0,0,0,18067
2022,61,19852,北海道,北空知圏学校給食組合,6,2,決算収支の状況,1,令和4年度,268189,266521,1668,0,1668,-1867,0,0,0,-1867
2022,61,19925,北海道,釧路公立大学事務組合,6,2,決算収支の状況,1,令和4年度,1446907,1365140,81767,0,81767,-36234,1453,0,116000,-150781
2022,61,19976,北海道,南空知ふるさと市町村圏組合,6,2,決算収支の状況,1,令和4年度,87205,39315,47890,0,47890,-376,0,0,0,-376
2022,61,22012,青森県,青森市,8,2,決算収支の状況,1,令和4年度,137545820,132019553,5526267,374806,5151461,277260,298,0,1500000,-1222442
2022,61,22021,青森県,弘前市,3,2,決算収支の状況,1,令和4年度,89194192,87761370,1432822,844347,588475,-731108,679981,0,700000,-751127
2022,61,22039,青森県,八戸市,8,2,決算収支の状況,1,令和4年度,110995725,106764951,4230774,950135,3280639,91581,601843,0,600000,93424
2022,61,22047,青森県,黒石市,4,2,決算収支の状況,1,令和4年度,20340961,19144605,1196356,161193,1035163,-687883,847775,0,0,159892
2022,61,22055,青森県,五所川原市,4,2,決算収支の状況,1,令和4年度,35317673,33567239,1750434,71601,1678833,-258853,11,0,1721317,-1980159
2022,61,22063,青森県,十和田市,4,2,決算収支の状況,1,令和4年度,38375391,36452884,1922507,365642,1556865,-547198,1376,0,1079555,-1625377
2022,61,22071,青森県,三沢市,4,2,決算収支の状況,1,令和4年度,30212509,29370723,841786,36720,805066,132671,5,0,634564,-501888
2022,61,22080,青森県,むつ市,4,2,決算収支の状況,1,令和4年度,39371079,38420864,950215,45247,904968,222192,1047799,0,967262,302729
2022,61,22098,青森県,つがる市,4,2,決算収支の状況,1,令和4年度,28417524,27845478,572046,28706,543340,-80804,603,0,181145,-261346
2022,61,22101,青森県,平川市,4,2,決算収支の状況,1,令和4年度,24566147,23424678,1141469,496813,644656,112951,4085,0,505543,-388507
2022,61,23019,青森県,平内町,5,2,決算収支の状況,1,令和4年度,8462727,8290957,171770,20099,151671,-12379,64081,0,0,51702
2022,61,23035,青森県,今別町,5,2,決算収支の状況,1,令和4年度,3803641,3542165,261476,13294,248182,21783,390006,17610,227500,201899
2022,61,23043,青森県,蓬田村,5,2,決算収支の状況,1,令和4年度,2595514,2471695,123819,43866,79953,34630,531,0,0,35161
2022,61,23078,青森県,外ヶ浜町,5,2,決算収支の状況,1,令和4年度,6849135,6683186,165949,44329,121620,4312,417131,124014,459950,85507
2022,61,23213,青森県,鰺ケ沢町,5,2,決算収支の状況,1,令和4年度,8476858,8153028,323830,88217,235613,72004,4,0,121139,-49131
2022,61,23230,青森県,深浦町,5,2,決算収支の状況,1,令和4年度,7867632,7588756,278876,115140,163736,-12031,1770,0,150000,-160261
2022,61,23434,青森県,西目屋村,5,2,決算収支の状況,1,令和4年度,2565877,2477141,88736,12925,75811,-376,220037,0,191554,28107
2022,61,23612,青森県,藤崎町,5,2,決算収支の状況,1,令和4年度,9295817,8982562,313255,52219,261036,89315,100252,0,168089,21478
2022,61,23621,青森県,大鰐町,5,2,決算収支の状況,1,令和4年度,7468413,7164382,304031,88429,215602,-123029,28,830000,0,706999
2022,61,23671,青森県,田舎館村,5,2,決算収支の状況,1,令和4年度,4561619,4132103,429516,15755,413761,-140628,3175,0,310000,-447453
2022,61,23817,青森県,板柳町,5,2,決算収支の状況,1,令和4年度,7764934,7215723,549211,3068,546143,102092,69832,0,237206,-65282
2022,61,23841,青森県,鶴田町,5,2,決算収支の状況,1,令和4年度,7706492,7201692,504800,12488,492312,-74820,15,2814,187759,-259750
2022,61,23876,青森県,中泊町,5,2,決算収支の状況,1,令和4年度,9989808,9662663,327145,81498,245647,2433,952370,0,800290,154513
2022,61,24015,青森県,野辺地町,5,2,決算収支の状況,1,令和4年度,7663635,7487109,176526,63,176463,-216265,214400,0,0,-1865
2022,61,24023,青森県,七戸町,5,2,決算収支の状況,1,令和4年度,13040662,12776746,263916,68248,195668,-88528,2079,0,168043,-254492
2022,61,24058,青森県,六戸町,5,2,決算収支の状況,1,令和4年度,6608646,6348839,259807,50419,209388,11334,50015,0,0,61349
2022,61,24066,青森県,横浜町,5,2,決算収支の状況,1,令和4年度,4164121,4089840,74281,741,73540,-40495,59027,0,0,18532
2022,61,24082,青森県,東北町,5,2,決算収支の状況,1,令和4年度,13215911,12713499,502412,33906,468506,64963,739652,0,1035637,-231022
2022,61,24112,青森県,六ケ所村,5,2,決算収支の状況,1,令和4年度,15389382,15043731,345651,143333,202318,23147,8270,0,503042,-471625
2022,61,24121,青森県,おいらせ町,5,2,決算収支の状況,1,令和4年度,12125552,11765905,359647,32252,327395,32046,4406,0,137939,-101487
2022,61,24236,青森県,大間町,5,2,決算収支の状況,1,令和4年度,7035364,6850491,184873,3740,181133,-20546,110011,0,711000,-621535
2022,61,24244,青森県,東通村,5,2,決算収支の状況,1,令和4年度,9129296,8740433,388863,57420,331443,145159,79,0,172011,-26773
2022,61,24252,青森県,風間浦村,5,2,決算収支の状況,1,令和4年度,3162003,3107806,54197,13,54184,-32851,150034,0,210000,-92817
2022,61,24261,青森県,佐井村,5,2,決算収支の状況,1,令和4年度,2820603,2729694,90909,4602,86307,-26405,99925,0,0,73520
2022,61,24414,青森県,三戸町,5,2,決算収支の状況,1,令和4年度,7420692,7091425,329267,18767,310500,48719,80,0,0,48799
2022,61,24422,青森県,五戸町,5,2,決算収支の状況,1,令和4年度,10045701,9868678,177023,5812,171211,-44562,176593,0,0,132031
2022,61,24431,青森県,田子町,5,2,決算収支の状況,1,令和4年度,5098380,4989819,108561,3431,105130,-219503,0,0,0,-219503
2022,61,24457,青森県,南部町,5,2,決算収支の状況,1,令和4年度,13078286,12166745,911541,17206,894335,400441,285,0,708474,-307748
2022,61,24465,青森県,階上町,5,2,決算収支の状況,1,令和4年度,6496371,6191635,304736,1721,303015,20090,250221,0,0,270311
2022,61,24503,青森県,新郷村,5,2,決算収支の状況,1,令和4年度,3285761,3086127,199634,1907,197727,51990,16960,0,0,68950
2022,61,28037,青森県,中部上北広域事業組合,6,2,決算収支の状況,1,令和4年度,2250070,2226138,23932,0,23932,957,2,0,26294,-25335
2022,61,28061,青森県,青森県市町村総合事務組合,6,2,決算収支の状況,1,令和4年度,818279,802720,15559,0,15559,-4343,14379,0,32000,-21964
2022,61,28126,青森県,青森県市町村職員退職手当組合,6,2,決算収支の状況,1,令和4年度,7100940,6736841,364099,0,364099,156512,0,0,0,156512
2022,61,28177,青森県,弘前地区環境整備事務組合,6,2,決算収支の状況,1,令和4年度,2146287,2073244,73043,0,73043,-4454,76529,0,117600,-45525
2022,61,28185,青森県,黒石地区清掃施設組合,6,2,決算収支の状況,1,令和4年度,788531,780034,8497,0,8497,-8922,8800,0,33432,-33554
2022,61,28193,青森県,西北五環境整備事務組合,6,2,決算収支の状況,1,令和4年度,927705,915932,11773,0,11773,-9073,0,0,0,-9073
2022,61,28266,青森県,三戸地区環境整備事務組合,6,2,決算収支の状況,1,令和4年度,732548,695279,37269,0,37269,4116,0,0,0,4116
2022,61,28291,青森県,西海岸衛生処理組合,6,2,決算収支の状況,1,令和4年度,429088,394601,34487,0,34487,-9437,0,0,0,-9437
2022,61,28304,青森県,西北五広域福祉事務組合,6,2,決算収支の状況,1,令和4年度,255111,246040,9071,1375,7696,-276,15811,0,24737,-9202
2022,61,28347,青森県,上北地方教育・福祉事務組合,6,2,決算収支の状況,1,令和4年度,764531,740127,24404,0,24404,-9507,43702,0,24270,9925
2022,61,28398,青森県,青森県交通災害共済組合,7,2,決算収支の状況,1,令和4年度,0,0,0,0,0,0,0,0,0,0
2022,61,28533,青森県,五所川原地区消防事務組合,6,2,決算収支の状況,1,令和4年度,3072880,3024531,48349,0,48349,12339,0,0,0,12339
2022,61,28568,青森県,弘前地区消防事務組合,6,2,決算収支の状況,1,令和4年度,4487719,4444678,43041,1463,41578,-39197,80778,0,53372,-11791
2022,61,28592,青森県,八戸地域広域市町村圏事務組合,6,2,決算収支の状況,1,令和4年度,7554761,7270553,284208,25292,258916,58852,0,0,0,58852
2022,61,28614,青森県,下北地域広域行政事務組合,6,2,決算収支の状況,1,令和4年度,9943161,8632501,1310660,1280608,30052,-24017,52840,0,81952,-53129
2022,61,28622,青森県,鰺ケ沢地区消防事務組合,6,2,決算収支の状況,1,令和4年度,802463,779956,22507,5600,16907,-1411,0,0,0,-1411
2022,61,28631,青森県,十和田地域広域事務組合,6,2,決算収支の状況,1,令和4年度,3770831,3636019,134812,0,134812,-60419,47422,0,0,-12997
2022,61,28673,青森県,田子高原広域事務組合,6,2,決算収支の状況,1,令和4年度,14592,7809,6783,0,6783,-2455,0,0,0,-2455
2022,61,28703,青森県,青森県市長会館管理組合,6,2,決算収支の状況,1,令和4年度,7422,6065,1357,0,1357,-124,0,0,0,-124
2022,61,28746,青森県,青森地域広域事務組合,6,2,決算収支の状況,1,令和4年度,6920491,6618044,302447,89561,212886,-17191,0,0,0,-17191
2022,61,28771,青森県,北部上北広域事務組合,6,2,決算収支の状況,1,令和4年度,2209878,2151367,58511,15042,43469,11457,0,0,0,11457
2022,61,28789,青森県,津軽広域連合,6,2,決算収支の状況,1,令和4年度,369282,331012,38270,0,38270,-12377,10,0,38139,-50506
2022,61,28797,青森県,つがる西北五広域連合,6,2,決算収支の状況,1,令和4年度,102607,97437,5170,0,5170,-3170,2,0,11697,-14865
2022,61,28801,青森県,青森県後期高齢者医療広域連合,7,2,決算収支の状況,1,令和4年度,155065,137757,17308,0,17308,-13886,14,0,8801,-22673
2022,61,32018,岩手県,盛岡市,8,2,決算収支の状況,1,令和4年度,139303721,136577158,2726563,907724,1818839,225507,1082496,2661,3102926,-1792262
2022,61,32026,岩手県,宮古市,4,2,決算収支の状況,1,令和4年度,36499262,35137801,1361461,311138,1050323,-105908,182653,0,555066,-478321
2022,61,32034,岩手県,大船渡市,4,2,決算収支の状況,1,令和4年度,24912781,24210517,702264,35001,667263,-228620,451992,0,667673,-444301
2022,61,32051,岩手県,花巻市,4,2,決算収支の状況,1,令和4年度,57795188,54863508,2931680,847766,2083914,-24853,1063939,0,1060000,-20914
2022,61,32069,岩手県,北上市,4,2,決算収支の状況,1,令和4年度,49725516,47767873,1957643,589543,1368100,855832,2360,0,0,858192
2022,61,32077,岩手県,久慈市,4,2,決算収支の状況,1,令和4年度,24203243,22923459,1279784,234254,1045530,-650276,461024,0,580216,-769468
2022,61,32085,岩手県,遠野市,4,2,決算収支の状況,1,令和4年度,21707588,20605172,1102416,102940,999476,119932,440743,27639,349753,238561
2022,61,32093,岩手県,一関市,3,2,決算収支の状況,1,令和4年度,84318663,79548368,4770295,282344,4487951,303576,3399883,0,3545612,157847
2022,61,32107,岩手県,陸前高田市,4,2,決算収支の状況,1,令和4年度,25529191,24368769,1160422,505433,654989,-3923355,4238225,981420,2628283,-1331993
2022,61,32115,岩手県,釜石市,4,2,決算収支の状況,1,令和4年度,22000009,21754713,245296,69879,175417,-114949,156341,0,700000,-658608
2022,61,32131,岩手県,二戸市,4,2,決算収支の状況,1,令和4年度,20324815,19192491,1132324,164033,968291,252145,357085,0,642862,-33632
2022,61,32140,岩手県,八幡平市,4,2,決算収支の状況,1,令和4年度,20866951,20225487,641464,149352,492112,-22112,258271,78397,682131,-367575
2022,61,32158,岩手県,奥州市,3,2,決算収支の状況,1,令和4年度,64685694,62383954,2301740,248663,2053077,-674936,1374024,13380,1183795,-471327
2022,61,32166,岩手県,滝沢市,4,2,決算収支の状況,1,令和4年度,22913542,22168550,744992,96193,648799,-106630,745384,0,799966,-161212
2022,61,33014,岩手県,雫石町,5,2,決算収支の状況,1,令和4年度,11444054,11158470,285584,21736,263848,5361,131560,0,180720,-43799
2022,61,33022,岩手県,葛巻町,5,2,決算収支の状況,1,令和4年度,10333807,9409696,924111,359304,564807,284219,150008,346446,180700,599973
2022,61,33031,岩手県,岩手町,5,2,決算収支の状況,1,令和4年度,9684882,9226242,458640,214556,244084,-45802,144955,0,673877,-574724
2022,61,33219,岩手県,紫波町,5,2,決算収支の状況,1,令和4年度,15810096,15633966,176130,74999,101131,-253820,491810,0,213702,24288
2022,61,33227,岩手県,矢巾町,5,2,決算収支の状況,1,令和4年度,13362761,12815966,546795,15533,531262,28841,612766,0,725526,-83919
2022,61,33669,岩手県,西和賀町,5,2,決算収支の状況,1,令和4年度,8157447,7833996,323451,16181,307270,-71663,60055,0,0,-11608
2022,61,33812,岩手県,金ケ崎町,5,2,決算収支の状況,1,令和4年度,10449020,10144558,304462,9340,295122,-104228,800052,0,794028,-98204
2022,61,34029,岩手県,平泉町,5,2,決算収支の状況,1,令和4年度,5250228,5055751,194477,3529,190948,11349,89073,300,91213,9509
2022,61,34410,岩手県,住田町,5,2,決算収支の状況,1,令和4年度,5275770,5187744,88026,1105,86921,66516,1862,0,0,68378
2022,61,34614,岩手県,大槌町,5,2,決算収支の状況,1,令和4年度,11105331,10555763,549568,161738,387830,-423000,342,36895,671701,-1057464
2022,61,34827,岩手県,山田町,5,2,決算収支の状況,1,令和4年度,13768164,13158178,609986,245846,364140,258936,604,0,1827274,-1567734
2022,61,34835,岩手県,岩泉町,5,2,決算収支の状況,1,令和4年度,10676887,9996454,680433,30272,650161,22054,314136,0,0,336190
2022,61,34843,岩手県,田野畑村,5,2,決算収支の状況,1,令和4年度,4524944,4335614,189330,33217,156113,309,766324,0,60843,705790
2022,61,34851,岩手県,普代村,5,2,決算収支の状況,1,令和4年度,4310899,4234227,76672,20971,55701,-14425,46614,0,0,32189
2022,61,35017,岩手県,軽米町,5,2,決算収支の状況,1,令和4年度,8608773,7967505,641268,153499,487769,-42646,266006,0,0,223360
2022,61,35033,岩手県,野田村,5,2,決算収支の状況,1,令和4年度,4712333,4483905,228428,7889,220539,7461,27268,0,0,34729
2022,61,35068,岩手県,九戸村,5,2,決算収支の状況,1,令和4年度,5242138,4904731,337407,266913,70494,2704,33895,0,200000,-163401
2022,61,35076,岩手県,洋野町,5,2,決算収支の状況,1,令和4年度,11260951,11148745,112206,42931,69275,-496988,301172,0,0,-195816
2022,61,35246,岩手県,一戸町,5,2,決算収支の状況,1,令和4年度,9808998,9364841,444157,152474,291683,-3506,183009,0,183009,-3506
2022,61,38083,岩手県,矢櫃山造林一部事務組合,6,2,決算収支の状況,1,令和4年度,2673,1100,1573,0,1573,-60,0,0,0,-60
2022,61,38156,岩手県,岩手県市町村総合事務組合,6,2,決算収支の状況,1,令和4年度,9549636,9490487,59149,0,59149,-170683,0,0,0,-170683
2022,61,38181,岩手県,大船渡地区消防組合,6,2,決算収支の状況,1,令和4年度,934266,916653,17613,0,17613,-5654,0,0,0,-5654
2022,61,38199,岩手県,北上地区広域行政組合,6,2,決算収支の状況,1,令和4年度,488976,449487,39489,16665,22824,2880,0,0,0,2880
2022,61,38288,岩手県,二戸地区広域行政事務組合,6,2,決算収支の状況,1,令和4年度,2349434,2279708,69726,0,69726,-39482,0,0,0,-39482
2022,61,38296,岩手県,盛岡北部行政事務組合,6,2,決算収支の状況,1,令和4年度,523136,499777,23359,0,23359,-1421,1,0,0,-1420
2022,61,38334,岩手県,岩手・玉山環境組合,6,2,決算収支の状況,1,令和4年度,483583,445568,38015,0,38015,1558,0,0,0,1558
2022,61,38407,岩手県,盛岡・紫波地区環境施設組合,6,2,決算収支の状況,1,令和4年度,2145033,2075632,69401,0,69401,-14298,0,0,0,-14298
2022,61,38440,岩手県,岩手県競馬組合,7,2,決算収支の状況,1,令和4年度,0,0,0,0,0,0,0,0,0,0
2022,61,38539,岩手県,岩手県沿岸知的障害児施設組合,6,2,決算収支の状況,1,令和4年度,129538,129477,61,0,61,-17683,0,0,0,-17683
2022,61,38547,岩手県,盛岡地区衛生処理組合,6,2,決算収支の状況,1,令和4年度,595102,582104,12998,9400,3598,2478,0,0,0,2478
2022,61,38555,岩手県,大船渡地区環境衛生組合,6,2,決算収支の状況,1,令和4年度,252888,243697,9191,0,9191,-3978,0,0,0,-3978
2022,61,38563,岩手県,盛岡地区広域消防組合,6,2,決算収支の状況,1,令和4年度,7071031,7004844,66187,9169,57018,-1782,0,0,0,-1782
2022,61,38628,岩手県,釜石大槌地区行政事務組合,6,2,決算収支の状況,1,令和4年度,1427907,1395451,32456,5902,26554,-1305,17515,0,10161,6049
2022,61,38679,岩手県,宮古地区広域行政組合,6,2,決算収支の状況,1,令和4年度,3213316,3050100,163216,75884,87332,23144,0,0,0,23144
2022,61,38709,岩手県,北上地区消防組合,6,2,決算収支の状況,1,令和4年度,1598342,1524476,73866,41480,32386,4059,0,0,0,4059
2022,61,38733,岩手県,奥州金ケ崎行政事務組合,6,2,決算収支の状況,1,令和4年度,3319806,3243233,76573,0,76573,-8654,0,0,0,-8654
2022,61,38750,岩手県,岩手県自治会館管理組合,6,2,決算収支の状況,1,令和4年度,76211,69029,7182,0,7182,2315,1,0,13413,-11097
2022,61,38784,岩手県,気仙広域連合,6,2,決算収支の状況,1,令和4年度,233514,220005,13509,0,13509,2293,0,0,0,2293
2022,61,38806,岩手県,久慈広域連合,6,2,決算収支の状況,1,令和4年度,3969778,3827073,142705,37817,104888,10630,0,0,0,10630
2022,61,38814,岩手県,岩手中部広域行政組合,6,2,決算収支の状況,1,令和4年度,580266,536490,43776,4070,39706,4060,0,0,0,4060
2022,61,38822,岩手県,一関地区広域行政組合,6,2,決算収支の状況,1,令和4年度,3086191,2896568,189623,47017,142606,-26262,168881,0,157765,-15146
2022,61,38831,岩手県,岩手沿岸南部広域環境組合,6,2,決算収支の状況,1,令和4年度,1571032,1561490,9542,0,9542,-1568,8012,0,0,6444
2022,61,38849,岩手県,岩手県後期高齢者医療広域連合,7,2,決算収支の状況,1,令和4年度,128227,119167,9060,0,9060,3136,5925,0,5564,3497
2022,61,38865,岩手県,滝沢・雫石環境組合,6,2,決算収支の状況,1,令和4年度,1479490,1431235,48255,8250,40005,-4832,0,0,0,-4832
2022,61,38938,岩手県,盛岡広域環境組合,6,2,決算収支の状況,1,令和4年度,10819,8815,2004,0,2004,2004,0,0,0,2004
2022,61,41009,宮城県,仙台市,1,2,決算収支の状況,1,令和4年度,590227702,582541084,7686618,4089977,3596641,-3297972,234091,0,7973789,-11037670
2022,61,42021,宮城県,石巻市,3,2,決算収支の状況,1,令和4年度,122895649,119002426,3893223,915298,2977925,-2054182,292,0,2600000,-4653890
2022,61,42030,宮城県,塩竈市,4,2,決算収支の状況,1,令和4年度,26499905,24894502,1605403,171900,1433503,302518,131032,0,709207,-275657
2022,61,42056,宮城県,気仙沼市,4,2,決算収支の状況,1,令和4年度,55766176,52806193,2959983,397415,2562568,-1274282,255,0,3300000,-4574027
2022,61,42064,宮城県,白石市,4,2,決算収支の状況,1,令和4年度,19835110,19258047,577063,179030,398033,-236028,3536,0,500000,-732492
2022,61,42072,宮城県,名取市,4,2,決算収支の状況,1,令和4年度,37135502,35437301,1698201,353225,1344976,314700,1075,26420,281347,60848
2022,61,42081,宮城県,角田市,4,2,決算収支の状況,1,令和4年度,18078620,17270557,808063,245741,562322,33547,24,0,0,33571
2022,61,42099,宮城県,多賀城市,4,2,決算収支の状況,1,令和4年度,27610079,25619046,1991033,901591,1089442,50033,553423,0,0,603456
2022,61,42111,宮城県,岩沼市,4,2,決算収支の状況,1,令和4年度,20133579,18759381,1374198,44755,1329443,-58085,4284,0,320697,-374498
2022,61,42129,宮城県,登米市,4,2,決算収支の状況,1,令和4年度,46229277,44893154,1336123,196537,1139586,-25485,4131,0,1334587,-1355941
2022,61,42137,宮城県,栗原市,4,2,決算収支の状況,1,令和4年度,47472318,46095787,1376531,123608,1252923,-39295,674552,1785,1318905,-681863
2022,61,42145,宮城県,東松島市,4,2,決算収支の状況,1,令和4年度,24318556,23346496,972060,194627,777433,-164454,30,0,335634,-500058
2022,61,42153,宮城県,大崎市,3,2,決算収支の状況,1,令和4年度,74959352,71870313,3089039,581449,2507590,238871,5821,0,1931287,-1686595
2022,61,42161,宮城県,富谷市,4,2,決算収支の状況,1,令和4年度,18572840,16542574,2030266,490768,1539498,488727,530874,0,444119,575482
2022,61,43010,宮城県,蔵王町,5,2,決算収支の状況,1,令和4年度,7891825,7686286,205539,47631,157908,-36138,42,0,317278,-353374
2022,61,43028,宮城県,七ケ宿町,5,2,決算収支の状況,1,令和4年度,2837326,2722309,115017,43560,71457,-29154,1928,0,17000,-44226
2022,61,43214,宮城県,大河原町,5,2,決算収支の状況,1,令和4年度,11474082,11079025,395057,4164,390893,36791,132097,0,0,168888
2022,61,43222,宮城県,村田町,5,2,決算収支の状況,1,令和4年度,6314215,6051023,263192,70595,192597,19057,95747,0,0,114804
2022,61,43231,宮城県,柴田町,5,2,決算収支の状況,1,令和4年度,16235691,15826078,409613,45059,364554,-122253,30,0,294831,-417054
2022,61,43249,宮城県,川崎町,5,2,決算収支の状況,1,令和4年度,5815164,5432905,382259,43034,339225,67812,500,0,0,68312
2022,61,43419,宮城県,丸森町,5,2,決算収支の状況,1,令和4年度,20151295,17869562,2281733,325182,1956551,1684689,2972,0,99606,1588055
2022,61,43613,宮城県,亘理町,5,2,決算収支の状況,1,令和4年度,16196880,15395664,801216,108858,692358,395132,440562,0,0,835694
2022,61,43621,宮城県,山元町,5,2,決算収支の状況,1,令和4年度,12381836,11710100,671736,137559,534177,41704,256536,1331315,218568,1410987
2022,61,44016,宮城県,松島町,5,2,決算収支の状況,1,令和4年度,7976066,7513178,462888,92463,370425,-15843,36283,0,349692,-329252
2022,61,44041,宮城県,七ケ浜町,5,2,決算収支の状況,1,令和4年度,8336709,7701317,635392,279690,355702,16209,178296,0,186874,7631
2022,61,44067,宮城県,利府町,5,2,決算収支の状況,1,令和4年度,13764219,13142172,622047,27821,594226,10841,1283,0,250116,-237992
2022,61,44211,宮城県,大和町,5,2,決算収支の状況,1,令和4年度,14266665,13267054,999611,455037,544574,187156,6455,0,104245,89366
2022,61,44229,宮城県,大郷町,5,2,決算収支の状況,1,令和4年度,6256343,5449017,807326,278841,528485,1416,212,0,205518,-203890
2022,61,44245,宮城県,大衡村,5,2,決算収支の状況,1,令和4年度,5142041,4945359,196682,19894,176788,91793,3437,0,140000,-44770
2022,61,44440,宮城県,色麻町,5,2,決算収支の状況,1,令和4年度,4870987,4748118,122869,6829,116040,-16217,10000,0,50000,-56217
2022,61,44458,宮城県,加美町,5,2,決算収支の状況,1,令和4年度,15005437,14068369,937068,152338,784730,-141421,9552,0,400000,-531869
2022,61,45012,宮城県,涌谷町,5,2,決算収支の状況,1,令和4年度,8458515,8172311,286204,146778,139426,40552,386112,0,0,426664
2022,61,45055,宮城県,美里町,5,2,決算収支の状況,1,令和4年度,11856124,11479381,376743,27752,348991,25961,283,0,196561,-170317
2022,61,45811,宮城県,女川町,5,2,決算収支の状況,1,令和4年度,14155618,13107283,1048335,897414,150921,-7631,70741,0,900000,-836890
2022,61,46060,宮城県,南三陸町,5,2,決算収支の状況,1,令和4年度,15087425,13995534,1091891,362216,729675,-634461,6933,0,700000,-1327528
2022,61,48101,宮城県,色麻町外一市一ヶ村花川ダム管理組合,6,2,決算収支の状況,1,令和4年度,4892,4143,749,0,749,-159,1,0,1770,-1928
2022,61,48151,宮城県,吉田川流域溜池大和町外３市３ヶ町村組合,6,2,決算収支の状況,1,令和4年度,1569,1221,348,0,348,15,0,0,0,15
2022,61,48160,宮城県,大衡村外一町牛野ダム管理組合,6,2,決算収支の状況,1,令和4年度,1867,1291,576,0,576,-161,2,0,0,-159
2022,61,48453,宮城県,白石市外二町組合,6,2,決算収支の状況,1,令和4年度,2833,2469,364,0,364,213,0,0,0,213
2022,61,48674,宮城県,黒川地域行政事務組合,6,2,決算収支の状況,1,令和4年度,2830502,2665683,164819,61727,103092,82971,11249,0,61553,32667
2022,61,48691,宮城県,亘理名取共立衛生処理組合,6,2,決算収支の状況,1,令和4年度,2646767,2596027,50740,0,50740,29691,21889,0,89000,-37420
2022,61,48721,宮城県,宮城東部衛生処理組合,6,2,決算収支の状況,1,令和4年度,1035125,1031760,3365,0,3365,-15329,59,0,26858,-42128
2022,61,49221,宮城県,宮城県市町村職員退職手当組合,6,2,決算収支の状況,1,令和4年度,12628981,12063346,565635,0,565635,119926,121000,0,2179000,-1938074
2022,61,49255,宮城県,宮城県市町村非常勤消防団員補償報償組合,6,2,決算収支の状況,1,令和4年度,865118,862917,2201,0,2201,224,49,0,2000,-1727
2022,61,49280,宮城県,石巻地区広域行政事務組合,6,2,決算収支の状況,1,令和4年度,6343686,6148094,195592,35500,160092,67089,40889,0,35370,72608
2022,61,49298,宮城県,塩釜地区消防事務組合,6,2,決算収支の状況,1,令和4年度,2876465,2833147,43318,0,43318,-30105,307,0,81786,-111584
2022,61,49310,宮城県,亘理地区行政事務組合,6,2,決算収支の状況,1,令和4年度,1344565,1313811,30754,0,30754,7852,1,0,20210,-12357
2022,61,49328,宮城県,仙南地域広域行政事務組合,6,2,決算収支の状況,1,令和4年度,4943874,4795525,148349,0,148349,490,54304,0,156200,-101406
2022,61,49361,宮城県,大崎地域広域行政事務組合,6,2,決算収支の状況,1,令和4年度,8716337,8391523,324814,140625,184189,81248,8707,0,99307,-9352
2022,61,49387,宮城県,気仙沼・本吉地域広域行政事務組合,6,2,決算収支の状況,1,令和4年度,2110646,2075368,35278,0,35278,6495,1,0,9852,-3356
2022,61,49654,宮城県,宮城県市町村自治振興センター,6,2,決算収支の状況,1,令和4年度,174258,171356,2902,0,2902,34,0,0,5101,-5067
2022,61,49689,宮城県,加美郡保健医療福祉行政事務組合,6,2,決算収支の状況,1,令和4年度,883213,878054,5159,0,5159,-2965,30500,0,0,27535
2022,61,49727,宮城県,宮城県後期高齢者医療広域連合,7,2,決算収支の状況,1,令和4年度,245387,184762,60625,0,60625,-17329,77964,0,34772,25863
2022,61,52019,秋田県,秋田市,8,2,決算収支の状況,1,令和4年度,152422038,149822795,2599243,762538,1836705,-66760,745478,0,842908,-164190
2022,61,52027,秋田県,能代市,4,2,決算収支の状況,1,令和4年度,33822510,32344314,1478196,377293,1100903,48877,526149,0,1035398,-460372
2022,61,52035,秋田県,横手市,4,2,決算収支の状況,1,令和4年度,59150500,55976753,3173747,182230,2991517,550111,1218050,0,1722714,45447
2022,61,52043,秋田県,大館市,4,2,決算収支の状況,1,令和4年度,44600264,42547884,2052380,300205,1752175,-410475,949855,400000,1181211,-241831
2022,61,52060,秋田県,男鹿市,4,2,決算収支の状況,1,令和4年度,18096760,17631335,465425,11114,454311,15042,358389,0,733984,-360553
2022,61,52078,秋田県,湯沢市,4,2,決算収支の状況,1,令和4年度,30496181,29596316,899865,56616,843249,84652,377101,0,369111,92642
2022,61,52094,秋田県,鹿角市,4,2,決算収支の状況,1,令和4年度,20656167,19816167,840000,282525,557475,161295,204269,0,379403,-13839
2022,61,52108,秋田県,由利本荘市,4,2,決算収支の状況,1,令和4年度,54367057,52937413,1429644,387530,1042114,731134,1308689,0,1644917,394906
2022,61,52116,秋田県,潟上市,4,2,決算収支の状況,1,令和4年度,17210701,16197161,1013540,36288,977252,-104368,816374,0,370000,342006
2022,61,52124,秋田県,大仙市,4,2,決算収支の状況,1,令和4年度,50315400,48032707,2282693,118789,2163904,-118476,700098,0,200000,381622
2022,61,52132,秋田県,北秋田市,4,2,決算収支の状況,1,令和4年度,25339642,23716868,1622774,706666,916108,179785,664291,0,0,844076
2022,61,52141,秋田県,にかほ市,4,2,決算収支の状況,1,令和4年度,17838911,17180260,658651,100285,558366,135032,257981,0,0,393013
2022,61,52159,秋田県,仙北市,4,2,決算収支の状況,1,令和4年度,22614873,22063488,551385,19391,531994,33083,24,0,253717,-220610
2022,61,53031,秋田県,小坂町,5,2,決算収支の状況,1,令和4年度,5265117,5024404,240713,150399,90314,-17655,615517,36854,378400,256316
2022,61,53279,秋田県,上小阿仁村,5,2,決算収支の状況,1,令和4年度,2776894,2630979,145915,89892,56023,-60518,58617,0,1892,-3793
2022,61,53465,秋田県,藤里町,5,2,決算収支の状況,1,令和4年度,4500846,4340424,160422,17000,143422,18671,69562,0,128552,-40319
2022,61,53481,秋田県,三種町,5,2,決算収支の状況,1,令和4年度,10948748,10451378,497370,216467,280903,90769,95153,0,108210,77712
2022,61,53490,秋田県,八峰町,5,2,決算収支の状況,1,令和4年度,7025299,6664717,360582,77339,283243,131041,75313,0,392868,-186514
2022,61,53619,秋田県,五城目町,5,2,決算収支の状況,1,令和4年度,6634856,6403274,231582,69077,162505,-273375,110836,56942,0,-105597
2022,61,53635,秋田県,八郎潟町,5,2,決算収支の状況,1,令和4年度,4095594,3885286,210308,6951,203357,2818,2232,144996,134769,15277
2022,61,53660,秋田県,井川町,5,2,決算収支の状況,1,令和4年度,3760827,3398167,362660,48179,314481,75154,3000,0,25000,53154
2022,61,53686,秋田県,大潟村,5,2,決算収支の状況,1,令和4年度,3901563,3708220,193343,5017,188326,-6772,1000,0,0,-5772
2022,61,54348,秋田県,美郷町,5,2,決算収支の状況,1,令和4年度,13279775,12772594,507181,50974,456207,-69882,1784,333208,0,265110
2022,61,54631,秋田県,羽後町,5,2,決算収支の状況,1,令和4年度,9073769,8633688,440081,52646,387435,-4092,463375,0,0,459283
2022,61,54640,秋田県,東成瀬村,5,2,決算収支の状況,1,令和4年度,4400459,4321744,78715,2930,75785,13509,606000,59785,314000,365294
2022,61,58041,秋田県,秋田県市町村総合事務組合,6,2,決算収支の状況,1,令和4年度,7169941,7083017,86924,0,86924,-226511,0,0,0,-226511
2022,61,58220,秋田県,井川町・潟上市共有財産管理組合,6,2,決算収支の状況,1,令和4年度,8347,4652,3695,0,3695,566,0,0,0,566
2022,61,58394,秋田県,北秋田市上小阿仁村生活環境施設組合,6,2,決算収支の状況,1,令和4年度,90006,87881,2125,0,2125,-2245,3622,0,9040,-7663
2022,61,58505,秋田県,湯沢雄勝広域市町村圏組合,6,2,決算収支の状況,1,令和4年度,3256472,3217064,39408,0,39408,6315,0,0,0,6315
2022,61,58548,秋田県,本荘由利広域市町村圏組合,6,2,決算収支の状況,1,令和4年度,1381962,1290327,91635,7172,84463,-22271,0,0,0,-22271
2022,61,58611,秋田県,能代山本広域市町村圏組合,6,2,決算収支の状況,1,令和4年度,3699967,3610982,88985,1760,87225,-13001,0,0,0,-13001
2022,61,58629,秋田県,大曲仙北広域市町村圏組合,6,2,決算収支の状況,1,令和4年度,5189739,5135162,54577,1,54576,22590,22445,0,76651,-31616
2022,61,58653,秋田県,三種・八峰養護老人ホーム組合,6,2,決算収支の状況,1,令和4年度,270885,186510,84375,0,84375,3603,0,0,0,3603
2022,61,58670,秋田県,鹿角広域行政組合,6,2,決算収支の状況,1,令和4年度,1816300,1777857,38443,3073,35370,-4319,0,0,0,-4319
2022,61,58726,秋田県,男鹿地区消防一部事務組合,6,2,決算収支の状況,1,令和4年度,1431444,1412323,19121,605,18516,-2872,0,0,0,-2872
2022,61,58742,秋田県,男鹿地区衛生処理一部事務組合,6,2,決算収支の状況,1,令和4年度,213662,209670,3992,0,3992,-2302,260,0,0,-2042
2022,61,58785,秋田県,大仙美郷介護福祉組合,6,2,決算収支の状況,1,令和4年度,119766,119766,0,0,0,0,0,0,0,0
2022,61,58815,秋田県,湖東地区行政一部事務組合,6,2,決算収支の状況,1,令和4年度,611379,592153,19226,0,19226,11133,0,0,0,11133
2022,61,58823,秋田県,八郎潟町・井川町衛生処理施設組合,6,2,決算収支の状況,1,令和4年度,63611,59713,3898,0,3898,358,0,0,6000,-5642
2022,61,58831,秋田県,秋田県市町村会館管理組合,6,2,決算収支の状況,1,令和4年度,146046,134880,11166,0,11166,256,1,0,0,257
2022,61,58840,秋田県,八郎湖周辺清掃事務組合,6,2,決算収支の状況,1,令和4年度,653210,638258,14952,0,14952,11772,0,0,10210,1562
2022,61,58858,秋田県,秋田県後期高齢者医療広域連合,7,2,決算収支の状況,1,令和4年度,104086,70382,33704,0,33704,-3129,0,0,0,-3129
2022,61,58866,秋田県,秋田県町村電算システム共同事業組合,6,2,決算収支の状況,1,令和4年度,808670,802031,6639,0,6639,-1138,0,0,0,-1138
2022,61,62014,山形県,山形市,8,2,決算収支の状況,1,令和4年度,120040990,116397300,3643690,1105501,2538189,-1214865,1856270,0,1726874,-1085469
2022,61,62022,山形県,米沢市,4,2,決算収支の状況,1,令和4年度,44780263,42950196,1830067,369851,1460216,96604,700176,0,750000,46780
2022,61,62031,山形県,鶴岡市,3,2,決算収支の状況,1,令和4年度,77545655,75760993,1784662,48002,1736660,-435181,365076,370643,0,300538
2022,61,62049,山形県,酒田市,3,2,決算収支の状況,1,令和4年度,61847946,60128141,1719805,108936,1610869,-325100,1150954,432200,755751,502303
2022,61,62057,山形県,新庄市,4,2,決算収支の状況,1,令和4年度,20608121,19751099,857022,67539,789483,-431656,250029,0,0,-181627
2022,61,62065,山形県,寒河江市,4,2,決算収支の状況,1,令和4年度,27090552,26089986,1000566,73745,926821,47599,7,0,0,47606
2022,61,62073,山形県,上山市,4,2,決算収支の状況,1,令和4年度,19272927,17780724,1492203,163927,1328276,375255,55099,969941,0,1400295
2022,61,62081,山形県,村山市,4,2,決算収支の状況,1,令和4年度,18432509,17130797,1301712,90896,1210816,-229422,12,9744,180000,-399666
2022,61,62090,山形県,長井市,4,2,決算収支の状況,1,令和4年度,22035980,21395150,640830,47918,592912,-22243,13,75512,147462,-94180
2022,61,62103,山形県,天童市,4,2,決算収支の状況,1,令和4年度,32660631,30423006,2237625,299389,1938236,153371,890317,0,245079,798609
2022,61,62111,山形県,東根市,4,2,決算収支の状況,1,令和4年度,25877478,24909722,967756,12201,955555,-222322,401,0,0,-221921
2022,61,62120,山形県,尾花沢市,4,2,決算収支の状況,1,令和4年度,15244689,14432995,811694,86298,725396,-171981,546706,0,448271,-73546
2022,61,62138,山形県,南陽市,4,2,決算収支の状況,1,令和4年度,17840226,16564902,1275324,100368,1174956,-11184,690844,300,569386,110574
2022,61,63011,山形県,山辺町,5,2,決算収支の状況,1,令和4年度,6978757,6639624,339133,440,338693,118702,170043,0,0,288745
2022,61,63029,山形県,中山町,5,2,決算収支の状況,1,令和4年度,5682282,5404017,278265,8644,269621,-51270,89117,0,0,37847
2022,61,63215,山形県,河北町,5,2,決算収支の状況,1,令和4年度,11283294,10961867,321427,16154,305273,-44994,49,0,66418,-111363
2022,61,63223,山形県,西川町,5,2,決算収支の状況,1,令和4年度,6434561,5997773,436788,39568,397220,92688,118,0,150000,-57194
2022,61,63231,山形県,朝日町,5,2,決算収支の状況,1,令和4年度,7045703,6612525,433178,41655,391523,-72019,159,0,391861,-463721
2022,61,63240,山形県,大江町,5,2,決算収支の状況,1,令和4年度,6624344,6275153,349191,55602,293589,-12816,394410,0,167800,213794
2022,61,63410,山形県,大石田町,5,2,決算収支の状況,1,令和4年度,6560393,6095095,465298,97259,368039,98860,135020,33400,80000,187280
2022,61,63614,山形県,金山町,5,2,決算収支の状況,1,令和4年度,5141708,4834870,306838,3797,303041,20655,245907,0,391000,-124438
2022,61,63622,山形県,最上町,5,2,決算収支の状況,1,令和4年度,7509943,7085502,424441,84144,340297,71876,274253,0,444253,-98124
2022,61,63631,山形県,舟形町,5,2,決算収支の状況,1,令和4年度,6021585,5741999,279586,35201,244385,-2542,123476,0,130823,-9889
2022,61,63649,山形県,真室川町,5,2,決算収支の状況,1,令和4年度,6848417,6648819,199598,17540,182058,-242364,303106,248572,0,309314
2022,61,63657,山形県,大蔵村,5,2,決算収支の状況,1,令和4年度,4351444,4265899,85545,26689,58856,-45768,52015,0,0,6247
2022,61,63665,山形県,鮭川村,5,2,決算収支の状況,1,令和4年度,4922207,4461392,460815,115365,345450,-174707,270027,0,230000,-134680
2022,61,63673,山形県,戸沢村,5,2,決算収支の状況,1,令和4年度,5234734,4641337,593397,42992,550405,-16112,300366,0,290000,-5746
2022,61,63819,山形県,高畠町,5,2,決算収支の状況,1,令和4年度,12771839,11996936,774903,22986,751917,-8131,410756,0,252004,150621
2022,61,63827,山形県,川西町,5,2,決算収支の状況,1,令和4年度,13202607,12505829,696778,146873,549905,252970,5,0,91150,161825
2022,61,64017,山形県,小国町,5,2,決算収支の状況,1,令和4年度,8024306,7339428,684878,174145,510733,37689,100007,0,0,137696
2022,61,64025,山形県,白鷹町,5,2,決算収支の状況,1,令和4年度,10748508,9853664,894844,89940,804904,-88781,80669,0,40000,-48112
2022,61,64033,山形県,飯豊町,5,2,決算収支の状況,1,令和4年度,8256101,7724246,531855,202951,328904,-91759,144454,0,408000,-355305
2022,61,64262,山形県,三川町,5,2,決算収支の状況,1,令和4年度,5649656,5302877,346779,27,346752,35612,193725,0,127400,101937
2022,61,64289,山形県,庄内町,5,2,決算収支の状況,1,令和4年度,13718764,12781379,937385,65094,872291,72394,3234,0,0,75628
2022,61,64611,山形県,遊佐町,5,2,決算収支の状況,1,令和4年度,10542572,9908514,634058,100827,533231,-10172,321783,0,409300,-97689
2022,61,68012,山形県,山形県消防補償等組合,6,2,決算収支の状況,1,令和4年度,1107526,1104349,3177,0,3177,-385,1570,0,0,1185
2022,61,68021,山形県,山形県自治会館管理組合,6,2,決算収支の状況,1,令和4年度,85246,71370,13876,0,13876,1548,16005,0,0,17553
2022,61,68039,山形県,山形県市町村職員退職手当組合,6,2,決算収支の状況,1,令和4年度,6733357,6651641,81716,0,81716,-364,0,0,0,-364
2022,61,68217,山形県,東根市外二市一町共立衛生処理組合,6,2,決算収支の状況,1,令和4年度,2183387,2094031,89356,0,89356,-1756,0,0,0,-1756
2022,61,68314,山形県,山形広域環境事務組合,6,2,決算収支の状況,1,令和4年度,3695263,3659489,35774,0,35774,-48133,0,0,0,-48133
2022,61,68829,山形県,松川堰組合,6,2,決算収支の状況,1,令和4年度,11358,10019,1339,0,1339,-601,0,0,0,-601
2022,61,69230,山形県,山形県市町村交通災害共済組合,7,2,決算収支の状況,1,令和4年度,0,0,0,0,0,0,0,0,0,0
2022,61,69451,山形県,庄内広域行政組合（普通会計分）,6,2,決算収支の状況,1,令和4年度,28970,25907,3063,0,3063,-300,0,0,0,-300
2022,61,69515,山形県,最上広域市町村圏事務組合,6,2,決算収支の状況,1,令和4年度,3006956,2922722,84234,5004,79230,720,1,0,21086,-20365
2022,61,69523,山形県,置賜広域行政事務組合,6,2,決算収支の状況,1,令和4年度,6102809,5978335,124474,785,123689,-12969,0,0,0,-12969
2022,61,69531,山形県,西村山広域行政事務組合（普通会計分）,6,2,決算収支の状況,1,令和4年度,2595208,2567774,27434,0,27434,-17840,5,0,12219,-30054
2022,61,69540,山形県,北村山広域行政事務組合,6,2,決算収支の状況,1,令和4年度,99491,83340,16151,0,16151,5154,0,0,0,5154
2022,61,69639,山形県,酒田地区広域行政組合,6,2,決算収支の状況,1,令和4年度,3251698,3169769,81929,0,81929,14085,0,0,0,14085
2022,61,69647,山形県,河北町ほか２市広域斎場事務組合,6,2,決算収支の状況,1,令和4年度,73956,66896,7060,0,7060,-248,0,0,0,-248
2022,61,69655,山形県,尾花沢市大石田町環境衛生事業組合（普通会計分）,6,2,決算収支の状況,1,令和4年度,855770,821369,34401,9284,25117,692,0,0,0,692
2022,61,69698,山形県,西置賜行政組合,6,2,決算収支の状況,1,令和4年度,1673962,1630174,43788,74,43714,-19362,0,0,0,-19362
2022,61,69728,山形県,最上地区広域連合（普通会計分）,6,2,決算収支の状況,1,令和4年度,179922,168575,11347,0,11347,-16904,24207,0,0,7303
2022,61,69736,山形県,最上地区広域連合（事業会計分）,7,2,決算収支の状況,1,令和4年度,0,0,0,0,0,0,0,0,0,0
2022,61,69744,山形県,山形県後期高齢者医療広域連合（普通会計分）,6,2,決算収支の状況,1,令和4年度,259396,167402,91994,0,91994,-3115,1,0,0,-3114
2022,61,69752,山形県,山形県後期高齢者医療広域連合（事業会計分）,7,2,決算収支の状況,1,令和4年度,0,0,0,0,0,0,0,0,0,0
2022,61,72010,福島県,福島市,8,2,決算収支の状況,1,令和4年度,134771525,124709832,10061693,3488895,6572798,-1971743,1500469,0,1500000,-1971274
2022,61,72028,福島県,会津若松市,3,2,決算収支の状況,1,令和4年度,60312704,56732143,3580561,257727,3322834,-903040,1148116,0,0,245076
2022,61,72036,福島県,郡山市,8,2,決算収支の状況,1,令和4年度,156163710,148796156,7367554,714228,6653326,-247659,6796131,0,6200000,348472
2022,61,72044,福島県,いわき市,8,2,決算収支の状況,1,令和4年度,162309312,155323600,6985712,786343,6199369,-1949268,7741098,0,4839676,952154
2022,61,72052,福島県,白河市,4,2,決算収支の状況,1,令和4年度,34631932,32961249,1670683,205590,1465093,-258515,964680,654637,1107112,253690
2022,61,72079,福島県,須賀川市,4,2,決算収支の状況,1,令和4年度,36685610,35452235,1233375,91526,1141849,247413,0,3596,100000,151009
2022,61,72087,福島県,喜多方市,4,2,決算収支の状況,1,令和4年度,29888252,29091749,796503,96738,699765,-59723,388689,0,742715,-413749
2022,61,72095,福島県,相馬市,4,2,決算収支の状況,1,令和4年度,26825079,24633431,2191648,1606830,584818,15720,417,0,560958,-544821
2022,61,72109,福島県,二本松市,4,2,決算収支の状況,1,令和4年度,33655397,31372576,2282821,593931,1688890,-443946,667232,0,517000,-293714
2022,61,72117,福島県,田村市,4,2,決算収支の状況,1,令和4年度,27830899,25316084,2514815,1307012,1207803,126822,14795,0,0,141617
2022,61,72125,福島県,南相馬市,4,2,決算収支の状況,1,令和4年度,56476128,50109049,6367079,4327080,2039999,-480631,2416552,0,1324832,611089
2022,61,72133,福島県,伊達市,4,2,決算収支の状況,1,令和4年度,39735310,36913529,2821781,326591,2495190,-87071,1300037,0,1715950,-502984
2022,61,72141,福島県,本宮市,4,2,決算収支の状況,1,令和4年度,19202732,17632630,1570102,300150,1269952,28051,533154,12627,850397,-276565
2022,61,73016,福島県,桑折町,5,2,決算収支の状況,1,令和4年度,7495459,7054553,440906,7045,433861,-150146,1245,0,0,-148901
2022,61,73032,福島県,国見町,5,2,決算収支の状況,1,令和4年度,8347861,7119425,1228436,586593,641843,127964,50094,264537,0,442595
2022,61,73083,福島県,川俣町,5,2,決算収支の状況,1,令和4年度,12660245,11795943,864302,337449,526853,-128014,22,169698,368324,-326618
2022,61,73229,福島県,大玉村,5,2,決算収支の状況,1,令和4年度,5825398,5346794,478604,6716,471888,-29699,260019,0,140000,90320
2022,61,73423,福島県,鏡石町,5,2,決算収支の状況,1,令和4年度,7026172,6715550,310622,169251,141371,14124,63029,0,155343,-78190
2022,61,73440,福島県,天栄村,5,2,決算収支の状況,1,令和4年度,5594515,5311258,283257,82580,200677,42120,80031,0,345000,-222849
2022,61,73628,福島県,下郷町,5,2,決算収支の状況,1,令和4年度,5037100,4665913,371187,8424,362763,23738,62,0,0,23800
2022,61,73644,福島県,檜枝岐村,5,2,決算収支の状況,1,令和4年度,2066120,1974467,91653,570,91083,-9883,19,70154,74753,-14463
2022,61,73679,福島県,只見町,5,2,決算収支の状況,1,令和4年度,6128240,5977219,151021,60897,90124,2598,39,56384,0,59021
2022,61,73687,福島県,南会津町,5,2,決算収支の状況,1,令和4年度,13388728,12929178,459550,21151,438399,34606,202129,0,200000,36735
2022,61,74021,福島県,北塩原村,5,2,決算収支の状況,1,令和4年度,3580593,3380370,200223,40783,159440,-11424,50008,0,0,38584
2022,61,74055,福島県,西会津町,5,2,決算収支の状況,1,令和4年度,7226380,6617577,608803,327086,281717,76581,368685,0,585876,-140610
2022,61,74071,福島県,磐梯町,5,2,決算収支の状況,1,令和4年度,4940781,4764658,176123,26441,149682,14422,98184,0,0,112606
2022,61,74080,福島県,猪苗代町,5,2,決算収支の状況,1,令和4年度,9678575,9350838,327737,18884,308853,1253,335859,0,0,337112
2022,61,74217,福島県,会津坂下町,5,2,決算収支の状況,1,令和4年度,9046269,8540795,505474,40940,464534,83315,231681,104441,119853,299584
2022,61,74225,福島県,湯川村,5,2,決算収支の状況,1,令和4年度,2954653,2844225,110428,17557,92871,-9736,54016,0,46000,-1720
2022,61,74233,福島県,柳津町,5,2,決算収支の状況,1,令和4年度,4268179,4104214,163965,44300,119665,-73592,18,0,0,-73574
2022,61,74446,福島県,三島町,5,2,決算収支の状況,1,令和4年度,2807223,2702200,105023,727,104296,-57670,23,0,0,-57647
2022,61,74454,福島県,金山町,5,2,決算収支の状況,1,令和4年度,3648250,3433726,214524,2304,212220,-37210,15,45172,103659,-95682
2022,61,74462,福島県,昭和村,5,2,決算収支の状況,1,令和4年度,2417330,2264821,152509,27869,124640,23226,108,0,79754,-56420
2022,61,74471,福島県,会津美里町,5,2,決算収支の状況,1,令和4年度,13897635,13297581,600054,46608,553446,139040,282618,1053328,355679,1119307
2022,61,74616,福島県,西郷村,5,2,決算収支の状況,1,令和4年度,12675411,12048613,626798,71355,555443,-6258,280901,0,0,274643
2022,61,74641,福島県,泉崎村,5,2,決算収支の状況,1,令和4年度,4020712,3668753,351959,50878,301081,-65760,20503,0,0,-45257
2022,61,74659,福島県,中島村,5,2,決算収支の状況,1,令和4年度,3519394,3225624,293770,83046,210724,-19105,125,0,63584,-82564
2022,61,74667,福島県,矢吹町,5,2,決算収支の状況,1,令和4年度,8967474,8706488,260986,42413,218573,-200580,702,46899,328839,-481818
2022,61,74811,福島県,棚倉町,5,2,決算収支の状況,1,令和4年度,7672339,7405438,266901,79903,186998,-253997,8,0,100000,-353989
2022,61,74829,福島県,矢祭町,5,2,決算収支の状況,1,令和4年度,5253941,4820580,433361,64493,368868,-252909,160031,318489,0,225611
2022,61,74837,福島県,塙町,5,2,決算収支の状況,1,令和4年度,7546861,7317562,229299,31271,198028,60880,68691,0,0,129571
2022,61,74845,福島県,鮫川村,5,2,決算収支の状況,1,令和4年度,3724361,3444821,279540,15803,263737,46655,107669,0,90000,64324
2022,61,75019,福島県,石川町,5,2,決算収支の状況,1,令和4年度,8746225,8172392,573833,83097,490736,-104850,253912,2621,0,151683
2022,61,75027,福島県,玉川村,5,2,決算収支の状況,1,令和4年度,5020193,4507100,513093,178186,334907,75826,133563,0,29000,180389
2022,61,75035,福島県,平田村,5,2,決算収支の状況,1,令和4年度,5349007,5023329,325678,38561,287117,-82342,220015,0,0,137673
2022,61,75043,福島県,浅川町,5,2,決算収支の状況,1,令和4年度,4159789,3995622,164167,19628,144539,-26197,260000,0,170000,63803
2022,61,75051,福島県,古殿町,5,2,決算収支の状況,1,令和4年度,5062892,4927842,135050,9069,125981,-97522,160682,0,246418,-183258
2022,61,75213,福島県,三春町,5,2,決算収支の状況,1,令和4年度,10293975,9701672,592303,126131,466172,-176868,502613,0,345608,-19863
2022,61,75221,福島県,小野町,5,2,決算収支の状況,1,令和4年度,5951936,5637267,314669,38860,275809,54219,110606,0,69658,95167
2022,61,75418,福島県,広野町,5,2,決算収支の状況,1,令和4年度,7672637,7128747,543890,48749,495141,105341,700496,0,0,805837
2022,61,75426,福島県,楢葉町,5,2,決算収支の状況,1,令和4年度,12076159,11292507,783652,358739,424913,-341803,1569,0,241855,-582089
2022,61,75434,福島県,富岡町,5,2,決算収支の状況,1,令和4年度,16412286,14758513,1653773,657833,995940,-330566,965947,0,1062674,-427293
2022,61,75442,福島県,川内村,5,2,決算収支の状況,1,令和4年度,8786909,8303096,483813,143821,339992,283347,0,0,0,283347
2022,61,75451,福島県,大熊町,5,2,決算収支の状況,1,令和4年度,33320383,24113271,9207112,8249545,957567,391569,6849,0,300000,98418
2022,61,75469,福島県,双葉町,5,2,決算収支の状況,1,令和4年度,18613287,16592672,2020615,573068,1447547,-6762,730941,0,500000,224179
2022,61,75477,福島県,浪江町,5,2,決算収支の状況,1,令和4年度,33419516,32034082,1385434,564536,820898,192414,321051,0,458092,55373
2022,61,75485,福島県,葛尾村,5,2,決算収支の状況,1,令和4年度,6736584,6243320,493264,212935,280329,98053,36,0,0,98089
2022,61,75612,福島県,新地町,5,2,決算収支の状況,1,令和4年度,8764551,7520034,1244517,603542,640975,182159,230126,0,0,412285
2022,61,75647,福島県,飯舘村,5,2,決算収支の状況,1,令和4年度,14008548,12598687,1409861,399963,1009898,932809,404,0,0,933213
2022,61,78026,福島県,福島県市町村総合事務組合,6,2,決算収支の状況,1,令和4年度,8480160,7062579,1417581,0,1417581,243355,0,0,0,243355
2022,61,78069,福島県,川俣方部衛生処理組合,6,2,決算収支の状況,1,令和4年度,204774,189591,15183,0,15183,-874,11770,0,24841,-13945
2022,61,78077,福島県,福島県市民交通災害共済組合,7,2,決算収支の状況,1,令和4年度,0,0,0,0,0,0,0,0,0,0
2022,61,78085,福島県,福島県伊達郡国見町桑折町有北山組合,6,2,決算収支の状況,1,令和4年度,823,647,176,0,176,-46,84,0,0,38
2022,61,78115,福島県,伊達地方衛生処理組合,6,2,決算収支の状況,1,令和4年度,1170592,1154007,16585,0,16585,-75,255,0,604,-424
2022,61,78204,福島県,須賀川地方保健環境組合,6,2,決算収支の状況,1,令和4年度,2881206,2063994,817212,564869,252343,12537,0,0,0,12537
2022,61,78255,福島県,耶麻郡磐梯町外一市二町一ケ村組合,6,2,決算収支の状況,1,令和4年度,20255,13775,6480,0,6480,-20,7345,0,4800,2525
2022,61,78441,福島県,東白衛生組合,6,2,決算収支の状況,1,令和4年度,826812,801215,25597,0,25597,-26663,0,0,0,-26663
2022,61,78468,福島県,石川地方生活環境施設組合,6,2,決算収支の状況,1,令和4年度,888596,812351,76245,0,76245,-5870,0,0,0,-5870
2022,61,78531,福島県,田村広域行政組合,6,2,決算収支の状況,1,令和4年度,1231423,1117682,113741,0,113741,78562,0,0,4672,73890
2022,61,78620,福島県,相馬方部衛生組合,6,2,決算収支の状況,1,令和4年度,805123,743350,61773,0,61773,-41108,0,0,0,-41108
2022,61,78671,福島県,白河地方広域市町村圏整備組合,6,2,決算収支の状況,1,令和4年度,3943233,3832145,111088,0,111088,-64355,0,0,0,-64355
2022,61,78689,福島県,喜多方地方広域市町村圏組合,6,2,決算収支の状況,1,令和4年度,2523390,2468288,55102,3569,51533,2815,0,0,0,2815
2022,61,78697,福島県,伊達地方消防組合,6,2,決算収支の状況,1,令和4年度,2004993,1979789,25204,0,25204,-4074,21806,0,60000,-42268
2022,61,78701,福島県,相馬地方広域市町村圏組合,6,2,決算収支の状況,1,令和4年度,1888812,1741244,147568,0,147568,-157,0,0,0,-157
2022,61,78719,福島県,安達地方広域行政組合,6,2,決算収支の状況,1,令和4年度,4690892,4452679,238213,107,238106,49518,40,0,85000,-35442
2022,61,78727,福島県,会津若松地方広域市町村圏整備組合,6,2,決算収支の状況,1,令和4年度,8126858,8001343,125515,0,125515,-12644,95012,0,48784,33584
2022,61,78735,福島県,双葉地方広域市町村圏組合,6,2,決算収支の状況,1,令和4年度,3098920,3042462,56458,2535,53923,-53175,10373,0,199482,-242284
2022,61,78751,福島県,須賀川地方広域消防組合,6,2,決算収支の状況,1,令和4年度,2318770,2291492,27278,4389,22889,-6133,17,0,0,-6116
2022,61,78760,福島県,郡山地方広域消防組合,6,2,決算収支の状況,1,令和4年度,4869765,4820643,49122,0,49122,-4910,9,34178,0,29277
2022,61,78778,福島県,南会津地方広域市町村圏組合,6,2,決算収支の状況,1,令和4年度,1038895,1001047,37848,0,37848,379,18800,0,21000,-1821
2022,61,78921,福島県,福島県後期高齢者医療広域連合,7,2,決算収支の状況,1,令和4年度,155733,129055,26678,8500,18178,-56,0,0,0,-56
2022,61,78930,福島県,南会津地方環境衛生組合,6,2,決算収支の状況,1,令和4年度,1081594,1058031,23563,0,23563,9163,7211,0,26000,-9626
2022,61,82015,茨城県,水戸市,8,2,決算収支の状況,1,令和4年度,140461271,135235114,5226157,967076,4259081,-1790273,3018092,0,1886888,-659069
2022,61,82023,茨城県,日立市,3,2,決算収支の状況,1,令和4年度,82206423,77637142,4569281,1100090,3469191,-1005933,1882282,0,1379790,-503441
2022,61,82031,茨城県,土浦市,3,2,決算収支の状況,1,令和4年度,61076073,57106026,3970047,1035321,2934726,174,1000375,0,1172162,-171613
2022,61,82040,茨城県,古河市,3,2,決算収支の状況,1,令和4年度,58829165,55779166,3049999,467062,2582937,-1138683,800287,816089,0,477693
2022,61,82058,茨城県,石岡市,4,2,決算収支の状況,1,令和4年度,37092747,34353225,2739522,279424,2460098,1050385,133,0,0,1050518
2022,61,82074,茨城県,結城市,4,2,決算収支の状況,1,令和4年度,20752557,19418777,1333780,29648,1304132,-302530,100699,0,0,-201831
2022,61,82082,茨城県,龍ケ崎市,4,2,決算収支の状況,1,令和4年度,31224289,29252004,1972285,187814,1784471,-843562,200426,0,0,-643136
2022,61,82104,茨城県,下妻市,4,2,決算収支の状況,1,令和4年度,23388562,21462386,1926176,76377,1849799,398065,460269,0,0,858334
2022,61,82112,茨城県,常総市,4,2,決算収支の状況,1,令和4年度,30281881,28446606,1835275,374954,1460321,460321,160468,80250,0,701039
2022,61,82121,茨城県,常陸太田市,4,2,決算収支の状況,1,令和4年度,27272659,25920114,1352545,228413,1124132,-400402,763793,0,0,363391
2022,61,82147,茨城県,高萩市,4,2,決算収支の状況,1,令和4年度,14229006,13407442,821564,64525,757039,-64849,104394,0,82000,-42455
2022,61,82155,茨城県,北茨城市,4,2,決算収支の状況,1,令和4年度,21305861,20147778,1158083,163675,994408,35167,723451,0,0,758618
2022,61,82163,茨城県,笠間市,4,2,決算収支の状況,1,令和4年度,35639315,34279256,1360059,219231,1140828,-111962,16884,0,0,-95078
2022,61,82171,茨城県,取手市,3,2,決算収支の状況,1,令和4年度,48124278,46390791,1733487,144700,1588787,144327,723491,0,537639,330179
2022,61,82198,茨城県,牛久市,4,2,決算収支の状況,1,令和4年度,33247825,31273889,1973936,209001,1764935,-392061,520804,401000,0,529743
2022,61,82201,茨城県,つくば市,9,2,決算収支の状況,1,令和4年度,118539756,112958322,5581434,1263996,4317438,-1946093,7845777,0,744466,5155218
2022,61,82210,茨城県,ひたちなか市,3,2,決算収支の状況,1,令和4年度,62464135,58613335,3850800,641497,3209303,-51243,41,0,0,-51202
2022,61,82228,茨城県,鹿嶋市,4,2,決算収支の状況,1,令和4年度,27223075,26563358,659717,38048,621669,-721517,623,900,293654,-1013648
2022,61,82236,茨城県,潮来市,4,2,決算収支の状況,1,令和4年度,14811289,13783106,1028183,44890,983293,-296152,30,0,0,-296122
2022,61,82244,茨城県,守谷市,4,2,決算収支の状況,1,令和4年度,35773339,31727823,4045516,1347844,2697672,497414,92,0,1538725,-1041219
2022,61,82252,茨城県,常陸大宮市,4,2,決算収支の状況,1,令和4年度,25191922,24724766,467156,150163,316993,-502398,400822,0,0,-101576
2022,61,82261,茨城県,那珂市,4,2,決算収支の状況,1,令和4年度,24126803,22691166,1435637,81151,1354486,-51954,500,0,0,-51454
2022,61,82279,茨城県,筑西市,3,2,決算収支の状況,1,令和4年度,49916645,46601167,3315478,373630,2941848,-137829,73,0,0,-137756
2022,61,82287,茨城県,坂東市,4,2,決算収支の状況,1,令和4年度,23360732,21958495,1402237,109830,1292407,437339,143955,0,0,581294
2022,61,82295,茨城県,稲敷市,4,2,決算収支の状況,1,令和4年度,25371110,23935936,1435174,502178,932996,-116133,4201,0,0,-111932
2022,61,82309,茨城県,かすみがうら市,4,2,決算収支の状況,1,令和4年度,20719981,19881887,838094,164709,673385,-516122,1137,0,0,-514985
2022,61,82317,茨城県,桜川市,4,2,決算収支の状況,1,令和4年度,23631784,21703180,1928604,226540,1702064,-132865,622,0,0,-132243
2022,61,82325,茨城県,神栖市,4,2,決算収支の状況,1,令和4年度,51766397,48393603,3372794,135347,3237447,-1240551,2307454,4583,1690846,-619360
2022,61,82333,茨城県,行方市,4,2,決算収支の状況,1,令和4年度,18854471,18078513,775958,133442,642516,100747,177086,0,0,277833
2022,61,82341,茨城県,鉾田市,4,2,決算収支の状況,1,令和4年度,24604614,22925572,1679042,446674,1232368,263206,101727,0,400000,-35067
2022,61,82350,茨城県,つくばみらい市,4,2,決算収支の状況,1,令和4年度,27101769,26175131,926638,55315,871323,333284,270222,0,494634,108872
2022,61,82368,茨城県,小美玉市,4,2,決算収支の状況,1,令和4年度,25465671,24630188,835483,183929,651554,-412566,2364,323033,0,-87169
2022,61,83020,茨城県,茨城町,5,2,決算収支の状況,1,令和4年度,13596902,12806167,790735,165179,625556,-58304,16,0,0,-58288
2022,61,83097,茨城県,大洗町,5,2,決算収支の状況,1,令和4年度,10380391,9726279,654112,76315,577797,-107541,4,0,0,-107537
2022,61,83101,茨城県,城里町,5,2,決算収支の状況,1,令和4年度,10717433,10215472,501961,143677,358284,-37286,198199,0,254128,-93215
2022,61,83411,茨城県,東海村,5,2,決算収支の状況,1,令和4年度,20956635,20219176,737459,63442,674017,-461133,435282,0,0,-25851
2022,61,83640,茨城県,大子町,5,2,決算収支の状況,1,令和4年度,13212265,11667582,1544683,330955,1213728,-202461,858,0,0,-201603
2022,61,84425,茨城県,美浦村,5,2,決算収支の状況,1,令和4年度,7086266,6754740,331526,4264,327262,-43143,143887,0,0,100744
2022,61,84433,茨城県,阿見町,5,2,決算収支の状況,1,令和4年度,19881770,18451718,1430052,141963,1288089,-167676,331847,0,0,164171
2022,61,84476,茨城県,河内町,5,2,決算収支の状況,1,令和4年度,6278191,5728007,550184,62199,487985,56197,120002,0,0,176199
2022,61,85219,茨城県,八千代町,5,2,決算収支の状況,1,令和4年度,10128549,9422864,705685,3454,702231,-50516,300000,0,71117,178367
2022,61,85421,茨城県,五霞町,5,2,決算収支の状況,1,令和4年度,5225437,4733431,492006,140508,351498,-41373,26736,0,68030,-82667
2022,61,85464,茨城県,境町,5,2,決算収支の状況,1,令和4年度,26262717,25048884,1213833,265687,948146,-109072,58009,0,0,-51063
2022,61,85642,茨城県,利根町,5,2,決算収支の状況,1,令和4年度,7229077,6942770,286307,12928,273379,-5429,138717,0,282668,-149380
2022,61,88366,茨城県,大宮地方環境整備組合,6,2,決算収支の状況,1,令和4年度,1318756,1198301,120455,0,120455,-38765,0,0,0,-38765
2022,61,88404,茨城県,清水丘診療所事務組合,7,2,決算収支の状況,1,令和4年度,0,0,0,0,0,0,0,0,0,0
2022,61,88439,茨城県,常総衛生組合,6,2,決算収支の状況,1,令和4年度,321593,280214,41379,15730,25649,-19498,0,0,0,-19498
2022,61,88455,茨城県,龍ヶ崎地方塵芥処理組合,6,2,決算収支の状況,1,令和4年度,1479443,1401005,78438,2273,76165,18951,25802,0,54485,-9732
2022,61,88501,茨城県,龍ヶ崎地方衛生組合,6,2,決算収支の状況,1,令和4年度,398584,370036,28548,8433,20115,-3150,20,0,2273,-5403
2022,61,88510,茨城県,さしま環境管理事務組合,6,2,決算収支の状況,1,令和4年度,3638354,3172145,466209,234316,231893,109224,232748,0,0,341972
2022,61,88536,茨城県,筑北環境衛生組合,6,2,決算収支の状況,1,令和4年度,226175,221372,4803,0,4803,-11422,0,0,0,-11422
2022,61,88552,茨城県,茨城地方広域環境事務組合,6,2,決算収支の状況,1,令和4年度,318108,287493,30615,0,30615,443,0,0,0,443
2022,61,88579,茨城県,取手市外２市火葬場組合,6,2,決算収支の状況,1,令和4年度,200560,174928,25632,0,25632,-1224,0,0,0,-1224
2022,61,88595,茨城県,大洗，鉾田，水戸環境組合,6,2,決算収支の状況,1,令和4年度,703889,588690,115199,34100,81099,19061,23,0,0,19084
2022,61,88676,茨城県,江戸崎地方衛生土木組合,6,2,決算収支の状況,1,令和4年度,2054437,1983495,70942,0,70942,9656,100,0,0,9756
2022,61,88714,茨城県,湖北環境衛生組合,6,2,決算収支の状況,1,令和4年度,494513,441527,52986,0,52986,-34760,0,0,0,-34760
2022,61,88838,茨城県,茨城西南地方広域市町村圏事務組合,6,2,決算収支の状況,1,令和4年度,4862900,4702458,160442,66000,94442,37173,141,0,115888,-78574
2022,61,88862,茨城県,筑西広域市町村圏事務組合,6,2,決算収支の状況,1,令和4年度,10401773,9818103,583670,25631,558039,206361,0,0,0,206361
2022,61,88951,茨城県,常総地方広域市町村圏事務組合,6,2,決算収支の状況,1,令和4年度,7064941,6312812,752129,22567,729562,80564,0,0,0,80564
2022,61,88960,茨城県,鹿行広域事務組合,6,2,決算収支の状況,1,令和4年度,2332769,2241699,91070,0,91070,-5996,18,0,0,-5978
2022,61,88986,茨城県,霞台厚生施設組合,6,2,決算収支の状況,1,令和4年度,2299070,2042872,256198,61533,194665,42913,0,0,0,42913
2022,61,89010,茨城県,稲敷地方広域市町村圏事務組合,6,2,決算収支の状況,1,令和4年度,4258575,4204698,53877,12860,41017,-18573,6687,0,0,-11886
2022,61,89079,茨城県,茨城県市町村総合事務組合（普通会計分）,6,2,決算収支の状況,1,令和4年度,16046221,16024897,21324,6975,14349,-7473,1172000,0,103000,1061527
2022,61,89087,茨城県,茨城県市町村総合事務組合（事業会計分）,7,2,決算収支の状況,1,令和4年度,0,0,0,0,0,0,0,0,0,0
2022,61,89095,茨城県,石岡地方斎場組合,6,2,決算収支の状況,1,令和4年度,265085,211272,53813,10285,43528,-20185,0,0,0,-20185
2022,61,89109,茨城県,笠間地方広域事務組合,6,2,決算収支の状況,1,令和4年度,168137,164233,3904,0,3904,-6565,10260,0,0,3695
2022,61,89168,茨城県,鹿島地方事務組合,6,2,決算収支の状況,1,令和4年度,9441490,8785502,655988,366135,289853,174546,0,0,0,174546
2022,61,89257,茨城県,高萩・北茨城広域事務組合,6,2,決算収支の状況,1,令和4年度,4042888,3853533,189355,186423,2932,737,0,0,0,737
2022,61,89346,茨城県,下妻地方広域事務組合,6,2,決算収支の状況,1,令和4年度,1637213,1456272,180941,5280,175661,-79562,0,0,0,-79562
2022,61,89354,茨城県,ひたちなか・東海広域事務組合,6,2,決算収支の状況,1,令和4年度,3609217,3553003,56214,1256,54958,5438,0,0,0,5438
2022,61,89389,茨城県,牛久市・阿見町斎場組合,6,2,決算収支の状況,1,令和4年度,428798,387226,41572,0,41572,37517,2029,0,2696,36850
2022,61,89401,茨城県,茨城租税債権管理機構,6,2,決算収支の状況,1,令和4年度,468100,242285,225815,0,225815,21725,0,0,0,21725
2022,61,89427,茨城県,利根川水系県南水防事務組合,6,2,決算収支の状況,1,令和4年度,13694,12362,1332,0,1332,-96,1048,0,7985,-7033
2022,61,89443,茨城県,茨城県後期高齢者医療広域連合,7,2,決算収支の状況,1,令和4年度,122079,117615,4464,0,4464,-5368,1,0,0,-5367
2022,61,89451,茨城県,土浦・かすみがうら土地区画整理一部事務組合,6,2,決算収支の状況,1,令和4年度,550635,367678,182957,172839,10118,4821,0,0,0,4821
2022,61,89460,茨城県,鉾田・大洗広域事務組合,6,2,決算収支の状況,1,令和4年度,242952,179993,62959,46334,16625,-17798,1055,0,0,-16743
2022,61,92011,栃木県,宇都宮市,8,2,決算収支の状況,1,令和4年度,268708797,261444038,7264759,3420568,3844191,-2603996,21150,0,4500000,-7082846
2022,61,92029,栃木県,足利市,3,2,決算収支の状況,1,令和4年度,58291820,54478619,3813201,167169,3646032,592500,387,0,0,592887
2022,61,92037,栃木県,栃木市,3,2,決算収支の状況,1,令和4年度,72647538,67798603,4848935,625303,4223632,655513,1784443,53194,2098959,394191
2022,61,92045,栃木県,佐野市,3,2,決算収支の状況,1,令和4年度,57393481,54077193,3316288,79634,3236654,-92910,2039852,0,1824241,122701
2022,61,92053,栃木県,鹿沼市,4,2,決算収支の状況,1,令和4年度,48654681,46433358,2221323,977653,1243670,-395810,505107,0,530000,-420703
2022,61,92061,栃木県,日光市,4,2,決算収支の状況,1,令和4年度,44485352,42406364,2078988,157948,1921040,85166,24,0,0,85190
2022,61,92088,栃木県,小山市,3,2,決算収支の状況,1,令和4年度,72615679,69656146,2959533,217839,2741694,-404986,1513030,0,950650,157394
2022,61,92096,栃木県,真岡市,4,2,決算収支の状況,1,令和4年度,38874635,34952778,3921857,342614,3579243,-41427,2472,0,0,-38955
2022,61,92100,栃木県,大田原市,4,2,決算収支の状況,1,令和4年度,35650613,32498782,3151831,136016,3015815,-66802,500012,0,0,433210
2022,61,92118,栃木県,矢板市,4,2,決算収支の状況,1,令和4年度,15515336,14798197,717139,47111,670028,-341619,103137,0,0,-238482
2022,61,92134,栃木県,那須塩原市,3,2,決算収支の状況,1,令和4年度,57360402,54243376,3117026,614993,2502033,-1200807,1851142,0,1830000,-1179665
2022,61,92142,栃木県,さくら市,4,2,決算収支の状況,1,令和4年度,22652054,20624823,2027231,327500,1699731,80095,10852,0,0,90947
2022,61,92151,栃木県,那須烏山市,4,2,決算収支の状況,1,令和4年度,13327882,12402484,925398,77753,847645,331939,103762,0,81977,353724
2022,61,92169,栃木県,下野市,4,2,決算収支の状況,1,令和4年度,30522983,27937777,2585206,424986,2160220,-150706,4475,0,25000,-171231
2022,61,93017,栃木県,上三川町,5,2,決算収支の状況,1,令和4年度,12702650,11589572,1113078,312422,800656,-173398,144,0,0,-173254
2022,61,93424,栃木県,益子町,5,2,決算収支の状況,1,令和4年度,9085150,8814909,270241,31464,238777,-414306,22,0,0,-414284
2022,61,93432,栃木県,茂木町,5,2,決算収支の状況,1,令和4年度,9375858,8267020,1108838,157911,950927,-269352,669364,0,398350,1662
2022,61,93441,栃木県,市貝町,5,2,決算収支の状況,1,令和4年度,6960279,6331742,628537,118424,510113,-305131,55000,0,200000,-450131
2022,61,93459,栃木県,芳賀町,5,2,決算収支の状況,1,令和4年度,15634965,14852027,782938,199747,583191,-131785,358532,0,500000,-273253
2022,61,93611,栃木県,壬生町,5,2,決算収支の状況,1,令和4年度,17715956,16955496,760460,14830,745630,-181453,138880,0,0,-42573
2022,61,93645,栃木県,野木町,5,2,決算収支の状況,1,令和4年度,9042962,8506280,536682,21431,515251,-41252,113,0,0,-41139
2022,61,93840,栃木県,塩谷町,5,2,決算収支の状況,1,令和4年度,7881456,6901629,979827,646309,333518,7659,99,0,0,7758
2022,61,93866,栃木県,高根沢町,5,2,決算収支の状況,1,令和4年度,10933356,10546725,386631,36433,350198,-112252,27,0,0,-112225
2022,61,94072,栃木県,那須町,5,2,決算収支の状況,1,令和4年度,15023691,13818934,1204757,43840,1160917,256770,534050,0,400000,390820
2022,61,94111,栃木県,那珂川町,5,2,決算収支の状況,1,令和4年度,9722053,8665824,1056229,42611,1013618,38184,500,0,83964,-45280
2022,61,98060,栃木県,那須地区広域行政事務組合（普通会計分）,6,2,決算収支の状況,1,令和4年度,1783540,1501141,282399,3630,278769,81928,0,0,0,81928
2022,61,98086,栃木県,佐野地区衛生施設組合,6,2,決算収支の状況,1,令和4年度,690327,641285,49042,0,49042,27013,11621,0,43732,-5098
2022,61,98124,栃木県,黒磯那須共同火葬場組合,6,2,決算収支の状況,1,令和4年度,53173,49730,3443,0,3443,290,0,0,0,290
2022,61,98213,栃木県,芳賀郡中部環境衛生事務組合,6,2,決算収支の状況,1,令和4年度,245351,218207,27144,0,27144,-4847,0,0,0,-4847
2022,61,98281,栃木県,石橋地区消防組合,6,2,決算収支の状況,1,令和4年度,2257851,2185785,72066,0,72066,-12929,76815,0,0,63886
2022,61,98337,栃木県,芳賀地区広域行政事務組合（普通会計分）,6,2,決算収支の状況,1,令和4年度,4319999,4005997,314002,16786,297216,-873,0,0,0,-873
2022,61,98418,栃木県,南那須地区広域行政事務組合（普通会計分）,6,2,決算収支の状況,1,令和4年度,1759176,1684657,74519,0,74519,28799,16283,0,73900,-28818
2022,61,98507,栃木県,塩谷広域行政組合,6,2,決算収支の状況,1,令和4年度,3587068,3455239,131829,4480,127349,-8432,168906,0,205764,-45290
2022,61,98523,栃木県,小山広域保健衛生組合,6,2,決算収支の状況,1,令和4年度,4295980,3987110,308870,0,308870,51952,202745,0,0,254697
2022,61,98540,栃木県,宇都宮西中核工業団地事務組合（普通会計分）,6,2,決算収支の状況,1,令和4年度,173223,162815,10408,0,10408,-3940,0,0,0,-3940
2022,61,98621,栃木県,栃木県市町村総合事務組合,6,2,決算収支の状況,1,令和4年度,7728036,7540658,187378,0,187378,-40415,820204,0,0,779789
2022,61,98639,栃木県,栃木県後期高齢者医療広域連合,7,2,決算収支の状況,1,令和4年度,180684,171737,8947,0,8947,1144,73349,0,0,74493
2022,61,98647,栃木県,那須地区消防組合,6,2,決算収支の状況,1,令和4年度,3859617,3771621,87996,0,87996,-81054,0,0,0,-81054
2022,61,102016,群馬県,前橋市,8,2,決算収支の状況,1,令和4年度,161792003,155389274,6402729,1236405,5166324,1020712,43594,0,2687278,-1622972
2022,61,102024,群馬県,高崎市,8,2,決算収支の状況,1,令和4年度,180343287,172707825,7635462,438624,7196838,-990910,10588,0,3671140,-4651462
2022,61,102032,群馬県,桐生市,3,2,決算収支の状況,1,令和4年度,52243844,49211880,3031964,445332,2586632,-976125,462,0,718292,-1693955
2022,61,102041,群馬県,伊勢崎市,9,2,決算収支の状況,1,令和4年度,83772180,80354024,3418156,315007,3103149,-95482,258,0,548670,-643894
2022,61,102059,群馬県,太田市,9,2,決算収支の状況,1,令和4年度,93218060,88492103,4725957,1435539,3290418,340046,13200,0,1157565,-804319
2022,61,102067,群馬県,沼田市,4,2,決算収支の状況,1,令和4年度,24721811,23519303,1202508,346039,856469,-121056,1518,0,529825,-649363
2022,61,102075,群馬県,館林市,4,2,決算収支の状況,1,令和4年度,32401969,29659795,2742174,29716,2712458,34282,4209,0,1751714,-1713223
2022,61,102083,群馬県,渋川市,4,2,決算収支の状況,1,令和4年度,37256945,35505632,1751313,151384,1599929,-756557,356,0,870323,-1626524
2022,61,102091,群馬県,藤岡市,4,2,決算収支の状況,1,令和4年度,28064605,27008254,1056351,158010,898341,-466451,56,0,0,-466395
2022,61,102105,群馬県,富岡市,4,2,決算収支の状況,1,令和4年度,24144054,23176426,967628,124964,842664,-411649,5999,0,568589,-974239
2022,61,102113,群馬県,安中市,4,2,決算収支の状況,1,令和4年度,26967759,25530887,1436872,133633,1303239,-113689,622,0,400000,-513067
2022,61,102121,群馬県,みどり市,4,2,決算収支の状況,1,令和4年度,22269797,20611750,1658047,151820,1506227,160665,5653,0,902062,-735744
2022,61,103446,群馬県,榛東村,5,2,決算収支の状況,1,令和4年度,7372392,7160476,211916,34465,177451,-181552,100579,0,200000,-280973
2022,61,103454,群馬県,吉岡町,5,2,決算収支の状況,1,令和4年度,8825860,8642904,182956,157202,25754,-214500,120087,0,260000,-354413
2022,61,103667,群馬県,上野村,5,2,決算収支の状況,1,令和4年度,3956198,3652756,303442,32551,270891,177390,8,0,50000,127398
2022,61,103675,群馬県,神流町,5,2,決算収支の状況,1,令和4年度,3154405,3009972,144433,36299,108134,56791,67,0,0,56858
2022,61,103829,群馬県,下仁田町,5,2,決算収支の状況,1,令和4年度,5483392,5374567,108825,4123,104702,2496,426481,0,0,428977
2022,61,103837,群馬県,南牧村,5,2,決算収支の状況,1,令和4年度,2629789,2378194,251595,59567,192028,-27271,774,0,0,-26497
2022,61,103845,群馬県,甘楽町,5,2,決算収支の状況,1,令和4年度,6281378,5885566,395812,71481,324331,11136,23108,0,0,34244
2022,61,104213,群馬県,中之条町,5,2,決算収支の状況,1,令和4年度,11535645,10816313,719332,177863,541469,-218437,13780,0,342077,-546734
2022,61,104248,群馬県,長野原町,5,2,決算収支の状況,1,令和4年度,5606792,5105725,501067,49999,451068,52831,202621,0,0,255452
2022,61,104256,群馬県,嬬恋村,5,2,決算収支の状況,1,令和4年度,9105482,8827415,278067,267065,11002,-278662,150032,0,125000,-253630
2022,61,104264,群馬県,草津町,5,2,決算収支の状況,1,令和4年度,6590789,6484350,106439,11884,94555,-12617,491541,0,439000,39924
2022,61,104281,群馬県,高山村,5,2,決算収支の状況,1,令和4年度,3244592,3084236,160356,40595,119761,-52253,74398,0,0,22145
2022,61,104299,群馬県,東吾妻町,5,2,決算収支の状況,1,令和4年度,8661687,8330858,330829,49842,280987,2303,51583,0,0,53886
2022,61,104434,群馬県,片品村,5,2,決算収支の状況,1,令和4年度,4620856,4255357,365499,17724,347775,-165935,151044,0,0,-14891
2022,61,104442,群馬県,川場村,5,2,決算収支の状況,1,令和4年度,5186230,4609277,576953,107878,469075,198828,13,0,331400,-132559
2022,61,104485,群馬県,昭和村,5,2,決算収支の状況,1,令和4年度,7648044,7156666,491378,42935,448443,-45446,1118,0,42440,-86768
2022,61,104493,群馬県,みなかみ町,5,2,決算収支の状況,1,令和4年度,16128274,15137450,990824,209474,781350,18541,52,0,420000,-401407
2022,61,104647,群馬県,玉村町,5,2,決算収支の状況,1,令和4年度,13229133,12276810,952323,46703,905620,28971,100093,0,0,129064
2022,61,105210,群馬県,板倉町,5,2,決算収支の状況,1,令和4年度,7053689,6374204,679485,27969,651516,-208905,499438,0,0,290533
2022,61,105228,群馬県,明和町,5,2,決算収支の状況,1,令和4年度,8037156,7587974,449182,195110,254072,-120330,564659,0,150000,294329
2022,61,105236,群馬県,千代田町,5,2,決算収支の状況,1,令和4年度,9287791,8700117,587674,33006,554668,-262795,824367,0,350000,211572
2022,61,105244,群馬県,大泉町,5,2,決算収支の状況,1,令和4年度,16368883,15650087,718796,0,718796,-60707,393031,0,1119619,-787295
2022,61,105252,群馬県,邑楽町,5,2,決算収支の状況,1,令和4年度,11736607,11176768,559839,69486,490353,39301,527422,0,450000,116723
2022,61,108065,群馬県,烏帽子山植林組合,6,2,決算収支の状況,1,令和4年度,877,563,314,0,314,183,0,0,0,183
2022,61,108383,群馬県,甘楽西部環境衛生施設組合,6,2,決算収支の状況,1,令和4年度,281011,265989,15022,2695,12327,1108,0,0,0,1108
2022,61,108391,群馬県,館林衛生施設組合,6,2,決算収支の状況,1,令和4年度,2877999,2827012,50987,6750,44237,-7999,0,0,45000,-52999
2022,61,108405,群馬県,吾妻東部衛生施設組合,6,2,決算収支の状況,1,令和4年度,761709,729322,32387,0,32387,4551,43078,0,61245,-13616
2022,61,108421,群馬県,西吾妻衛生施設組合,6,2,決算収支の状況,1,令和4年度,102142,91799,10343,0,10343,-3224,0,0,0,-3224
2022,61,108618,群馬県,館林地区消防組合,6,2,決算収支の状況,1,令和4年度,2555043,2390592,164451,0,164451,-564,2,0,29599,-30161
2022,61,108626,群馬県,利根沼田広域市町村圏振興整備組合,6,2,決算収支の状況,1,令和4年度,2094192,2057089,37103,0,37103,-1919,13074,0,25132,-13977
2022,61,108634,群馬県,高崎市・安中市消防組合,6,2,決算収支の状況,1,令和4年度,4866059,4818490,47569,5522,42047,-10879,0,0,0,-10879
2022,61,108707,群馬県,西吾妻環境衛生施設組合,6,2,決算収支の状況,1,令和4年度,531095,497795,33300,0,33300,24968,0,0,15700,9268
2022,61,108731,群馬県,渋川地区広域市町村圏振興整備組合,6,2,決算収支の状況,1,令和4年度,3393004,3230365,162639,11550,151089,60580,109,0,101280,-40591
2022,61,108740,群馬県,富岡甘楽広域市町村圏振興整備組合,6,2,決算収支の状況,1,令和4年度,2168377,2130551,37826,2849,34977,-18529,2,0,10464,-28991
2022,61,108758,群馬県,沼田市外二箇村清掃施設組合,6,2,決算収支の状況,1,令和4年度,512361,488973,23388,0,23388,12285,1,0,35400,-23114
2022,61,108766,群馬県,群馬県市町村会館管理組合,6,2,決算収支の状況,1,令和4年度,158779,134335,24444,0,24444,2674,0,0,0,2674
2022,61,108804,群馬県,吾妻広域町村圏振興整備組合（普通会計分）,6,2,決算収支の状況,1,令和4年度,1715982,1687535,28447,0,28447,-20399,43846,0,83738,-60291
2022,61,108821,群馬県,多野藤岡広域市町村圏振興整備組合,6,2,決算収支の状況,1,令和4年度,2062821,2033306,29515,0,29515,8203,29,8834,44859,-27793
2022,61,108839,群馬県,利根沼田学校組合,6,2,決算収支の状況,1,令和4年度,537710,513102,24608,0,24608,2567,1,0,11040,-8472
2022,61,108901,群馬県,大泉町外二町環境衛生施設組合,6,2,決算収支の状況,1,令和4年度,328552,303802,24750,0,24750,-8426,0,0,0,-8426
2022,61,108928,群馬県,利根東部衛生施設組合,6,2,決算収支の状況,1,令和4年度,255305,240523,14782,0,14782,6555,1,0,0,6556
2022,61,109061,群馬県,群馬県市町村総合事務組合,6,2,決算収支の状況,1,令和4年度,4299908,3690670,609238,0,609238,33191,46127,0,5200,74118
2022,61,109142,群馬県,太田市外三町広域清掃組合,6,2,決算収支の状況,1,令和4年度,3279950,2762782,517168,30800,486368,176919,0,0,0,176919
2022,61,109185,群馬県,群馬県後期高齢者医療広域連合,7,2,決算収支の状況,1,令和4年度,90726,85246,5480,0,5480,-616,2,0,5170,-5784
2022,61,109207,群馬県,吾妻環境施設組合,6,2,決算収支の状況,1,令和4年度,22399,13435,8964,0,8964,8315,0,0,0,8315
2022,61,111007,埼玉県,さいたま市,1,2,決算収支の状況,1,令和4年度,666656729,657348945,9307784,3347174,5960610,-1367147,7328244,0,0,5961097
2022,61,112011,埼玉県,川越市,8,2,決算収支の状況,1,令和4年度,130378426,121558311,8820115,273357,8546758,871497,645751,0,0,1517248
2022,61,112020,埼玉県,熊谷市,9,2,決算収支の状況,1,令和4年度,77291761,71316890,5974871,721120,5253751,-1030379,8206,0,0,-1022173
2022,61,112038,埼玉県,川口市,8,2,決算収支の状況,1,令和4年度,244212253,234444172,9768081,1333655,8434426,-2063524,4334,0,1025676,-3084866
2022,61,112062,埼玉県,行田市,4,2,決算収支の状況,1,令和4年度,32304803,29405151,2899652,154322,2745330,-113236,153071,0,0,39835
2022,61,112071,埼玉県,秩父市,4,2,決算収支の状況,1,令和4年度,34459654,31906181,2553473,247070,2306403,28409,1488612,809602,1050000,1276623
2022,61,112089,埼玉県,所沢市,9,2,決算収支の状況,1,令和4年度,128036480,116895054,11141426,1152812,9988614,2349321,3635628,0,4423538,1561411
2022,61,112097,埼玉県,飯能市,4,2,決算収支の状況,1,令和4年度,34306807,32086337,2220470,184407,2036063,435096,102637,0,0,537733
2022,61,112101,埼玉県,加須市,3,2,決算収支の状況,1,令和4年度,48363156,42630407,5732749,669641,5063108,2878,884,0,0,3762
2022,61,112119,埼玉県,本庄市,4,2,決算収支の状況,1,令和4年度,34266860,31405620,2861240,371535,2489705,-610040,350478,1493,0,-258069
2022,61,112127,埼玉県,東松山市,4,2,決算収支の状況,1,令和4年度,36312967,33999469,2313498,487370,1826128,-24442,1270661,0,1220000,26219
2022,61,112143,埼玉県,春日部市,9,2,決算収支の状況,1,令和4年度,90028276,85699016,4329260,507249,3822011,-1140518,34883,1202068,0,96433
2022,61,112151,埼玉県,狭山市,3,2,決算収支の状況,1,令和4年度,53754911,51116900,2638011,432975,2205036,-429901,1803548,0,1000000,373647
2022,61,112160,埼玉県,羽生市,4,2,決算収支の状況,1,令和4年度,23112352,21212954,1899398,237495,1661903,-207995,500681,0,500000,-207314
2022,61,112178,埼玉県,鴻巣市,3,2,決算収支の状況,1,令和4年度,44317128,41711443,2605685,251286,2354399,-126125,305091,0,0,178966
2022,61,112186,埼玉県,深谷市,3,2,決算収支の状況,1,令和4年度,64462977,60012625,4450352,762712,3687640,-2280380,2545653,0,0,265273
2022,61,112194,埼玉県,上尾市,3,2,決算収支の状況,1,令和4年度,78125001,74671847,3453154,337228,3115926,-528632,1299497,0,0,770865
2022,61,112216,埼玉県,草加市,9,2,決算収支の状況,1,令和4年度,102479568,94941211,7538357,1624757,5913600,74895,3,0,864631,-789733
2022,61,112224,埼玉県,越谷市,8,2,決算収支の状況,1,令和4年度,133555579,123562586,9992993,163292,9829701,-1539617,5450800,0,3278000,633183
2022,61,112232,埼玉県,蕨市,4,2,決算収支の状況,1,令和4年度,33581676,30891881,2689795,156515,2533280,-89291,545606,0,0,456315
2022,61,112241,埼玉県,戸田市,3,2,決算収支の状況,1,令和4年度,66262191,61276144,4986047,501282,4484765,197708,2989223,0,1869720,1317211
2022,61,112259,埼玉県,入間市,3,2,決算収支の状況,1,令和4年度,48874528,47195861,1678667,118175,1560492,-450436,212500,0,0,-237936
2022,61,112275,埼玉県,朝霞市,3,2,決算収支の状況,1,令和4年度,53822918,50993751,2829167,254898,2574269,-256366,1752995,0,1486293,10336
2022,61,112283,埼玉県,志木市,4,2,決算収支の状況,1,令和4年度,33044414,31080254,1964160,37847,1926313,-420916,0,0,313639,-734555
2022,61,112291,埼玉県,和光市,4,2,決算収支の状況,1,令和4年度,35236546,32224362,3012184,149105,2863079,-176494,1077166,0,949606,-48934
2022,61,112305,埼玉県,新座市,3,2,決算収支の状況,1,令和4年度,65352883,62950815,2402068,113601,2288467,-1047157,4808663,0,5003560,-1242054
2022,61,112313,埼玉県,桶川市,4,2,決算収支の状況,1,令和4年度,27052995,26288449,764546,25323,739223,-167574,21,0,502108,-669661
2022,61,112321,埼玉県,久喜市,3,2,決算収支の状況,1,令和4年度,55247022,52809303,2437719,582134,1855585,-357865,324,386,964672,-1321827
2022,61,112330,埼玉県,北本市,4,2,決算収支の状況,1,令和4年度,25614985,24089888,1525097,251543,1273554,-224455,749652,0,736620,-211423
2022,61,112348,埼玉県,八潮市,4,2,決算収支の状況,1,令和4年度,43308117,39812849,3495268,378978,3116290,453758,1609601,0,1001031,1062328
2022,61,112356,埼玉県,富士見市,3,2,決算収支の状況,1,令和4年度,41708606,40601329,1107277,215051,892226,-616728,751,0,0,-615977
2022,61,112372,埼玉県,三郷市,3,2,決算収支の状況,1,令和4年度,64049897,59784844,4265053,147594,4117459,-747189,4769996,0,3552178,470629
2022,61,112381,埼玉県,蓮田市,4,2,決算収支の状況,1,令和4年度,24076725,21531788,2544937,1132419,1412518,41812,853101,0,976605,-81692
2022,61,112399,埼玉県,坂戸市,3,2,決算収支の状況,1,令和4年度,37232026,34821539,2410487,301099,2109388,-480172,1494646,0,807943,206531
2022,61,112402,埼玉県,幸手市,4,2,決算収支の状況,1,令和4年度,20012474,18336490,1675984,138664,1537320,-1457,770009,0,537000,231552
2022,61,112411,埼玉県,鶴ケ島市,4,2,決算収支の状況,1,令和4年度,26531040,24737625,1793415,29959,1763456,533282,974111,0,708401,798992
2022,61,112429,埼玉県,日高市,4,2,決算収支の状況,1,令和4年度,23467323,21679372,1787951,353382,1434569,-56179,745377,0,0,689198
2022,61,112437,埼玉県,吉川市,4,2,決算収支の状況,1,令和4年度,27113799,25832983,1280816,178666,1102150,-56352,10,0,406657,-462999
2022,61,112453,埼玉県,ふじみ野市,3,2,決算収支の状況,1,令和4年度,46412252,43426206,2986046,237756,2748290,534477,2618,0,0,537095
2022,61,112461,埼玉県,白岡市,4,2,決算収支の状況,1,令和4年度,18974311,17526894,1447417,566368,881049,110648,212690,0,0,323338
2022,61,113018,埼玉県,伊奈町,5,2,決算収支の状況,1,令和4年度,14224720,13545663,679057,25026,654031,5763,71003,0,0,76766
2022,61,113247,埼玉県,三芳町,5,2,決算収支の状況,1,令和4年度,16036710,14612267,1424443,12319,1412124,299008,427471,0,111517,614962
2022,61,113263,埼玉県,毛呂山町,5,2,決算収支の状況,1,令和4年度,11456653,10975844,480809,13816,466993,36969,493907,0,373891,156985
2022,61,113271,埼玉県,越生町,5,2,決算収支の状況,1,令和4年度,5220309,4686641,533668,30130,503538,63584,193428,0,0,257012
2022,61,113417,埼玉県,滑川町,5,2,決算収支の状況,1,令和4年度,8154742,7614790,539952,6905,533047,-36945,370005,0,0,333060
2022,61,113425,埼玉県,嵐山町,5,2,決算収支の状況,1,令和4年度,7735035,7215607,519428,52203,467225,9917,320007,0,220000,109924
2022,61,113433,埼玉県,小川町,5,2,決算収支の状況,1,令和4年度,10546598,10065993,480605,29705,450900,5567,73,0,291348,-285708
2022,61,113468,埼玉県,川島町,5,2,決算収支の状況,1,令和4年度,8133017,7623083,509934,110276,399658,-144302,288,0,0,-144014
2022,61,113476,埼玉県,吉見町,5,2,決算収支の状況,1,令和4年度,8322762,7566974,755788,20701,735087,-4848,44050,0,0,39202
2022,61,113484,埼玉県,鳩山町,5,2,決算収支の状況,1,令和4年度,6386355,5909705,476650,211407,265243,40060,43557,0,0,83617
2022,61,113492,埼玉県,ときがわ町,5,2,決算収支の状況,1,令和4年度,6538462,6105633,432829,168662,264167,-66755,177251,0,153171,-42675
2022,61,113611,埼玉県,横瀬町,5,2,決算収支の状況,1,令和4年度,5196234,4929747,266487,12610,253877,42526,213000,0,159014,96512
2022,61,113620,埼玉県,皆野町,5,2,決算収支の状況,1,令和4年度,4862318,4726174,136144,7336,128808,-64263,128696,0,0,64433
2022,61,113638,埼玉県,長瀞町,5,2,決算収支の状況,1,令和4年度,3856106,3671546,184560,18836,165724,-55014,500,0,0,-54514
2022,61,113654,埼玉県,小鹿野町,5,2,決算収支の状況,1,令和4年度,8722702,8104459,618243,68619,549624,70689,95153,0,0,165842
2022,61,113697,埼玉県,東秩父村,5,2,決算収支の状況,1,令和4年度,2852835,2703468,149367,17983,131384,-58519,201021,0,200000,-57498
2022,61,113816,埼玉県,美里町,5,2,決算収支の状況,1,令和4年度,6297883,5589509,708374,138125,570249,-21616,296064,0,296064,-21616
2022,61,113832,埼玉県,神川町,5,2,決算収支の状況,1,令和4年度,6888931,6460522,428409,18828,409581,-31159,32077,0,0,918
2022,61,113859,埼玉県,上里町,5,2,決算収支の状況,1,令和4年度,12369259,11569939,799320,25457,773863,-72468,150541,0,245408,-167335
2022,61,114081,埼玉県,寄居町,5,2,決算収支の状況,1,令和4年度,13736429,12932639,803790,48850,754940,-335353,296941,0,0,-38412
2022,61,114421,埼玉県,宮代町,5,2,決算収支の状況,1,令和4年度,13338994,12479543,859451,100927,758524,-261966,510747,0,398104,-149323
2022,61,114642,埼玉県,杉戸町,5,2,決算収支の状況,1,令和4年度,15782961,15106332,676629,47424,629205,-161571,3,0,149743,-311311
2022,61,114651,埼玉県,松伏町,5,2,決算収支の状況,1,令和4年度,11499451,10705400,794051,153408,640643,-346098,493388,0,420366,-273076
2022,61,118061,埼玉県,埼葛斎場組合,6,2,決算収支の状況,1,令和4年度,360483,327202,33281,0,33281,-8541,0,0,0,-8541
2022,61,118087,埼玉県,蓮田白岡衛生組合,6,2,決算収支の状況,1,令和4年度,1968561,1807246,161315,96516,64799,28236,0,0,0,28236
2022,61,118095,埼玉県,久喜宮代衛生組合,6,2,決算収支の状況,1,令和4年度,4075525,3928562,146963,0,146963,-45903,0,0,89993,-135896
2022,61,118109,埼玉県,朝霞地区一部事務組合,6,2,決算収支の状況,1,令和4年度,5401891,5224836,177055,0,177055,-74012,0,0,0,-74012
2022,61,118141,埼玉県,上尾、桶川、伊奈衛生組合,6,2,決算収支の状況,1,令和4年度,341204,332592,8612,0,8612,-1968,5295,0,73750,-70423
2022,61,118150,埼玉県,志木地区衛生組合,6,2,決算収支の状況,1,令和4年度,6011690,5848838,162852,0,162852,-1579,623877,0,0,622298
2022,61,118168,埼玉県,北本地区衛生組合,6,2,決算収支の状況,1,令和4年度,315813,285056,30757,0,30757,7288,11735,0,12266,6757
2022,61,118176,埼玉県,入間西部衛生組合,6,2,決算収支の状況,1,令和4年度,405437,338045,67392,0,67392,9010,0,0,0,9010
2022,61,118206,埼玉県,小川地区衛生組合,6,2,決算収支の状況,1,令和4年度,1772427,1599780,172647,0,172647,37147,0,0,0,37147
2022,61,118214,埼玉県,坂戸地区衛生組合,6,2,決算収支の状況,1,令和4年度,303299,282285,21014,0,21014,1791,0,0,0,1791
2022,61,118249,埼玉県,東埼玉資源環境組合,6,2,決算収支の状況,1,令和4年度,6398088,6124963,273125,0,273125,40844,0,0,0,40844
2022,61,118273,埼玉県,蕨戸田衛生センター組合,6,2,決算収支の状況,1,令和4年度,2260987,2041910,219077,0,219077,96363,0,0,0,96363
2022,61,118303,埼玉県,本庄上里学校給食組合,6,2,決算収支の状況,1,令和4年度,819703,802773,16930,0,16930,2044,0,0,0,2044
2022,61,118401,埼玉県,加須市・羽生市水防事務組合,6,2,決算収支の状況,1,令和4年度,10962,3386,7576,0,7576,-1372,0,0,0,-1372
2022,61,118419,埼玉県,荒川北縁水防事務組合,6,2,決算収支の状況,1,令和4年度,10892,1861,9031,0,9031,2439,0,0,0,2439
2022,61,118435,埼玉県,利根川栗橋流域水防事務組合,6,2,決算収支の状況,1,令和4年度,15299,11735,3564,0,3564,-4720,0,0,0,-4720
2022,61,118443,埼玉県,江戸川水防事務組合,6,2,決算収支の状況,1,令和4年度,7121,3499,3622,0,3622,-83,0,0,0,-83
2022,61,118451,埼玉県,戸田ボートレース企業団,7,2,決算収支の状況,1,令和4年度,0,0,0,0,0,0,0,0,0,0
2022,61,118486,埼玉県,埼玉県市町村総合事務組合,6,2,決算収支の状況,1,令和4年度,23478937,22910920,568017,0,568017,88132,3710434,0,5700,3792866
2022,61,118494,埼玉県,埼玉県都市ボートレース企業団,7,2,決算収支の状況,1,令和4年度,0,0,0,0,0,0,0,0,0,0
2022,61,118613,埼玉県,彩北広域清掃組合,6,2,決算収支の状況,1,令和4年度,593725,557326,36399,0,36399,-5179,93,0,16000,-21086
2022,61,118630,埼玉県,秩父広域市町村圏組合,6,2,決算収支の状況,1,令和4年度,3518172,3225739,292433,22929,269504,-37268,0,0,0,-37268
2022,61,118656,埼玉県,入間東部地区事務組合,6,2,決算収支の状況,1,令和4年度,3896408,3720971,175437,0,175437,-2915,0,38310,0,35395
2022,61,118681,埼玉県,吉川松伏消防組合,6,2,決算収支の状況,1,令和4年度,1827332,1796856,30476,0,30476,-13208,0,0,0,-13208
2022,61,118699,埼玉県,児玉郡市広域市町村圏組合,6,2,決算収支の状況,1,令和4年度,3961630,3844242,117388,6504,110884,-22179,66536,0,82730,-38373
2022,61,118711,埼玉県,埼玉西部環境保全組合,6,2,決算収支の状況,1,令和4年度,8655977,8434752,221225,18,221207,98424,124961,0,0,223385
2022,61,118761,埼玉県,坂戸・鶴ケ島消防組合,6,2,決算収支の状況,1,令和4年度,2605359,2446522,158837,0,158837,-24054,0,0,0,-24054
2022,61,118770,埼玉県,比企広域市町村圏組合,6,2,決算収支の状況,1,令和4年度,3700489,3450981,249508,2595,246913,9549,0,0,0,9549
2022,61,118788,埼玉県,川越地区消防組合,6,2,決算収支の状況,1,令和4年度,5421878,5338534,83344,0,83344,-144724,0,0,0,-144724
2022,61,118826,埼玉県,埼玉県央広域事務組合,6,2,決算収支の状況,1,令和4年度,3907607,3836827,70780,5590,65190,-28395,169985,0,233682,-92092
2022,61,118842,埼玉県,西入間広域消防組合,6,2,決算収支の状況,1,令和4年度,1300414,1265597,34817,0,34817,-7306,0,0,0,-7306
2022,61,118851,埼玉県,埼玉中部環境保全組合,6,2,決算収支の状況,1,令和4年度,858101,822241,35860,0,35860,18698,1,0,13693,5006
2022,61,118869,埼玉県,埼玉県浦和競馬組合,7,2,決算収支の状況,1,令和4年度,0,0,0,0,0,0,0,0,0,0
2022,61,118923,埼玉県,広域飯能斎場組合,6,2,決算収支の状況,1,令和4年度,157576,143827,13749,0,13749,1699,0,0,0,1699
2022,61,118931,埼玉県,広域静苑組合,6,2,決算収支の状況,1,令和4年度,231170,211942,19228,0,19228,9200,0,0,0,9200
2022,61,118958,埼玉県,広域利根斎場組合,6,2,決算収支の状況,1,令和4年度,347269,321143,26126,0,26126,-15605,0,0,0,-15605
2022,61,118974,埼玉県,彩の国さいたま人づくり広域連合,6,2,決算収支の状況,1,令和4年度,321030,310037,10993,0,10993,3142,0,0,0,3142
2022,61,118982,埼玉県,皆野・長瀞下水道組合,6,2,決算収支の状況,1,令和4年度,125454,110434,15020,0,15020,1029,0,0,0,1029
2022,61,118991,埼玉県,大里広域市町村圏組合,6,2,決算収支の状況,1,令和4年度,4792424,4272061,520363,0,520363,225234,0,0,0,225234
2022,61,119008,埼玉県,埼玉県後期高齢者医療広域連合,7,2,決算収支の状況,1,令和4年度,177179,136805,40374,0,40374,3875,0,0,0,3875
2022,61,119016,埼玉県,埼玉西部消防組合,6,2,決算収支の状況,1,令和4年度,10148285,9954147,194138,15247,178891,-247999,0,0,0,-247999
2022,61,119024,埼玉県,埼玉東部消防組合,6,2,決算収支の状況,1,令和4年度,6209762,6036509,173253,0,173253,-37125,57588,0,140674,-120211
2022,61,119041,埼玉県,草加八潮消防組合,6,2,決算収支の状況,1,令和4年度,4062190,3806395,255795,36662,219133,11895,0,0,0,11895
2022,61,119067,埼玉県,朝霞和光資源循環組合,6,2,決算収支の状況,1,令和4年度,987027,934163,52864,0,52864,-49674,277583,0,0,227909
2022,61,119075,埼玉県,行田羽生資源環境組合,6,2,決算収支の状況,1,令和4年度,116050,88736,27314,0,27314,27314,0,0,0,27314
2022,61,121002,千葉県,千葉市,1,2,決算収支の状況,1,令和4年度,534983454,527564488,7418966,1854582,5564384,2586541,1586904,0,3509501,663944
2022,61,122025,千葉県,銚子市,4,2,決算収支の状況,1,令和4年度,26482459,25361353,1121106,103298,1017808,-203531,18,0,0,-203513
2022,61,122033,千葉県,市川市,3,2,決算収支の状況,1,令和4年度,180022385,174968715,5053670,817692,4235978,-657742,15548,0,0,-642194
2022,61,122041,千葉県,船橋市,8,2,決算収支の状況,1,令和4年度,245437120,238073168,7363952,768819,6595133,-3489814,58,0,0,-3489756
2022,61,122050,千葉県,館山市,4,2,決算収支の状況,1,令和4年度,23584305,22721033,863272,127259,736013,-252989,29,0,0,-252960
2022,61,122068,千葉県,木更津市,3,2,決算収支の状況,1,令和4年度,55476266,53216857,2259409,667207,1592202,-43136,4392,0,225608,-264352
2022,61,122076,千葉県,松戸市,3,2,決算収支の状況,1,令和4年度,193467227,183865661,9601566,2579243,7022323,-1969338,695,3010,2729051,-4694684
2022,61,122084,千葉県,野田市,3,2,決算収支の状況,1,令和4年度,61220330,59323036,1897294,274733,1622561,-587287,2012492,0,1380000,45205
2022,61,122106,千葉県,茂原市,4,2,決算収支の状況,1,令和4年度,34218481,33368379,850102,34629,815473,-483004,111398,50000,908423,-1230029
2022,61,122114,千葉県,成田市,3,2,決算収支の状況,1,令和4年度,69216625,64940882,4275743,872152,3403591,150003,2354000,0,3718521,-1214518
2022,61,122122,千葉県,佐倉市,3,2,決算収支の状況,1,令和4年度,59648622,56791646,2856976,207698,2649278,-323569,2798712,0,0,2475143
2022,61,122131,千葉県,東金市,4,2,決算収支の状況,1,令和4年度,23009170,21974200,1034970,24866,1010104,-259021,15121,0,60000,-303900
2022,61,122157,千葉県,旭市,4,2,決算収支の状況,1,令和4年度,33337108,31909985,1427123,95092,1332031,-304312,39100,0,650000,-915212
2022,61,122165,千葉県,習志野市,3,2,決算収支の状況,1,令和4年度,66492234,63208375,3283859,341175,2942684,-641987,1227,0,2300000,-2940760
2022,61,122173,千葉県,柏市,8,2,決算収支の状況,1,令和4年度,164471229,155887030,8584199,2670695,5913504,421432,4010,0,0,425442
2022,61,122181,千葉県,勝浦市,4,2,決算収支の状況,1,令和4年度,19311718,18756318,555400,73112,482288,93680,357632,0,406783,44529
2022,61,122190,千葉県,市原市,3,2,決算収支の状況,1,令和4年度,112804436,106728100,6076336,981458,5094878,-1254254,289315,0,0,-964939
2022,61,122203,千葉県,流山市,3,2,決算収支の状況,1,令和4年度,80068744,77037826,3030918,799381,2231537,-910874,434,0,0,-910440
2022,61,122211,千葉県,八千代市,3,2,決算収支の状況,1,令和4年度,73726813,70512761,3214052,558891,2655161,-353177,1340,0,2398454,-2750291
2022,61,122220,千葉県,我孫子市,3,2,決算収支の状況,1,令和4年度,51818326,50491549,1326777,189302,1137475,-338585,950000,0,0,611415
2022,61,122238,千葉県,鴨川市,4,2,決算収支の状況,1,令和4年度,18570419,17744458,825961,99261,726700,-143379,435212,0,0,291833
2022,61,122246,千葉県,鎌ケ谷市,3,2,決算収支の状況,1,令和4年度,43458783,40716870,2741913,243450,2498463,-345609,1422044,0,682760,393675
2022,61,122254,千葉県,君津市,4,2,決算収支の状況,1,令和4年度,39681684,38336584,1345100,182995,1162105,-1201970,1765135,0,1199050,-635885
2022,61,122262,千葉県,富津市,4,2,決算収支の状況,1,令和4年度,21470938,20519571,951367,224700,726667,-533366,49,0,452083,-985400
2022,61,122271,千葉県,浦安市,3,2,決算収支の状況,1,令和4年度,71262346,68870969,2391377,858915,1532462,-103429,1624,0,424883,-526688
2022,61,122289,千葉県,四街道市,4,2,決算収支の状況,1,令和4年度,38050728,35234124,2816604,304124,2512480,597950,960000,0,454798,1103152
2022,61,122297,千葉県,袖ケ浦市,4,2,決算収支の状況,1,令和4年度,31204365,30023201,1181164,65082,1116082,191841,420549,0,425351,187039
2022,61,122301,千葉県,八街市,4,2,決算収支の状況,1,令和4年度,27563627,26052979,1510648,97717,1412931,367633,52,0,447762,-80077
2022,61,122319,千葉県,印西市,3,2,決算収支の状況,1,令和4年度,50082489,46709796,3372693,617042,2755651,-861808,4432,0,1958051,-2815427
2022,61,122327,千葉県,白井市,4,2,決算収支の状況,1,令和4年度,24422241,23070931,1351310,148188,1203122,55634,1099396,0,1164962,-9932
2022,61,122335,千葉県,富里市,4,2,決算収支の状況,1,令和4年度,19442480,18437918,1004562,79549,925013,-245541,781322,0,758522,-222741
2022,61,122343,千葉県,南房総市,4,2,決算収支の状況,1,令和4年度,26100035,24070248,2029787,775269,1254518,141468,289,0,66138,75619
2022,61,122351,千葉県,匝瑳市,4,2,決算収支の状況,1,令和4年度,16208942,15148395,1060547,14549,1045998,7163,2475,0,238000,-228362
2022,61,122360,千葉県,香取市,4,2,決算収支の状況,1,令和4年度,40080912,37036305,3044607,262874,2781733,-32171,16357,0,800000,-815814
2022,61,122378,千葉県,山武市,4,2,決算収支の状況,1,令和4年度,27583775,26256542,1327233,583469,743764,-404907,21442,0,600000,-983465
2022,61,122386,千葉県,いすみ市,4,2,決算収支の状況,1,令和4年度,19341706,18228581,1113125,178800,934325,-162484,4306,0,639471,-797649
2022,61,122394,千葉県,大網白里市,4,2,決算収支の状況,1,令和4年度,17660957,16816949,844008,4702,839306,-43407,6,0,337144,-380545
2022,61,123226,千葉県,酒々井町,5,2,決算収支の状況,1,令和4年度,7268880,6789481,479399,13199,466200,56691,16881,0,386801,-313229
2022,61,123293,千葉県,栄町,5,2,決算収支の状況,1,令和4年度,8722454,8432932,289522,11543,277979,-111407,367431,0,161975,94049
2022,61,123421,千葉県,神崎町,5,2,決算収支の状況,1,令和4年度,3237979,2974565,263414,40306,223108,-25496,124627,0,0,99131
2022,61,123471,千葉県,多古町,5,2,決算収支の状況,1,令和4年度,8460349,7730337,730012,2055,727957,135448,295568,0,203217,227799
2022,61,123498,千葉県,東庄町,5,2,決算収支の状況,1,令和4年度,7148524,6379209,769315,40915,728400,-238089,300018,0,0,61929
2022,61,124036,千葉県,九十九里町,5,2,決算収支の状況,1,令和4年度,7259556,6825640,433916,4043,429873,-36500,403981,0,7496,359985
2022,61,124095,千葉県,芝山町,5,2,決算収支の状況,1,令和4年度,6408019,6080601,327418,90713,236705,-191424,250162,0,0,58738
2022,61,124109,千葉県,横芝光町,5,2,決算収支の状況,1,令和4年度,12918714,12477213,441501,19693,421808,-43094,234338,0,300000,-108756
2022,61,124214,千葉県,一宮町,5,2,決算収支の状況,1,令和4年度,5562218,5429730,132488,2755,129733,-107780,127842,0,0,20062
2022,61,124222,千葉県,睦沢町,5,2,決算収支の状況,1,令和4年度,4154552,3964396,190156,79546,110610,23836,134262,0,0,158098
2022,61,124231,千葉県,長生村,5,2,決算収支の状況,1,令和4年度,6815245,6515231,300014,5782,294232,-91716,192975,0,216722,-115463
2022,61,124249,千葉県,白子町,5,2,決算収支の状況,1,令和4年度,5436201,5104695,331506,139562,191944,-72830,112212,0,0,39382
2022,61,124265,千葉県,長柄町,5,2,決算収支の状況,1,令和4年度,5527129,5210674,316455,14950,301505,-246173,310010,0,0,63837
2022,61,124273,千葉県,長南町,5,2,決算収支の状況,1,令和4年度,6667301,6258923,408378,114254,294124,78836,188267,0,200000,67103
2022,61,124419,千葉県,大多喜町,5,2,決算収支の状況,1,令和4年度,6536675,5936535,600140,159323,440817,35876,0,0,0,35876
2022,61,124435,千葉県,御宿町,5,2,決算収支の状況,1,令和4年度,4532894,4169033,363861,27535,336326,-41264,127,0,0,-41137
2022,61,124630,千葉県,鋸南町,5,2,決算収支の状況,1,令和4年度,5480214,5145460,334754,71132,263622,29353,295705,0,0,325058
2022,61,128139,千葉県,千葉県市町村総合事務組合,6,2,決算収支の状況,1,令和4年度,21656594,20905240,751354,41754,709600,232929,0,0,0,232929
2022,61,128155,千葉県,東葛中部地区総合開発事務組合,6,2,決算収支の状況,1,令和4年度,738119,654659,83460,48768,34692,-13487,2,0,2133,-15618
2022,61,128163,千葉県,鋸南地区環境衛生組合,6,2,決算収支の状況,1,令和4年度,649856,612558,37298,0,37298,-15191,44231,0,0,29040
2022,61,128287,千葉県,佐倉市、酒々井町清掃組合,6,2,決算収支の状況,1,令和4年度,1784016,1732852,51164,0,51164,-46965,65230,0,200000,-181735
2022,61,128309,千葉県,東金市外三市町清掃組合,6,2,決算収支の状況,1,令和4年度,1560237,1422787,137450,10478,126972,18323,0,0,182926,-164603
2022,61,128317,千葉県,山武郡市環境衛生組合,6,2,決算収支の状況,1,令和4年度,1124604,1046017,78587,0,78587,27296,41216,0,0,68512
2022,61,128333,千葉県,柏・白井・鎌ケ谷環境衛生組合,6,2,決算収支の状況,1,令和4年度,4953006,4784760,168246,0,168246,27721,9238,0,47711,-10752
2022,61,128341,千葉県,印旛衛生施設管理組合,6,2,決算収支の状況,1,令和4年度,380446,372828,7618,0,7618,-1190,4406,0,33635,-30419
2022,61,128350,千葉県,印西地区衛生組合,6,2,決算収支の状況,1,令和4年度,505731,496081,9650,869,8781,2306,0,0,0,2306
2022,61,128384,千葉県,東総衛生組合,6,2,決算収支の状況,1,令和4年度,632367,607440,24927,0,24927,-21702,4,0,22351,-44049
2022,61,128414,千葉県,夷隅環境衛生組合,6,2,決算収支の状況,1,令和4年度,417998,381083,36915,0,36915,-7269,11053,0,55770,-51986
2022,61,128449,千葉県,佐倉市、四街道市、酒々井町葬祭組合,6,2,決算収支の状況,1,令和4年度,366180,338081,28099,0,28099,-609,12002,0,25300,-13907
2022,61,128465,千葉県,一宮聖苑組合,6,2,決算収支の状況,1,令和4年度,73740,67769,5971,0,5971,2659,14752,0,0,17411
2022,61,128473,千葉県,印旛利根川水防事務組合,6,2,決算収支の状況,1,令和4年度,17526,13072,4454,0,4454,2158,1148,0,4813,-1507
2022,61,128503,千葉県,布施学校組合,6,2,決算収支の状況,1,令和4年度,40346,38650,1696,0,1696,275,0,0,0,275
2022,61,128538,千葉県,千葉県競馬組合,7,2,決算収支の状況,1,令和4年度,0,0,0,0,0,0,0,0,0,0
2022,61,128546,千葉県,匝瑳市ほか二町環境衛生組合,6,2,決算収支の状況,1,令和4年度,197224,151656,45568,0,45568,-3276,7,0,70070,-73339
2022,61,128571,千葉県,君津郡市広域市町村圏事務組合,6,2,決算収支の状況,1,令和4年度,609716,571818,37898,0,37898,-19931,0,0,0,-19931
2022,61,128589,千葉県,千葉県市町村交通災害共済事業会計,7,2,決算収支の状況,1,令和4年度,0,0,0,0,0,0,0,0,0,0
2022,61,128601,千葉県,安房郡市広域市町村圏事務組合,6,2,決算収支の状況,1,令和4年度,3365049,3143570,221479,19240,202239,-12763,0,0,0,-12763
2022,61,128619,千葉県,四市複合事務組合,6,2,決算収支の状況,1,令和4年度,3006206,2835892,170314,0,170314,-103236,0,0,0,-103236
2022,61,128635,千葉県,長生郡市広域市町村圏組合（普通会計分）,6,2,決算収支の状況,1,令和4年度,7665579,7484037,181542,73018,108524,-92814,0,0,0,-92814
2022,61,128651,千葉県,匝瑳市横芝光町消防組合,6,2,決算収支の状況,1,令和4年度,1858577,1804058,54519,35167,19352,-2819,0,0,0,-2819
2022,61,128660,千葉県,山武郡市広域行政組合,6,2,決算収支の状況,1,令和4年度,4679260,4570388,108872,7098,101774,-85821,0,0,211891,-297712
2022,61,128678,千葉県,香取広域市町村圏事務組合,6,2,決算収支の状況,1,令和4年度,4864429,4582934,281495,0,281495,-207319,0,0,0,-207319
2022,61,128686,千葉県,佐倉市八街市酒々井町消防組合,6,2,決算収支の状況,1,令和4年度,4941902,4898097,43805,0,43805,3903,3,0,147070,-143164
2022,61,128694,千葉県,東総地区広域市町村圏事務組合,6,2,決算収支の状況,1,令和4年度,1594462,1424770,169692,0,169692,21806,0,0,0,21806
2022,61,128708,千葉県,印西地区消防組合,6,2,決算収支の状況,1,令和4年度,3285924,3184444,101480,51127,50353,-10091,0,0,0,-10091
2022,61,128732,千葉県,夷隅郡市広域市町村圏事務組合,6,2,決算収支の状況,1,令和4年度,2059496,1972925,86571,8433,78138,-19559,0,0,0,-19559
2022,61,128741,千葉県,印旛郡市広域市町村圏事務組合（普通会計分）,6,2,決算収支の状況,1,令和4年度,187074,181860,5214,0,5214,-629,2921,0,7687,-5395
2022,61,128830,千葉県,印西地区環境整備事業組合（普通会計分）,6,2,決算収支の状況,1,令和4年度,3512642,3341840,170802,21059,149743,44704,0,0,0,44704
2022,61,128902,千葉県,千葉県後期高齢者医療広域連合,7,2,決算収支の状況,1,令和4年度,943084,827694,115390,0,115390,-145162,130276,0,130277,-145163
2022,61,131016,東京都,千代田区,2,2,決算収支の状況,1,令和4年度,68549008,66236416,2312592,1201703,1110889,-362056,880653,0,738571,-219974
2022,61,131024,東京都,中央区,2,2,決算収支の状況,1,令和4年度,140316917,134823054,5493863,3306985,2186878,237934,5970214,0,3300000,2908148
2022,61,131032,東京都,港区,2,2,決算収支の状況,1,令和4年度,183992415,172047888,11944527,289446,11655081,-54617,28129,0,2700000,-2726488
2022,61,131041,東京都,新宿区,2,2,決算収支の状況,1,令和4年度,176789897,172138976,4650921,309140,4341781,-2009604,3618591,0,1000000,608987
2022,61,131059,東京都,文京区,2,2,決算収支の状況,1,令和4年度,137802419,132020929,5781490,96038,5685452,-1055433,3386143,0,4585850,-2255140
2022,61,131067,東京都,台東区,2,2,決算収支の状況,1,令和4年度,124386234,116401427,7984807,229887,7754920,-2591927,1058066,0,0,-1533861
2022,61,131075,東京都,墨田区,2,2,決算収支の状況,1,令和4年度,141796412,135845720,5950692,140915,5809777,1249444,2285222,0,505000,3029666
2022,61,131083,東京都,江東区,2,2,決算収支の状況,1,令和4年度,240885135,232505093,8380042,465675,7914367,-3016647,5477325,0,200000,2260678
2022,61,131091,東京都,品川区,2,2,決算収支の状況,1,令和4年度,195518418,188940434,6577984,317203,6260781,-683025,2332923,0,0,1649898
2022,61,131105,東京都,目黒区,2,2,決算収支の状況,1,令和4年度,131734891,123596554,8138337,18284,8120053,-588898,4438746,0,5471,3844377
2022,61,131113,東京都,大田区,2,2,決算収支の状況,1,令和4年度,305342225,301311510,4030715,1330123,2700592,-6992062,25977,0,4000000,-10966085
2022,61,131121,東京都,世田谷区,2,2,決算収支の状況,1,令和4年度,395148535,375041261,20107274,4860484,15246790,-1830148,2993517,0,0,1163369
2022,61,131130,東京都,渋谷区,2,2,決算収支の状況,1,令和4年度,134925585,121400300,13525285,712967,12812318,-2882237,9036006,0,0,6153769
2022,61,131148,東京都,中野区,2,2,決算収支の状況,1,令和4年度,169442333,162275994,7166339,736810,6429529,332709,14369490,0,9583400,5118799
2022,61,131156,東京都,杉並区,2,2,決算収支の状況,1,令和4年度,234566785,221710442,12856343,2663078,10193265,-3003158,9201974,0,355789,5843027
2022,61,131164,東京都,豊島区,2,2,決算収支の状況,1,令和4年度,149300723,144701202,4599521,298369,4301152,1739463,975013,0,6842727,-4128251
2022,61,131172,東京都,北区,2,2,決算収支の状況,1,令和4年度,184808271,175889006,8919265,202143,8717122,329453,18027,0,2000000,-1652520
2022,61,131181,東京都,荒川区,2,2,決算収支の状況,1,令和4年度,114036881,108865699,5171182,52413,5118769,214497,17924,0,0,232421
2022,61,131199,東京都,板橋区,2,2,決算収支の状況,1,令和4年度,262601898,251504596,11097302,916401,10180901,-2369237,4262479,0,3503761,-1610519
2022,61,131202,東京都,練馬区,2,2,決算収支の状況,1,令和4年度,318828220,309119117,9709103,199297,9509806,-718188,37328,0,3200000,-3880860
2022,61,131211,東京都,足立区,2,2,決算収支の状況,1,令和4年度,340840685,326844422,13996263,967111,13029152,1701089,17788,0,6713706,-4994829
2022,61,131229,東京都,葛飾区,2,2,決算収支の状況,1,令和4年度,250981410,239189268,11792142,624065,11168077,-5467134,3541217,0,2931206,-4857123
2022,61,131237,東京都,江戸川区,2,2,決算収支の状況,1,令和4年度,343430696,317060115,26370581,14386054,11984527,-48702,147048,0,130016,-31670
2022,61,132012,東京都,八王子市,8,2,決算収支の状況,1,令和4年度,237366330,228077566,9288764,3266005,6022759,-1495336,4864481,0,0,3369145
2022,61,132021,東京都,立川市,3,2,決算収支の状況,1,令和4年度,99822037,93380930,6441107,1248800,5192307,-1312029,994380,0,0,-317649
2022,61,132039,東京都,武蔵野市,3,2,決算収支の状況,1,令和4年度,79229283,75071425,4157858,182140,3975718,159636,770098,0,769418,160316
2022,61,132047,東京都,三鷹市,3,2,決算収支の状況,1,令和4年度,78340533,76031947,2308586,112893,2195693,8178,594944,0,0,603122
2022,61,132055,東京都,青梅市,3,2,決算収支の状況,1,令和4年度,62857034,58959941,3897093,126884,3770209,897403,1437128,0,0,2334531
2022,61,132063,東京都,府中市,3,2,決算収支の状況,1,令和4年度,132911238,129780300,3130938,173365,2957573,-1468810,6000,0,6000,-1468810
2022,61,132071,東京都,昭島市,3,2,決算収支の状況,1,令和4年度,52147529,49629263,2518266,140226,2378040,-861511,297,0,700000,-1561214
2022,61,132080,東京都,調布市,3,2,決算収支の状況,1,令和4年度,108278178,102320016,5958162,1581282,4376880,-2329505,902203,0,950000,-2377302
2022,61,132098,東京都,町田市,3,2,決算収支の状況,1,令和4年度,184675921,173875066,10800855,2954545,7846310,-297828,6370733,0,5063482,1009423
2022,61,132101,東京都,小金井市,3,2,決算収支の状況,1,令和4年度,52997404,50469159,2528245,15630,2512615,657847,930081,0,1400000,187928
2022,61,132110,東京都,小平市,3,2,決算収支の状況,1,令和4年度,89827411,84456794,5370617,311845,5058772,-1253164,3158001,0,3050000,-1145163
2022,61,132128,東京都,日野市,3,2,決算収支の状況,1,令和4年度,78547253,75527997,3019256,300238,2719018,-2478778,1800985,0,138750,-816543
2022,61,132136,東京都,東村山市,3,2,決算収支の状況,1,令和4年度,70577986,67875587,2702399,100387,2602012,-704942,1700001,0,1620830,-625771
2022,61,132144,東京都,国分寺市,3,2,決算収支の状況,1,令和4年度,57156236,54213942,2942294,316794,2625500,237232,755585,0,725676,267141
2022,61,132152,東京都,国立市,4,2,決算収支の状況,1,令和4年度,36013772,35217903,795869,10655,785214,-246036,529457,0,600000,-316579
2022,61,132187,東京都,福生市,4,2,決算収支の状況,1,令和4年度,30132275,28414749,1717526,80064,1637462,179710,18574,0,0,198284
2022,61,132195,東京都,狛江市,4,2,決算収支の状況,1,令和4年度,37179103,34955048,2224055,176943,2047112,-260860,648984,0,403021,-14897
2022,61,132209,東京都,東大和市,4,2,決算収支の状況,1,令和4年度,40517222,37579090,2938132,51736,2886396,-25988,1456231,0,1497271,-67028
2022,61,132217,東京都,清瀬市,4,2,決算収支の状況,1,令和4年度,37555643,35177224,2378419,37779,2340640,221083,1264404,0,1197978,287509
2022,61,132225,東京都,東久留米市,3,2,決算収支の状況,1,令和4年度,51081080,49953258,1127822,452213,675609,-2239688,1525202,232,76290,-790544
2022,61,132233,東京都,武蔵村山市,4,2,決算収支の状況,1,令和4年度,32334490,31459490,875000,41563,833437,-466382,649910,0,0,183528
2022,61,132241,東京都,多摩市,3,2,決算収支の状況,1,令和4年度,70461673,67825905,2635768,150714,2485054,-301141,1442498,255622,1500000,-103021
2022,61,132250,東京都,稲城市,4,2,決算収支の状況,1,令和4年度,40064136,37596084,2468052,252181,2215871,29824,167787,0,3702,193909
2022,61,132276,東京都,羽村市,4,2,決算収支の状況,1,令和4年度,27171770,25937048,1234722,1109,1233613,-254810,814552,0,0,559742
2022,61,132284,東京都,あきる野市,4,2,決算収支の状況,1,令和4年度,36722380,35422973,1299407,12717,1286690,-467943,219581,0,0,-248362
2022,61,132292,東京都,西東京市,3,2,決算収支の状況,1,令和4年度,87049826,83529956,3519870,404046,3115824,-695905,2018953,0,1500000,-176952
2022,61,133035,東京都,瑞穂町,5,2,決算収支の状況,1,令和4年度,16112928,15648623,464305,0,464305,-217488,383827,0,47000,119339
2022,61,133051,東京都,日の出町,5,2,決算収支の状況,1,令和4年度,10327549,9962816,364733,20535,344198,-192103,419122,0,0,227019
2022,61,133078,東京都,檜原村,5,2,決算収支の状況,1,令和4年度,4010476,3864832,145644,0,145644,-1198,170552,0,0,169354
2022,61,133086,東京都,奥多摩町,5,2,決算収支の状況,1,令和4年度,7652031,7356246,295785,53030,242755,-157535,195826,0,120000,-81709
2022,61,133612,東京都,大島町,5,2,決算収支の状況,1,令和4年度,8544537,8395796,148741,58538,90203,-104837,70031,0,0,-34806
2022,61,133621,東京都,利島村,5,2,決算収支の状況,1,令和4年度,1717255,1604785,112470,19351,93119,3409,30013,0,0,33422
2022,61,133639,東京都,新島村,5,2,決算収支の状況,1,令和4年度,4389251,4100254,288997,8679,280318,-42694,300210,0,0,257516
2022,61,133647,東京都,神津島村,5,2,決算収支の状況,1,令和4年度,3381037,3286373,94664,0,94664,17160,150250,0,0,167410
2022,61,133817,東京都,三宅村,5,2,決算収支の状況,1,令和4年度,4366332,4192024,174308,0,174308,-22576,98553,0,0,75977
2022,61,133825,東京都,御蔵島村,5,2,決算収支の状況,1,令和4年度,1951769,1811836,139933,40279,99654,-24317,289711,0,263000,2394
2022,61,134015,東京都,八丈町,5,2,決算収支の状況,1,令和4年度,9214783,8995295,219488,132786,86702,-67910,0,0,0,-67910
2022,61,134023,東京都,青ヶ島村,5,2,決算収支の状況,1,令和4年度,1176899,1044110,132789,14091,118698,79721,23,0,0,79744
2022,61,134210,東京都,小笠原村,5,2,決算収支の状況,1,令和4年度,5349311,5076010,273301,66645,206656,-38269,62951,0,0,24682
2022,61,138011,東京都,特別区人事・厚生事務組合,6,2,決算収支の状況,1,令和4年度,7627148,7179596,447552,0,447552,32959,154990,0,150000,37949
2022,61,138029,東京都,特別区競馬組合,7,2,決算収支の状況,1,令和4年度,0,0,0,0,0,0,0,0,0,0
2022,61,138061,東京都,東京都島嶼町村一部事務組合,6,2,決算収支の状況,1,令和4年度,551844,546949,4895,0,4895,-342,943,0,0,601
2022,61,138096,東京都,瑞穂斎場組合,6,2,決算収支の状況,1,令和4年度,464653,428813,35840,0,35840,22985,0,0,0,22985
2022,61,138151,東京都,ふじみ衛生組合,6,2,決算収支の状況,1,令和4年度,2432677,2047919,384758,0,384758,31209,0,0,0,31209
2022,61,138169,東京都,柳泉園組合,6,2,決算収支の状況,1,令和4年度,2882498,2441914,440584,0,440584,81063,0,0,0,81063
2022,61,138185,東京都,湖南衛生組合,6,2,決算収支の状況,1,令和4年度,121028,107968,13060,0,13060,321,4001,0,4000,322
2022,61,138207,東京都,西多摩衛生組合,6,2,決算収支の状況,1,令和4年度,2166042,1988948,177094,0,177094,77378,0,0,0,77378
2022,61,138223,東京都,多摩川衛生組合,6,2,決算収支の状況,1,令和4年度,2046908,1884839,162069,0,162069,34730,7620,0,0,42350
2022,61,138231,東京都,小平・村山・大和衛生組合,6,2,決算収支の状況,1,令和4年度,5823999,5509523,314476,151450,163026,61347,126805,0,71491,116661
2022,61,138258,東京都,東京都市町村職員退職手当組合,6,2,決算収支の状況,1,令和4年度,4817696,4559951,257745,0,257745,-142005,0,0,0,-142005
2022,61,138266,東京都,東京都十一市競輪事業組合,7,2,決算収支の状況,1,令和4年度,0,0,0,0,0,0,0,0,0,0
2022,61,138274,東京都,東京都六市競艇事業組合,7,2,決算収支の状況,1,令和4年度,0,0,0,0,0,0,0,0,0,0
2022,61,138282,東京都,東京都四市競艇事業組合,7,2,決算収支の状況,1,令和4年度,0,0,0,0,0,0,0,0,0,0
2022,61,138321,東京都,東京都市町村議会議員公務災害補償等組合,6,2,決算収支の状況,1,令和4年度,4076,3372,704,0,704,-617,0,0,0,-617
2022,61,138398,東京都,羽村・瑞穂地区学校給食組合,6,2,決算収支の状況,1,令和4年度,404375,380314,24061,0,24061,-37983,0,0,0,-37983
2022,61,138410,東京都,東京都三市収益事業組合,7,2,決算収支の状況,1,令和4年度,0,0,0,0,0,0,0,0,0,0
2022,61,138444,東京都,西秋川衛生組合,6,2,決算収支の状況,1,令和4年度,1395770,1349810,45960,0,45960,15575,0,0,0,15575
2022,61,138452,東京都,南多摩斎場組合,6,2,決算収支の状況,1,令和4年度,323584,300306,23278,0,23278,6419,0,0,0,6419
2022,61,138479,東京都,東京たま広域資源循環組合,6,2,決算収支の状況,1,令和4年度,9646713,9533565,113148,0,113148,-378918,1061,0,100000,-477857
2022,61,138487,東京都,立川・昭島・国立聖苑組合,6,2,決算収支の状況,1,令和4年度,302959,280188,22771,0,22771,-10234,30003,0,0,19769
2022,61,138495,東京都,東京市町村総合事務組合,6,2,決算収支の状況,1,令和4年度,924841,904753,20088,0,20088,-9414,763,0,44085,-52736
2022,61,138517,東京都,多摩六都科学館組合,6,2,決算収支の状況,1,令和4年度,461071,446003,15068,0,15068,4152,7744,0,0,11896
2022,61,138525,東京都,多摩ニュータウン環境組合,6,2,決算収支の状況,1,令和4年度,1636682,1527574,109108,0,109108,22859,150240,0,168214,4885
2022,61,138533,東京都,秋川流域斎場組合,6,2,決算収支の状況,1,令和4年度,247930,224573,23357,0,23357,-1328,0,0,0,-1328
2022,61,138550,東京都,臨海部広域斎場組合,6,2,決算収支の状況,1,令和4年度,776298,664070,112228,0,112228,-19910,0,0,0,-19910
2022,61,138568,東京都,東京二十三区清掃一部事務組合,6,2,決算収支の状況,1,令和4年度,108541943,104627108,3914835,182880,3731955,-994512,5539394,0,9371763,-4826881
2022,61,138584,東京都,東京都後期高齢者医療広域連合,7,2,決算収支の状況,1,令和4年度,4692544,4616426,76118,0,76118,-34,1060226,0,2072113,-1011921
2022,61,138592,東京都,稲城・府中墓苑組合,6,2,決算収支の状況,1,令和4年度,989814,968532,21282,0,21282,53,14,0,0,67
2022,61,138606,東京都,浅川清流環境組合,6,2,決算収支の状況,1,令和4年度,1542349,1379447,162902,0,162902,56065,53419,0,0,109484
2022,61,141003,神奈川県,横浜市,1,2,決算収支の状況,1,令和4年度,2107978321,2072931560,35046761,15243558,19803203,5806631,12006087,0,17596000,216718
2022,61,141305,神奈川県,川崎市,1,2,決算収支の状況,1,令和4年度,805341463,797468795,7872668,5722528,2150140,-4067010,52488,0,1748044,-5762566
2022,61,141500,神奈川県,相模原市,1,2,決算収支の状況,1,令和4年度,354093500,336509959,17583541,1594260,15989281,-8621221,16495,0,7610000,-16214726
2022,61,142018,神奈川県,横須賀市,8,2,決算収支の状況,1,令和4年度,180787447,173275811,7511636,528475,6983161,-1403384,137,0,2311375,-3714622
2022,61,142034,神奈川県,平塚市,9,2,決算収支の状況,1,令和4年度,100418246,96108746,4309500,855031,3454469,124038,95604,63116,704520,-421762
2022,61,142042,神奈川県,鎌倉市,3,2,決算収支の状況,1,令和4年度,74911172,70576253,4334919,445630,3889289,-671612,2107322,0,0,1435710
2022,61,142051,神奈川県,藤沢市,3,2,決算収支の状況,1,令和4年度,180540590,174807470,5733120,422729,5310391,-1443998,3477211,0,3000000,-966787
2022,61,142069,神奈川県,小田原市,9,2,決算収支の状況,1,令和4年度,84510302,80178624,4331678,181997,4149681,-582566,2363335,0,1900000,-119231
2022,61,142077,神奈川県,茅ヶ崎市,9,2,決算収支の状況,1,令和4年度,96409004,88840438,7568566,318476,7250090,100628,493,1306,3000000,-2897573
2022,61,142085,神奈川県,逗子市,4,2,決算収支の状況,1,令和4年度,25320761,23325345,1995416,12891,1982525,-341391,1337548,0,670000,326157
2022,61,142107,神奈川県,三浦市,4,2,決算収支の状況,1,令和4年度,19975031,19309575,665456,130695,534761,-361844,16,0,575344,-937172
2022,61,142115,神奈川県,秦野市,3,2,決算収支の状況,1,令和4年度,57928266,54948743,2979523,167325,2812198,-629998,12669,0,640403,-1257732
2022,61,142123,神奈川県,厚木市,9,2,決算収支の状況,1,令和4年度,107345604,101779502,5566102,379404,5186698,-378137,2849216,0,4015170,-1544091
2022,61,142131,神奈川県,大和市,9,2,決算収支の状況,1,令和4年度,91599644,87873362,3726282,75863,3650419,-1230182,109,0,1281500,-2511573
2022,61,142140,神奈川県,伊勢原市,3,2,決算収支の状況,1,令和4年度,38543443,36504993,2038450,101087,1937363,-502934,601453,0,0,98519
2022,61,142158,神奈川県,海老名市,3,2,決算収支の状況,1,令和4年度,55185277,52442521,2742756,664100,2078656,-686520,1293946,48283,1057869,-402160
2022,61,142166,神奈川県,座間市,3,2,決算収支の状況,1,令和4年度,51116625,48627717,2488908,339027,2149881,-93006,1897376,0,2939732,-1135362
2022,61,142174,神奈川県,南足柄市,4,2,決算収支の状況,1,令和4年度,19443852,18643028,800824,131594,669230,-335396,1097160,0,625000,136764
2022,61,142182,神奈川県,綾瀬市,4,2,決算収支の状況,1,令和4年度,35373495,33607932,1765563,78204,1687359,-1310825,222,0,5000,-1315603
2022,61,143014,神奈川県,葉山町,5,2,決算収支の状況,1,令和4年度,13327056,12609115,717941,29218,688723,-261047,540023,0,335000,-56024
2022,61,143219,神奈川県,寒川町,5,2,決算収支の状況,1,令和4年度,20901741,18851296,2050445,103281,1947164,-213420,1597555,0,949288,434847
2022,61,143413,神奈川県,大磯町,5,2,決算収支の状況,1,令和4年度,12392842,11601953,790889,16189,774700,-20891,418021,0,609733,-212603
2022,61,143421,神奈川県,二宮町,5,2,決算収支の状況,1,令和4年度,10129636,9579851,549785,71813,477972,-44486,270006,0,228840,-3320
2022,61,143618,神奈川県,中井町,5,2,決算収支の状況,1,令和4年度,4601066,4198255,402811,15972,386839,26156,100155,0,0,126311
2022,61,143626,神奈川県,大井町,5,2,決算収支の状況,1,令和4年度,6808493,6333264,475229,48893,426336,-48921,506,0,0,-48415
2022,61,143634,神奈川県,松田町,5,2,決算収支の状況,1,令和4年度,5733697,5265852,467845,82668,385177,-119807,100013,0,0,-19794
2022,61,143642,神奈川県,山北町,5,2,決算収支の状況,1,令和4年度,6814208,6592343,221865,7628,214237,-146355,203294,0,150000,-93061
2022,61,143669,神奈川県,開成町,5,2,決算収支の状況,1,令和4年度,7760474,7096629,663845,164475,499370,-30550,65,0,200000,-230485
2022,61,143821,神奈川県,箱根町,5,2,決算収支の状況,1,令和4年度,11577350,11182369,394981,13069,381912,-69533,938156,0,522370,346253
2022,61,143839,神奈川県,真鶴町,5,2,決算収支の状況,1,令和4年度,4303093,4120947,182146,225,181921,-157919,210000,0,100000,-47919
2022,61,143847,神奈川県,湯河原町,5,2,決算収支の状況,1,令和4年度,10936759,10309504,627255,107942,519313,-116677,450025,0,200000,133348
2022,61,144011,神奈川県,愛川町,5,2,決算収支の状況,1,令和4年度,15021245,14264743,756502,65162,691340,-62348,180849,0,28721,89780
2022,61,144029,神奈川県,清川村,5,2,決算収支の状況,1,令和4年度,2699791,2570618,129173,30058,99115,-17648,99243,0,0,81595
2022,61,148016,神奈川県,小田原市外二ヶ市町組合,6,2,決算収支の状況,1,令和4年度,116281,36174,80107,0,80107,23792,1000,0,0,24792
2022,61,148024,神奈川県,南足柄市外五ケ市町組合,6,2,決算収支の状況,1,令和4年度,53749,19320,34429,0,34429,8644,0,0,0,8644
2022,61,148041,神奈川県,南足柄市外二ケ市町組合,6,2,決算収支の状況,1,令和4年度,9295,4610,4685,0,4685,398,0,0,0,398
2022,61,148059,神奈川県,南足柄市外二ケ町組合,6,2,決算収支の状況,1,令和4年度,89652,17436,72216,0,72216,24835,0,0,0,24835
2022,61,148067,神奈川県,南足柄市・山北町・開成町一部事務組合,6,2,決算収支の状況,1,令和4年度,5859,1109,4750,0,4750,-187,0,0,0,-187
2022,61,148075,神奈川県,松田町外三ヶ町組合,6,2,決算収支の状況,1,令和4年度,46740,3477,43263,0,43263,15667,0,0,0,15667
2022,61,148130,神奈川県,松田町外二ヶ町組合,6,2,決算収支の状況,1,令和4年度,13398,10447,2951,0,2951,-574,0,0,0,-574
2022,61,148148,神奈川県,金目川水害予防組合,6,2,決算収支の状況,1,令和4年度,4919,4295,624,0,624,223,100,0,0,323
2022,61,148156,神奈川県,秦野市伊勢原市環境衛生組合,6,2,決算収支の状況,1,令和4年度,3105998,3012434,93564,8815,84749,5921,0,0,0,5921
2022,61,148181,神奈川県,高座清掃施設組合,6,2,決算収支の状況,1,令和4年度,3776406,3278702,497704,9963,487741,32612,0,0,0,32612
2022,61,148199,神奈川県,足柄上衛生組合,6,2,決算収支の状況,1,令和4年度,139008,120267,18741,0,18741,-545,0,0,0,-545
2022,61,148202,神奈川県,神奈川県市町村職員退職手当組合,6,2,決算収支の状況,1,令和4年度,3302849,3104074,198775,0,198775,93117,0,0,0,93117
2022,61,148229,神奈川県,箱根町外二カ市組合,6,2,決算収支の状況,1,令和4年度,9435,6565,2870,0,2870,98,1000,0,0,1098
2022,61,148237,神奈川県,南足柄市外四ケ市町組合,6,2,決算収支の状況,1,令和4年度,14778,1275,13503,0,13503,1175,0,0,0,1175
2022,61,148270,神奈川県,湯河原町真鶴町衛生組合,6,2,決算収支の状況,1,令和4年度,1200508,1164611,35897,14721,21176,-31532,0,0,0,-31532
2022,61,148288,神奈川県,広域大和斎場組合,6,2,決算収支の状況,1,令和4年度,480451,444898,35553,1854,33699,-19063,0,0,0,-19063
2022,61,148296,神奈川県,足柄東部清掃組合,6,2,決算収支の状況,1,令和4年度,453117,401318,51799,0,51799,11321,0,0,0,11321
2022,61,148377,神奈川県,足柄西部清掃組合,6,2,決算収支の状況,1,令和4年度,352942,337489,15453,0,15453,-3127,0,0,0,-3127
2022,61,148393,神奈川県,神奈川県川崎競馬組合,7,2,決算収支の状況,1,令和4年度,0,0,0,0,0,0,0,0,0,0
2022,61,148407,神奈川県,厚木愛甲環境施設組合,6,2,決算収支の状況,1,令和4年度,1959710,1855255,104455,97294,7161,3322,0,0,0,3322
2022,61,148415,神奈川県,神奈川県後期高齢者医療広域連合,7,2,決算収支の状況,1,令和4年度,1824750,1667410,157340,0,157340,-468146,336242,0,542649,-674553
2022,61,148423,神奈川県,神奈川県町村情報システム共同事業組合,6,2,決算収支の状況,1,令和4年度,1065340,1026955,38385,0,38385,6590,2,0,0,6592
2022,61,151009,新潟県,新潟市,1,2,決算収支の状況,1,令和4年度,436287767,427945418,8342349,1905162,6437187,-1128649,1167723,0,1586623,-1547549
2022,61,152021,新潟県,長岡市,9,2,決算収支の状況,1,令和4年度,144538627,137432003,7106624,846387,6260237,516476,1950737,0,0,2467213
2022,61,152048,新潟県,三条市,4,2,決算収支の状況,1,令和4年度,54554943,54119894,435049,127968,307081,-1644994,5080121,0,2370000,1065127
2022,61,152056,新潟県,柏崎市,4,2,決算収支の状況,1,令和4年度,51701434,48508074,3193360,271696,2921664,177167,7063,0,0,184230
2022,61,152064,新潟県,新発田市,4,2,決算収支の状況,1,令和4年度,51665798,49392335,2273463,76888,2196575,-362721,2734715,0,2570580,-198586
2022,61,152081,新潟県,小千谷市,4,2,決算収支の状況,1,令和4年度,20177000,19084863,1092137,222580,869557,-443473,673100,0,0,229627
2022,61,152099,新潟県,加茂市,4,2,決算収支の状況,1,令和4年度,14418482,13753118,665364,34982,630382,-385722,658073,88,0,272439
2022,61,152102,新潟県,十日町市,4,2,決算収支の状況,1,令和4年度,38413309,36567858,1845451,88530,1756921,452691,89750,38,0,542479
2022,61,152111,新潟県,見附市,4,2,決算収支の状況,1,令和4年度,18985955,18186362,799593,201501,598092,-225632,435885,0,393758,-183505
2022,61,152129,新潟県,村上市,4,2,決算収支の状況,1,令和4年度,43014379,39868342,3146037,1679021,1467016,-285990,655,0,1442000,-1727335
2022,61,152137,新潟県,燕市,4,2,決算収支の状況,1,令和4年度,46865676,44352361,2513315,195508,2317807,338502,2978445,0,2591536,725411
2022,61,152161,新潟県,糸魚川市,4,2,決算収支の状況,1,令和4年度,29307146,26931152,2375994,179483,2196511,228755,400410,13756,100000,542921
2022,61,152170,新潟県,妙高市,4,2,決算収支の状況,1,令和4年度,23778632,21214510,2564122,181212,2382910,80167,2300,0,0,82467
2022,61,152188,新潟県,五泉市,4,2,決算収支の状況,1,令和4年度,23556571,22420408,1136163,98073,1038090,70067,485091,0,0,555158
2022,61,152226,新潟県,上越市,9,2,決算収支の状況,1,令和4年度,107578176,101584385,5993791,295902,5697889,913289,2392474,0,3476230,-170467
2022,61,152234,新潟県,阿賀野市,4,2,決算収支の状況,1,令和4年度,24122281,22761644,1360637,219171,1141466,219839,100029,0,0,319868
2022,61,152242,新潟県,佐渡市,4,2,決算収支の状況,1,令和4年度,49202791,47158099,2044692,833120,1211572,-183375,706738,0,1932029,-1408666
2022,61,152251,新潟県,魚沼市,4,2,決算収支の状況,1,令和4年度,33968535,32819705,1148830,296573,852257,-6079,466908,0,407750,53079
2022,61,152269,新潟県,南魚沼市,4,2,決算収支の状況,1,令和4年度,39402729,36873250,2529479,296565,2232914,765777,620509,0,624851,761435
2022,61,152277,新潟県,胎内市,4,2,決算収支の状況,1,令和4年度,20975511,19534767,1440744,337420,1103324,-431435,765320,0,434035,-100150
2022,61,153079,新潟県,聖籠町,5,2,決算収支の状況,1,令和4年度,8968139,8366416,601723,48154,553569,-116152,81162,0,40000,-74990
2022,61,153427,新潟県,弥彦村,5,2,決算収支の状況,1,令和4年度,6142759,5444116,698643,246104,452539,-217946,223000,0,0,5054
2022,61,153613,新潟県,田上町,5,2,決算収支の状況,1,令和4年度,5326236,5089204,237032,6272,230760,44140,92608,0,112860,23888
2022,61,153851,新潟県,阿賀町,5,2,決算収支の状況,1,令和4年度,13503403,12806759,696644,131844,564800,-265139,207820,0,0,-57319
2022,61,154059,新潟県,出雲崎町,5,2,決算収支の状況,1,令和4年度,3830872,3666645,164227,25668,138559,10351,105592,0,0,115943
2022,61,154610,新潟県,湯沢町,5,2,決算収支の状況,1,令和4年度,9707335,8952359,754976,224767,530209,-149219,143929,0,0,-5290
2022,61,154822,新潟県,津南町,5,2,決算収支の状況,1,令和4年度,8395852,7897538,498314,16506,481808,-2283,216707,0,0,214424
2022,61,155047,新潟県,刈羽村,5,2,決算収支の状況,1,令和4年度,6514935,6136527,378408,96453,281955,-33105,1172185,0,0,1139080
2022,61,155811,新潟県,関川村,5,2,決算収支の状況,1,令和4年度,6611955,6132272,479683,287429,192254,-7793,118,0,0,-7675
2022,61,155861,新潟県,粟島浦村,5,2,決算収支の状況,1,令和4年度,1678707,1331814,346893,0,346893,12584,55000,0,0,67584
2022,61,158381,新潟県,津南地域衛生施設組合,6,2,決算収支の状況,1,令和4年度,263004,238734,24270,0,24270,-3267,15335,0,6515,5553
2022,61,158542,新潟県,さくら福祉保健事務組合,6,2,決算収支の状況,1,令和4年度,435331,381599,53732,0,53732,-1527,0,0,0,-1527
2022,61,158551,新潟県,寺泊老人ホーム組合,6,2,決算収支の状況,1,令和4年度,194515,186791,7724,0,7724,5921,0,0,4693,1228
2022,61,158607,新潟県,下越福祉行政組合,6,2,決算収支の状況,1,令和4年度,1465490,1358074,107416,0,107416,-14426,0,0,0,-14426
2022,61,158615,新潟県,魚沼地区障害福祉組合,6,2,決算収支の状況,1,令和4年度,463581,454391,9190,0,9190,-15470,1,0,15000,-30469
2022,61,158623,新潟県,新潟県中越福祉事務組合,6,2,決算収支の状況,1,令和4年度,733222,672006,61216,0,61216,41,13000,0,0,13041
2022,61,158631,新潟県,西蒲原福祉事務組合,6,2,決算収支の状況,1,令和4年度,661968,622941,39027,0,39027,-12685,1303,0,0,-11382
2022,61,158640,新潟県,新潟県中東福祉事務組合,6,2,決算収支の状況,1,令和4年度,576732,535572,41160,0,41160,-18432,2,0,0,-18430
2022,61,158895,新潟県,新潟県三条・燕総合グラウンド施設組合,6,2,決算収支の状況,1,令和4年度,42392,40958,1434,0,1434,-110,0,0,0,-110
2022,61,158909,新潟県,三条・燕・西蒲・南蒲広域養護老人ホーム施設組合,6,2,決算収支の状況,1,令和4年度,254248,260869,-6621,0,-6621,-8530,0,0,13550,-22080
2022,61,158933,新潟県,加茂市・田上町消防衛生保育組合,6,2,決算収支の状況,1,令和4年度,1394196,1328442,65754,0,65754,18323,0,0,0,18323
2022,61,159000,新潟県,燕・弥彦総合事務組合,6,2,決算収支の状況,1,令和4年度,2900834,2898668,2166,0,2166,-406,2571,0,10074,-7909
2022,61,159069,新潟県,豊栄郷清掃施設処理組合,6,2,決算収支の状況,1,令和4年度,652781,621693,31088,0,31088,-11948,0,0,0,-11948
2022,61,159123,新潟県,新発田地域広域事務組合,6,2,決算収支の状況,1,令和4年度,4037472,3862498,174974,47981,126993,818,0,0,0,818
2022,61,159166,新潟県,十日町地域広域事務組合,6,2,決算収支の状況,1,令和4年度,1800874,1750370,50504,0,50504,13388,0,0,0,13388
2022,61,159174,新潟県,上越地域消防事務組合,6,2,決算収支の状況,1,令和4年度,2831585,2814112,17473,3570,13903,-248,7108,0,0,6860
2022,61,159476,新潟県,五泉地域衛生施設組合,6,2,決算収支の状況,1,令和4年度,1667453,1629302,38151,0,38151,-19740,0,0,0,-19740
2022,61,159522,新潟県,上越広域伝染病院組合,6,2,決算収支の状況,1,令和4年度,23054,10250,12804,0,12804,26,3,0,0,29
2022,61,159573,新潟県,新潟県市町村総合事務組合（普通会計分）,6,2,決算収支の状況,1,令和4年度,7979511,7330783,648728,0,648728,135371,0,0,0,135371
2022,61,159581,新潟県,新潟県市町村総合事務組合（事業会計分）,7,2,決算収支の状況,1,令和4年度,0,0,0,0,0,0,0,0,0,0
2022,61,159590,新潟県,新潟県後期高齢者医療広域連合,7,2,決算収支の状況,1,令和4年度,335671,296665,39006,0,39006,-26760,0,0,0,-26760
2022,61,162019,富山県,富山市,8,2,決算収支の状況,1,令和4年度,190208167,185526848,4681319,1142965,3538354,105475,500534,12549,0,618558
2022,61,162027,富山県,高岡市,3,2,決算収支の状況,1,令和4年度,72995372,69923583,3071789,998030,2073759,1037136,900,776247,0,1814283
2022,61,162043,富山県,魚津市,4,2,決算収支の状況,1,令和4年度,21653852,19825832,1828020,417824,1410196,-494525,200018,0,0,-294507
2022,61,162051,富山県,氷見市,4,2,決算収支の状況,1,令和4年度,27863669,26824053,1039616,56649,982967,375495,104240,0,100000,379735
2022,61,162060,富山県,滑川市,4,2,決算収支の状況,1,令和4年度,16601588,15389860,1211728,77320,1134408,7725,471024,119300,280000,318049
2022,61,162078,富山県,黒部市,4,2,決算収支の状況,1,令和4年度,24700637,23680960,1019677,240344,779333,-134752,1772,0,0,-132980
2022,61,162086,富山県,砺波市,4,2,決算収支の状況,1,令和4年度,24137213,22011121,2126092,118240,2007852,88305,100,0,0,88405
2022,61,162094,富山県,小矢部市,4,2,決算収支の状況,1,令和4年度,15703178,15198822,504356,23101,481255,-474481,490917,0,0,16436
2022,61,162108,富山県,南砺市,4,2,決算収支の状況,1,令和4年度,38031321,35550460,2480861,130128,2350733,290405,9079,0,21369,278115
2022,61,162116,富山県,射水市,4,2,決算収支の状況,1,令和4年度,42784390,40960565,1823825,287152,1536673,-254763,16255,1149027,0,910519
2022,61,163210,富山県,舟橋村,5,2,決算収支の状況,1,令和4年度,2161891,1923995,237896,18303,219593,22332,0,0,0,22332
2022,61,163228,富山県,上市町,5,2,決算収支の状況,1,令和4年度,11179042,10870037,309005,26884,282121,-48837,2024,0,0,-46813
2022,61,163236,富山県,立山町,5,2,決算収支の状況,1,令和4年度,13706755,13040496,666259,184014,482245,-89659,2,418042,0,328385
2022,61,163422,富山県,入善町,5,2,決算収支の状況,1,令和4年度,12759672,12263644,496028,85897,410131,-44439,448,0,0,-43991
2022,61,163431,富山県,朝日町,5,2,決算収支の状況,1,令和4年度,9655198,9361125,294073,57081,236992,-9507,206385,0,234000,-37122
2022,61,168114,富山県,三郷利田用水市町村組合,6,2,決算収支の状況,1,令和4年度,4403,3040,1363,0,1363,587,0,0,0,587
2022,61,168157,富山県,黒東合口用水組合,6,2,決算収支の状況,1,令和4年度,6694,5098,1596,0,1596,308,49,0,0,357
2022,61,168165,富山県,下山用水組合,6,2,決算収支の状況,1,令和4年度,6301,3369,2932,0,2932,127,0,0,0,127
2022,61,168424,富山県,砺波地方衛生施設組合,6,2,決算収支の状況,1,令和4年度,254234,254226,8,0,8,-2043,7500,0,9000,-3543
2022,61,168611,富山県,庄川水害予防組合,6,2,決算収支の状況,1,令和4年度,4101,260,3841,0,3841,610,0,0,0,610
2022,61,168645,富山県,小矢部川中流水害予防組合,6,2,決算収支の状況,1,令和4年度,118,105,13,0,13,-1,0,0,0,-1
2022,61,168661,富山県,常願寺川右岸水防市町村組合,6,2,決算収支の状況,1,令和4年度,889,366,523,0,523,-106,0,0,0,-106
2022,61,168726,富山県,富山県市町村総合事務組合,6,2,決算収支の状況,1,令和4年度,5926125,5694647,231478,0,231478,-230605,581115,0,0,350510
2022,61,168912,富山県,砺波広域圏事務組合,6,2,決算収支の状況,1,令和4年度,1313066,995615,317451,72900,244551,24959,0,0,0,24959
2022,61,168921,富山県,新川広域圏事務組合,6,2,決算収支の状況,1,令和4年度,1662787,1584671,78116,9900,68216,12283,0,0,0,12283
2022,61,168971,富山県,富山地区広域圏事務組合,6,2,決算収支の状況,1,令和4年度,5084099,4184695,899404,0,899404,302847,10,0,0,302857
2022,61,169005,富山県,高岡地区広域圏事務組合,6,2,決算収支の状況,1,令和4年度,1537289,1483388,53901,0,53901,-4030,30738,0,53000,-26292
2022,61,169013,富山県,富山県市町村会館管理組合,6,2,決算収支の状況,1,令和4年度,251854,196024,55830,0,55830,22852,38000,0,0,60852
2022,61,169048,富山県,中新川広域行政事務組合,6,2,決算収支の状況,1,令和4年度,46043,39731,6312,0,6312,1789,0,0,0,1789
2022,61,169072,富山県,砺波地方介護保険組合,6,2,決算収支の状況,1,令和4年度,297705,272638,25067,0,25067,8308,0,0,12143,-3835
2022,61,169099,富山県,新川地域介護保険・ケーブルテレビ事業組合,6,2,決算収支の状況,1,令和4年度,1539671,1502224,37447,21753,15694,-17712,0,0,0,-17712
2022,61,169111,富山県,滑川中新川地区広域情報事務組合,6,2,決算収支の状況,1,令和4年度,82714,77944,4770,0,4770,-13082,0,0,0,-13082
2022,61,169129,富山県,富山県後期高齢者医療広域連合,7,2,決算収支の状況,1,令和4年度,66995,64590,2405,0,2405,-4122,0,0,0,-4122
2022,61,169137,富山県,砺波地域消防組合,6,2,決算収支の状況,1,令和4年度,2186499,2141665,44834,503,44331,-63297,0,0,0,-63297
2022,61,169145,富山県,富山県東部消防組合,6,2,決算収支の状況,1,令和4年度,1392112,1353299,38813,0,38813,-22648,0,0,0,-22648
2022,61,169153,富山県,新川地域消防組合,6,2,決算収支の状況,1,令和4年度,1482199,1464011,18188,0,18188,-23116,0,0,0,-23116
2022,61,172014,石川県,金沢市,8,2,決算収支の状況,1,令和4年度,243774504,237252022,6522482,2194656,4327826,-239093,4458689,1517750,0,5737346
2022,61,172022,石川県,七尾市,4,2,決算収支の状況,1,令和4年度,39236959,37975170,1261789,121896,1139893,-84562,9103,0,1063074,-1138533
2022,61,172031,石川県,小松市,3,2,決算収支の状況,1,令和4年度,55336355,54093573,1242782,501352,741430,92319,1190,538650,490000,142159
2022,61,172049,石川県,輪島市,4,2,決算収支の状況,1,令和4年度,22237492,21524921,712571,155243,557328,-494500,1920,279636,0,-212944
2022,61,172057,石川県,珠洲市,4,2,決算収支の状況,1,令和4年度,13820966,13323565,497401,114985,382416,-28417,3248,0,0,-25169
2022,61,172065,石川県,加賀市,4,2,決算収支の状況,1,令和4年度,35399425,34059021,1340404,182916,1157488,101388,245,0,500000,-398367
2022,61,172073,石川県,羽咋市,4,2,決算収支の状況,1,令和4年度,13734556,13482056,252500,42664,209836,54889,102207,240179,0,397275
2022,61,172090,石川県,かほく市,4,2,決算収支の状況,1,令和4年度,18994562,18328532,666030,66115,599915,-70053,27029,0,360000,-403024
2022,61,172103,石川県,白山市,3,2,決算収支の状況,1,令和4年度,62341123,60544242,1796881,589584,1207297,-819315,1013411,0,1015236,-821140
2022,61,172111,石川県,能美市,4,2,決算収支の状況,1,令和4年度,25816013,24849463,966550,405656,560894,-52854,3197,0,400000,-449657
2022,61,172120,石川県,野々市市,4,2,決算収支の状況,1,令和4年度,21269400,20609332,660068,104350,555718,46305,2749,0,200000,-150946
2022,61,173240,石川県,川北町,5,2,決算収支の状況,1,令和4年度,4242971,4056748,186223,3750,182473,116980,60171,77689,0,254840
2022,61,173614,石川県,津幡町,5,2,決算収支の状況,1,令和4年度,16972973,16661870,311103,30649,280454,-101076,370369,0,200000,69293
2022,61,173657,石川県,内灘町,5,2,決算収支の状況,1,令和4年度,10757337,10582500,174837,53299,121538,-19027,146,0,70993,-89874
2022,61,173843,石川県,志賀町,5,2,決算収支の状況,1,令和4年度,14002310,13846612,155698,20158,135540,-709,71041,0,0,70332
2022,61,173860,石川県,宝達志水町,5,2,決算収支の状況,1,令和4年度,9484400,8693611,790789,73999,716790,-35388,74393,410564,0,449569
2022,61,174076,石川県,中能登町,5,2,決算収支の状況,1,令和4年度,11500016,10919543,580473,28133,552340,-31563,106238,0,689631,-614956
2022,61,174611,石川県,穴水町,5,2,決算収支の状況,1,令和4年度,7719664,7476559,243105,12973,230132,-137804,1005,0,0,-136799
2022,61,174637,石川県,能登町,5,2,決算収支の状況,1,令和4年度,16008596,15694800,313796,14940,298856,18054,11152,1323895,40858,1312243
2022,61,178063,石川県,石川県市町村消防団員等公務災害補償等組合,6,2,決算収支の状況,1,令和4年度,176187,171422,4765,0,4765,242,0,0,0,242
2022,61,178128,石川県,手取川水防事務組合,6,2,決算収支の状況,1,令和4年度,1982,354,1628,0,1628,575,0,0,0,575
2022,61,178209,石川県,石川県市町村職員退職手当組合,6,2,決算収支の状況,1,令和4年度,3355560,2832073,523487,0,523487,-215291,0,0,0,-215291
2022,61,178217,石川県,河北郡市広域事務組合,6,2,決算収支の状況,1,令和4年度,8403917,8380736,23181,0,23181,-4319,23099,0,50736,-31956
2022,61,178250,石川県,手取川流域環境衛生事業組合,6,2,決算収支の状況,1,令和4年度,243275,111677,131598,0,131598,121478,93,0,138856,-17285
2022,61,178268,石川県,輪島市・穴水町環境衛生施設組合,6,2,決算収支の状況,1,令和4年度,2596972,2579055,17917,0,17917,10314,0,0,0,10314
2022,61,178292,石川県,手取郷広域事務組合,6,2,決算収支の状況,1,令和4年度,113870,107505,6365,0,6365,-6402,3338,0,0,-3064
2022,61,178306,石川県,石川県市町村消防賞じゆつ金組合,6,2,決算収支の状況,1,令和4年度,4933,796,4137,0,4137,745,0,0,0,745
2022,61,178331,石川県,石川県市町議会議員公務災害補償等組合,6,2,決算収支の状況,1,令和4年度,1405,908,497,0,497,-2,0,0,0,-2
2022,61,178373,石川県,羽咋郡市広域圏事務組合（普通会計分）,6,2,決算収支の状況,1,令和4年度,2159004,2148443,10561,5867,4694,2823,0,0,0,2823
2022,61,178411,石川県,白山野々市広域事務組合,6,2,決算収支の状況,1,令和4年度,3848583,3724540,124043,2745,121298,-53160,0,0,0,-53160
2022,61,178462,石川県,奥能登広域圏事務組合,6,2,決算収支の状況,1,令和4年度,2011080,1930600,80480,33522,46958,2308,0,0,0,2308
2022,61,178489,石川県,南加賀広域圏事務組合（普通会計分）,6,2,決算収支の状況,1,令和4年度,429523,429341,182,0,182,-17105,0,0,0,-17105
2022,61,178519,石川県,のと鉄道運営助成基金事務組合,6,2,決算収支の状況,1,令和4年度,141103,141103,0,0,0,0,0,0,0,0
2022,61,178543,石川県,能美介護認定事務組合,6,2,決算収支の状況,1,令和4年度,20184,19524,660,0,660,-1616,0,0,0,-1616
2022,61,178551,石川県,奥能登クリーン組合,6,2,決算収支の状況,1,令和4年度,2981140,2943933,37207,0,37207,2626,0,0,0,2626
2022,61,178560,石川県,石川北部アール・ディ・エフ広域処理組合,6,2,決算収支の状況,1,令和4年度,946462,882037,64425,0,64425,23545,14482,0,16000,22027
2022,61,178624,石川県,石川県後期高齢者医療広域連合,7,2,決算収支の状況,1,令和4年度,115489,98847,16642,0,16642,-4670,21313,0,0,16643
2022,61,182010,福井県,福井市,8,2,決算収支の状況,1,令和4年度,126286682,123932287,2354395,389406,1964989,-1600148,600060,1407128,0,407040
2022,61,182028,福井県,敦賀市,4,2,決算収支の状況,1,令和4年度,45637230,43249863,2387367,185738,2201629,-174315,273,394600,0,220558
2022,61,182044,福井県,小浜市,4,2,決算収支の状況,1,令和4年度,18607044,17892522,714522,89171,625351,-148764,494047,0,285715,59568
2022,61,182052,福井県,大野市,4,2,決算収支の状況,1,令和4年度,19718334,18906953,811381,55133,756248,-129766,444545,0,414419,-99640
2022,61,182061,福井県,勝山市,4,2,決算収支の状況,1,令和4年度,14587592,13935339,652253,70806,581447,145145,215969,50583,261500,150197
2022,61,182079,福井県,鯖江市,4,2,決算収支の状況,1,令和4年度,30240501,28738209,1502292,281978,1220314,75013,672300,0,316700,430613
2022,61,182087,福井県,あわら市,4,2,決算収支の状況,1,令和4年度,19798410,18806266,992144,61958,930186,-211060,1058434,0,570434,276940
2022,61,182095,福井県,越前市,4,2,決算収支の状況,1,令和4年度,41301483,40077527,1223956,107266,1116690,131564,662039,0,1148657,-355054
2022,61,182109,福井県,坂井市,4,2,決算収支の状況,1,令和4年度,48020469,46256167,1764302,159252,1605050,-16484,210158,0,0,193674
2022,61,183229,福井県,永平寺町,5,2,決算収支の状況,1,令和4年度,11566876,11215795,351081,23451,327630,-133042,292191,0,1000000,-840851
2022,61,183822,福井県,池田町,5,2,決算収支の状況,1,令和4年度,5075174,4355713,719461,166692,552769,-25670,11315,0,0,-14355
2022,61,184047,福井県,南越前町,5,2,決算収支の状況,1,令和4年度,10765569,10068527,697042,136203,560839,190815,993,0,0,191808
2022,61,184233,福井県,越前町,5,2,決算収支の状況,1,令和4年度,14904313,14255949,648364,23223,625141,10915,308797,0,350833,-31121
2022,61,184420,福井県,美浜町,5,2,決算収支の状況,1,令和4年度,13183640,12343611,840029,338882,501147,-497535,469000,0,0,-28535
2022,61,184811,福井県,高浜町,5,2,決算収支の状況,1,令和4年度,14232698,12958573,1274125,610858,663267,272422,826631,0,0,1099053
2022,61,184837,福井県,おおい町,5,2,決算収支の状況,1,令和4年度,11346344,10857215,489129,43667,445462,20144,6082,0,0,26226
2022,61,185019,福井県,若狭町,5,2,決算収支の状況,1,令和4年度,12505521,11475812,1029709,57639,972070,33969,467332,0,0,501301
2022,61,188026,福井県,越前三国競艇企業団,7,2,決算収支の状況,1,令和4年度,0,0,0,0,0,0,0,0,0,0
2022,61,188034,福井県,福井県市町総合事務組合（普通会計分）,6,2,決算収支の状況,1,令和4年度,4640623,3398889,1241734,0,1241734,266353,0,0,0,266353
2022,61,188182,福井県,福井県市町総合事務組合（事業会計分）,7,2,決算収支の状況,1,令和4年度,0,0,0,0,0,0,0,0,0,0
2022,61,188212,福井県,美浜・三方環境衛生組合,6,2,決算収支の状況,1,令和4年度,731146,644580,86566,0,86566,-49027,0,0,0,-49027
2022,61,188221,福井県,嶺北消防組合,6,2,決算収支の状況,1,令和4年度,2363256,2339767,23489,3169,20320,-9559,3,0,11000,-20556
2022,61,188239,福井県,鯖江・丹生消防組合,6,2,決算収支の状況,1,令和4年度,1700129,1632812,67317,0,67317,-22341,0,0,0,-22341
2022,61,188255,福井県,福井坂井地区広域市町村圏事務組合,6,2,決算収支の状況,1,令和4年度,2667638,2561784,105854,0,105854,59540,0,0,0,59540
2022,61,188271,福井県,南越消防組合,6,2,決算収支の状況,1,令和4年度,1942782,1899181,43601,7300,36301,-24905,0,0,0,-24905
2022,61,188298,福井県,若狭消防組合,6,2,決算収支の状況,1,令和4年度,1398949,1366511,32438,735,31703,-8027,0,0,0,-8027
2022,61,188301,福井県,敦賀美方消防組合,6,2,決算収支の状況,1,令和4年度,1797558,1754023,43535,28041,15494,-11021,0,0,0,-11021
2022,61,188336,福井県,大野・勝山地区広域行政事務組合,6,2,決算収支の状況,1,令和4年度,1014623,974399,40224,0,40224,16102,0,0,0,16102
2022,61,188395,福井県,南越清掃組合,6,2,決算収支の状況,1,令和4年度,1697839,1645466,52373,0,52373,9216,0,0,0,9216
2022,61,188425,福井県,勝山・永平寺衛生管理組合,6,2,決算収支の状況,1,令和4年度,42858,41233,1625,0,1625,369,0,0,0,369
2022,61,188441,福井県,鯖江広域衛生施設組合,6,2,決算収支の状況,1,令和4年度,1557211,1499725,57486,0,57486,31672,530,0,29885,2317
2022,61,188484,福井県,福井県丹南広域組合,6,2,決算収支の状況,1,令和4年度,903561,860475,43086,4862,38224,2981,0,0,0,2981
2022,61,188506,福井県,福井県自治会館組合,6,2,決算収支の状況,1,令和4年度,111375,107870,3505,0,3505,-1110,4647,0,0,3537
2022,61,188514,福井県,嶺南広域行政組合,6,2,決算収支の状況,1,令和4年度,1475466,1473727,1739,0,1739,-52,0,0,0,-52
2022,61,188531,福井県,坂井地区広域連合,6,2,決算収支の状況,1,令和4年度,702105,685642,16463,0,16463,-11090,0,0,0,-11090
2022,61,188557,福井県,福井県後期高齢者医療広域連合,7,2,決算収支の状況,1,令和4年度,147944,101117,46827,0,46827,13948,0,0,0,13948
2022,61,188565,福井県,若狭広域行政事務組合,6,2,決算収支の状況,1,令和4年度,6962395,6704559,257836,10158,247678,141610,0,0,0,141610
2022,61,192015,山梨県,甲府市,8,2,決算収支の状況,1,令和4年度,87314176,85316489,1997687,213961,1783726,-1873008,941,0,0,-1872067
2022,61,192023,山梨県,富士吉田市,4,2,決算収支の状況,1,令和4年度,35211597,33533047,1678550,873715,804835,-122756,4660,0,600000,-718096
2022,61,192040,山梨県,都留市,4,2,決算収支の状況,1,令和4年度,19964000,19209753,754247,56018,698229,130043,6773,0,195000,-58184
2022,61,192058,山梨県,山梨市,4,2,決算収支の状況,1,令和4年度,26380188,24331963,2048225,132043,1916182,224730,230,0,0,224960
2022,61,192066,山梨県,大月市,4,2,決算収支の状況,1,令和4年度,14232253,13540287,691966,82063,609903,120775,284458,0,0,405233
2022,61,192074,山梨県,韮崎市,4,2,決算収支の状況,1,令和4年度,17180945,16540169,640776,133367,507409,128804,439665,93091,0,661560
2022,61,192082,山梨県,南アルプス市,4,2,決算収支の状況,1,令和4年度,37025213,33309170,3716043,1734095,1981948,-401215,5677,0,0,-395538
2022,61,192091,山梨県,北杜市,4,2,決算収支の状況,1,令和4年度,32256824,31069943,1186881,104658,1082223,-380745,2748,255900,164663,-286760
2022,61,192104,山梨県,甲斐市,4,2,決算収支の状況,1,令和4年度,33948483,31780315,2168168,388069,1780099,27568,1138030,0,405909,759689
2022,61,192112,山梨県,笛吹市,4,2,決算収支の状況,1,令和4年度,42430697,39394882,3035815,1209943,1825872,-115459,375685,0,374864,-114638
2022,61,192121,山梨県,上野原市,4,2,決算収支の状況,1,令和4年度,13108376,12397370,711006,161701,549305,-88688,820764,0,14,732062
2022,61,192139,山梨県,甲州市,4,2,決算収支の状況,1,令和4年度,22449629,21461188,988441,70038,918403,-284607,253894,0,0,-30713
2022,61,192147,山梨県,中央市,4,2,決算収支の状況,1,令和4年度,15830955,13868668,1962287,326838,1635449,342093,38911,0,188880,192124
2022,61,193461,山梨県,市川三郷町,5,2,決算収支の状況,1,令和4年度,9560543,9163829,396714,25416,371298,161718,43380,41,0,205139
2022,61,193640,山梨県,早川町,5,2,決算収支の状況,1,令和4年度,3911454,3512390,399064,29812,369252,30986,61,0,0,31047
2022,61,193658,山梨県,身延町,5,2,決算収支の状況,1,令和4年度,11002740,9978203,1024537,267947,756590,-198734,305,351214,0,152785
2022,61,193666,山梨県,南部町,5,2,決算収支の状況,1,令和4年度,6352456,5549978,802478,258255,544223,-215397,790,0,0,-214607
2022,61,193682,山梨県,富士川町,5,2,決算収支の状況,1,令和4年度,11160645,10786741,373904,94962,278942,-122675,28,23240,0,-99407
2022,61,193844,山梨県,昭和町,5,2,決算収支の状況,1,令和4年度,10510118,10044624,465494,11605,453889,-211951,631369,0,539369,-119951
2022,61,194221,山梨県,道志村,5,2,決算収支の状況,1,令和4年度,2708343,2579867,128476,43263,85213,956,30004,0,0,30960
2022,61,194239,山梨県,西桂町,5,2,決算収支の状況,1,令和4年度,3391053,3297443,93610,21533,72077,4957,57281,0,0,62238
2022,61,194247,山梨県,忍野村,5,2,決算収支の状況,1,令和4年度,6889798,5770929,1118869,733540,385329,-115872,20,0,198875,-314727
2022,61,194255,山梨県,山中湖村,5,2,決算収支の状況,1,令和4年度,5336209,4735092,601117,69776,531341,119861,2323,0,0,122184
2022,61,194298,山梨県,鳴沢村,5,2,決算収支の状況,1,令和4年度,2465794,2272771,193023,29458,163565,33122,437,0,0,33559
2022,61,194301,山梨県,富士河口湖町,5,2,決算収支の状況,1,令和4年度,15616528,13987714,1628814,189186,1439628,-83236,240258,0,260000,-102978
2022,61,194425,山梨県,小菅村,5,2,決算収支の状況,1,令和4年度,1843558,1547239,296319,28306,268013,12750,50089,0,0,62839
2022,61,194433,山梨県,丹波山村,5,2,決算収支の状況,1,令和4年度,2372450,2334056,38394,6000,32394,-32151,150,0,0,-32001
2022,61,198013,山梨県,牛奥山恩賜県有財産保護組合,7,2,決算収支の状況,1,令和4年度,0,0,0,0,0,0,0,0,0,0
2022,61,198021,山梨県,滑沢山恩賜県有財産保護組合,7,2,決算収支の状況,1,令和4年度,0,0,0,0,0,0,0,0,0,0
2022,61,198056,山梨県,金峰前山恩賜県有財産保護組合,7,2,決算収支の状況,1,令和4年度,0,0,0,0,0,0,0,0,0,0
2022,61,198064,山梨県,大蔵沢恩賜県有財産保護組合,7,2,決算収支の状況,1,令和4年度,0,0,0,0,0,0,0,0,0,0
2022,61,198072,山梨県,深沢山恩賜県有財産保護組合,7,2,決算収支の状況,1,令和4年度,0,0,0,0,0,0,0,0,0,0
2022,61,198145,山梨県,京戸入会恩賜県有財産保護組合,7,2,決算収支の状況,1,令和4年度,0,0,0,0,0,0,0,0,0,0
2022,61,198218,山梨県,八町山恩賜県有財産保護組合,7,2,決算収支の状況,1,令和4年度,0,0,0,0,0,0,0,0,0,0
2022,61,198234,山梨県,奥仙重外二字山恩賜県有財産保護組合,7,2,決算収支の状況,1,令和4年度,0,0,0,0,0,0,0,0,0,0
2022,61,198251,山梨県,北奥仙丈外二山恩賜県有財産保護組合,7,2,決算収支の状況,1,令和4年度,0,0,0,0,0,0,0,0,0,0
2022,61,198277,山梨県,御勅使川入旧三十六ケ村入会山恩賜県有財産保護組合,6,2,決算収支の状況,1,令和4年度,1823,311,1512,0,1512,323,0,0,0,323
2022,61,198323,山梨県,御座石山恩賜県有財産保護組合,7,2,決算収支の状況,1,令和4年度,0,0,0,0,0,0,0,0,0,0
2022,61,198340,山梨県,老別当恩賜県有財産保護組合,7,2,決算収支の状況,1,令和4年度,0,0,0,0,0,0,0,0,0,0
2022,61,198358,山梨県,第一御座石前山恩賜県有財産保護組合,7,2,決算収支の状況,1,令和4年度,0,0,0,0,0,0,0,0,0,0
2022,61,198374,山梨県,牛ケ馬場恩賜県有財産保護組合,7,2,決算収支の状況,1,令和4年度,0,0,0,0,0,0,0,0,0,0
2022,61,198382,山梨県,大内窪外壱字恩賜県有財産保護組合,7,2,決算収支の状況,1,令和4年度,0,0,0,0,0,0,0,0,0,0
2022,61,198528,山梨県,釜無山外三字恩賜県有財産保護組合,7,2,決算収支の状況,1,令和4年度,0,0,0,0,0,0,0,0,0,0
2022,61,198544,山梨県,富士吉田市外二ケ村恩賜県有財産保護組合,6,2,決算収支の状況,1,令和4年度,2929465,2770356,159109,570,158539,64783,0,0,0,64783
2022,61,198561,山梨県,鹿留山恩賜県有財産保護組合,7,2,決算収支の状況,1,令和4年度,0,0,0,0,0,0,0,0,0,0
2022,61,198579,山梨県,大旅外二恩賜県有財産保護組合,7,2,決算収支の状況,1,令和4年度,0,0,0,0,0,0,0,0,0,0
2022,61,198587,山梨県,鳴沢・富士河口湖恩賜県有財産保護組合,6,2,決算収支の状況,1,令和4年度,155209,73105,82104,0,82104,13657,0,0,0,13657
2022,61,198595,山梨県,小金沢土室山恩賜県有財産保護組合,7,2,決算収支の状況,1,令和4年度,0,0,0,0,0,0,0,0,0,0
2022,61,198617,山梨県,野脇恩賜県有財産保護組合,7,2,決算収支の状況,1,令和4年度,0,0,0,0,0,0,0,0,0,0
2022,61,198714,山梨県,峡南衛生組合,6,2,決算収支の状況,1,令和4年度,495629,431243,64386,16280,48106,20604,3,0,315,20292
2022,61,198838,山梨県,三郡衛生組合,6,2,決算収支の状況,1,令和4年度,601597,537576,64021,0,64021,39124,35013,0,84394,-10257
2022,61,198960,山梨県,大月都留広域事務組合,6,2,決算収支の状況,1,令和4年度,1057079,1018416,38663,0,38663,4820,6,0,0,4826
2022,61,198994,山梨県,河口湖南中学校組合,6,2,決算収支の状況,1,令和4年度,276304,275004,1300,0,1300,800,0,0,0,800
2022,61,199079,山梨県,青木ケ原衛生センター,6,2,決算収支の状況,1,令和4年度,61982,50481,11501,1540,9961,-4095,0,0,0,-4095
2022,61,199176,山梨県,東山梨行政事務組合,6,2,決算収支の状況,1,令和4年度,1456014,1418218,37796,0,37796,167,4769,0,17097,-12161
2022,61,199214,山梨県,青木が原ごみ処理組合,6,2,決算収支の状況,1,令和4年度,41653,28052,13601,0,13601,647,45,0,0,692
2022,61,199222,山梨県,甲府地区広域行政事務組合,6,2,決算収支の状況,1,令和4年度,4014524,3983087,31437,0,31437,-48717,157,0,115902,-164462
2022,61,199249,山梨県,中巨摩地区広域事務組合,6,2,決算収支の状況,1,令和4年度,1826363,1748217,78146,0,78146,6944,12959,0,75641,-55738
2022,61,199257,山梨県,山梨県市町村総合事務組合（普通会計分）,6,2,決算収支の状況,1,令和4年度,5807669,5490991,316678,0,316678,-112117,274637,0,1054,161466
2022,61,199265,山梨県,山梨県市町村総合事務組合（事業会計分）,7,2,決算収支の状況,1,令和4年度,0,0,0,0,0,0,0,0,0,0
2022,61,199303,山梨県,峡北広域行政事務組合,6,2,決算収支の状況,1,令和4年度,3738202,3423779,314423,205507,108916,12048,69397,0,59107,22338
2022,61,199311,山梨県,東八代広域行政事務組合,6,2,決算収支の状況,1,令和4年度,162249,134054,28195,0,28195,-1411,15000,0,0,13589
2022,61,199320,山梨県,峡南広域行政組合,6,2,決算収支の状況,1,令和4年度,1713688,1678984,34704,12731,21973,-14877,37803,0,40236,-17310
2022,61,199346,山梨県,釈迦堂遺跡博物館組合,6,2,決算収支の状況,1,令和4年度,50461,42245,8216,0,8216,154,0,0,0,154
2022,61,199362,山梨県,富士五湖広域行政事務組合,6,2,決算収支の状況,1,令和4年度,3496781,3494614,2167,0,2167,98,4,0,4000,-3898
2022,61,199419,山梨県,山梨県後期高齢者医療広域連合,7,2,決算収支の状況,1,令和4年度,130862,108622,22240,2382,19858,-17400,36275,0,3550,15325
2022,61,199427,山梨県,甲府・峡東地域ごみ処理施設事務組合,6,2,決算収支の状況,1,令和4年度,2094955,2036466,58489,0,58489,6262,0,0,0,6262
2022,61,199443,山梨県,山梨西部広域環境組合,6,2,決算収支の状況,1,令和4年度,215034,186079,28955,22097,6858,-22787,16552,0,15821,-22056
2022,61,199451,山梨県,富士・東部広域環境事務組合,6,2,決算収支の状況,1,令和4年度,189898,172502,17396,0,17396,14850,0,0,0,14850
2022,61,202011,長野県,長野市,8,2,決算収支の状況,1,令和4年度,170676355,165123960,5552395,1758529,3793866,-237106,12757,0,0,-224349
2022,61,202029,長野県,松本市,8,2,決算収支の状況,1,令和4年度,115090206,112001774,3088432,707984,2380448,-160106,1438678,0,1385370,-106798
2022,61,202037,長野県,上田市,3,2,決算収支の状況,1,令和4年度,76452042,73656302,2795740,555692,2240048,-152709,100000,0,0,-52709
2022,61,202045,長野県,岡谷市,4,2,決算収支の状況,1,令和4年度,22977981,22072298,905683,93187,812496,-12846,351301,0,0,338455
2022,61,202053,長野県,飯田市,4,2,決算収支の状況,1,令和4年度,51208913,50381103,827810,178653,649157,-301561,470019,1300,0,169758
2022,61,202061,長野県,諏訪市,4,2,決算収支の状況,1,令和4年度,23833525,22405797,1427728,66226,1361502,-58095,601189,0,370000,173094
2022,61,202070,長野県,須坂市,4,2,決算収支の状況,1,令和4年度,31265271,30272042,993229,44686,948543,-70714,522006,0,0,451292
2022,61,202088,長野県,小諸市,4,2,決算収支の状況,1,令和4年度,19618309,18624928,993381,207491,785890,102000,2070,12676,0,116746
2022,61,202096,長野県,伊那市,4,2,決算収支の状況,1,令和4年度,42689365,41198595,1490770,517038,973732,48665,11185,194559,152958,101451
2022,61,202100,長野県,駒ケ根市,4,2,決算収支の状況,1,令和4年度,16851590,16080975,770615,49030,721585,388992,218665,0,11000,596657
2022,61,202118,長野県,中野市,4,2,決算収支の状況,1,令和4年度,26405643,25102536,1303107,102640,1200467,465499,392465,0,0,857964
2022,61,202126,長野県,大町市,4,2,決算収支の状況,1,令和4年度,18479240,17667900,811340,81434,729906,-124170,0,0,50000,-174170
2022,61,202134,長野県,飯山市,4,2,決算収支の状況,1,令和4年度,17374636,16414358,960278,62334,897944,140706,200643,0,200000,141349
2022,61,202142,長野県,茅野市,4,2,決算収支の状況,1,令和4年度,30904140,29097068,1807072,99380,1707692,206754,16202,0,0,222956
2022,61,202151,長野県,塩尻市,4,2,決算収支の状況,1,令和4年度,34862534,34160656,701878,160973,540905,-642381,603106,0,0,-39275
2022,61,202177,長野県,佐久市,4,2,決算収支の状況,1,令和4年度,58676637,57261047,1415590,295726,1119864,-434023,213723,998189,0,777889
2022,61,202185,長野県,千曲市,4,2,決算収支の状況,1,令和4年度,27362355,26104713,1257642,161392,1096250,302557,6054,0,50000,258611
2022,61,202193,長野県,東御市,4,2,決算収支の状況,1,令和4年度,16975445,16138955,836490,79432,757058,50495,95335,49744,0,195574
2022,61,202207,長野県,安曇野市,4,2,決算収支の状況,1,令和4年度,48128584,46631102,1497482,165170,1332312,374276,488219,0,490541,371954
2022,61,203033,長野県,小海町,5,2,決算収支の状況,1,令和4年度,5391713,5040064,351649,44890,306759,-212905,7803,0,280957,-486059
2022,61,203041,長野県,川上村,5,2,決算収支の状況,1,令和4年度,7139893,6650793,489100,265385,223715,67385,365,10579,0,78329
2022,61,203050,長野県,南牧村,5,2,決算収支の状況,1,令和4年度,4950648,3906972,1043676,285339,758337,-108083,205,0,0,-107878
2022,61,203068,長野県,南相木村,5,2,決算収支の状況,1,令和4年度,1919280,1861094,58186,12831,45355,43983,86,0,30000,14069
2022,61,203076,長野県,北相木村,5,2,決算収支の状況,1,令和4年度,1883872,1837039,46833,1053,45780,-169372,104734,0,3600,-68238
2022,61,203092,長野県,佐久穂町,5,2,決算収支の状況,1,令和4年度,10920718,9737683,1183035,234459,948576,109402,573,0,490000,-380025
2022,61,203211,長野県,軽井沢町,5,2,決算収支の状況,1,令和4年度,18481908,17036858,1445050,35200,1409850,35910,1113102,0,780000,369012
2022,61,203238,長野県,御代田町,5,2,決算収支の状況,1,令和4年度,9148134,8432599,715535,16145,699390,222127,5100,0,660900,-433673
2022,61,203246,長野県,立科町,5,2,決算収支の状況,1,令和4年度,6602813,5947921,654892,9838,645054,83800,1750,0,0,85550
2022,61,203491,長野県,青木村,5,2,決算収支の状況,1,令和4年度,3309342,2978006,331336,146124,185212,10800,6897,0,0,17697
2022,61,203505,長野県,長和町,5,2,決算収支の状況,1,令和4年度,7275941,7111516,164425,20271,144154,-132306,3817,0,166653,-295142
2022,61,203611,長野県,下諏訪町,5,2,決算収支の状況,1,令和4年度,8617932,8300891,317041,2888,314153,617,11660,0,0,12277
2022,61,203629,長野県,富士見町,5,2,決算収支の状況,1,令和4年度,10111116,9173985,937131,246875,690256,-247406,861985,0,359763,254816
2022,61,203637,長野県,原村,5,2,決算収支の状況,1,令和4年度,5443612,4618054,825558,2772,822786,206960,103123,0,0,310083
2022,61,203823,長野県,辰野町,5,2,決算収支の状況,1,令和4年度,10661535,10173528,488007,65253,422754,-17624,60805,0,0,43181
2022,61,203831,長野県,箕輪町,5,2,決算収支の状況,1,令和4年度,12826701,11611797,1214904,250472,964432,-20017,330096,144961,0,455040
2022,61,203840,長野県,飯島町,5,2,決算収支の状況,1,令和4年度,6542398,6281230,261168,99013,162155,5732,41240,68171,62000,53143
2022,61,203858,長野県,南箕輪村,5,2,決算収支の状況,1,令和4年度,8721383,7845330,876053,368476,507577,-5760,341567,0,0,335807
2022,61,203866,長野県,中川村,5,2,決算収支の状況,1,令和4年度,4753494,4214068,539426,111047,428379,28019,750,0,0,28769
2022,61,203882,長野県,宮田村,5,2,決算収支の状況,1,令和4年度,5485804,5263913,221891,22601,199290,-145050,150955,0,0,5905
2022,61,204021,長野県,松川町,5,2,決算収支の状況,1,令和4年度,8128942,7482074,646868,170843,476025,41285,9800,0,4520,46565
2022,61,204030,長野県,高森町,5,2,決算収支の状況,1,令和4年度,8163538,7427612,735926,28197,707729,-57180,2152,0,0,-55028
2022,61,204048,長野県,阿南町,5,2,決算収支の状況,1,令和4年度,4747988,4413721,334267,246733,87534,-8551,166810,81563,0,239822
2022,61,204072,長野県,阿智村,5,2,決算収支の状況,1,令和4年度,6217551,5859677,357874,70449,287425,7807,150977,0,71273,87511
2022,61,204099,長野県,平谷村,5,2,決算収支の状況,1,令和4年度,1161694,1083427,78267,33605,44662,-57788,111528,0,69300,-15560
2022,61,204102,長野県,根羽村,5,2,決算収支の状況,1,令和4年度,2508349,2337394,170955,20001,150954,-2418,47,0,0,-2371
2022,61,204111,長野県,下條村,5,2,決算収支の状況,1,令和4年度,3738916,3311525,427391,31840,395551,-52474,2143,221300,311000,-140031
2022,61,204129,長野県,売木村,5,2,決算収支の状況,1,令和4年度,1249095,1214656,34439,5964,28475,-330,9003,0,0,8673
2022,61,204137,長野県,天龍村,5,2,決算収支の状況,1,令和4年度,3455565,3327031,128534,15481,113053,-28869,197798,37517,110000,96446
2022,61,204145,長野県,泰阜村,5,2,決算収支の状況,1,令和4年度,2481403,2225201,256202,67034,189168,-11364,197117,43582,0,229335
2022,61,204153,長野県,喬木村,5,2,決算収支の状況,1,令和4年度,5257996,4750173,507823,36541,471282,242745,1410,0,0,244155
2022,61,204161,長野県,豊丘村,5,2,決算収支の状況,1,令和4年度,6881594,6191671,689923,175319,514604,-558851,2073,0,0,-556778
2022,61,204170,長野県,大鹿村,5,2,決算収支の状況,1,令和4年度,2438840,2307339,131501,39547,91954,6558,342,0,0,6900
2022,61,204226,長野県,上松町,5,2,決算収支の状況,1,令和4年度,4520381,4325017,195364,104891,90473,13779,12,0,50000,-36209
2022,61,204234,長野県,南木曽町,5,2,決算収支の状況,1,令和4年度,4357476,4206115,151361,16561,134800,-19987,8,30540,0,10561
2022,61,204251,長野県,木祖村,5,2,決算収支の状況,1,令和4年度,3510170,3273645,236525,53883,182642,-51067,1065,0,0,-50002
2022,61,204293,長野県,王滝村,5,2,決算収支の状況,1,令和4年度,2299452,2199697,99755,18755,81000,-40203,158188,0,145066,-27081
2022,61,204307,長野県,大桑村,5,2,決算収支の状況,1,令和4年度,4853530,4690377,163153,39509,123644,6920,27,400874,60000,347821
2022,61,204323,長野県,木曽町,5,2,決算収支の状況,1,令和4年度,12150902,11639142,511760,142642,369118,-61703,12003,0,380000,-429700
2022,61,204463,長野県,麻績村,5,2,決算収支の状況,1,令和4年度,3408283,3274037,134246,47793,86453,-17322,160000,0,54000,88678
2022,61,204480,長野県,生坂村,5,2,決算収支の状況,1,令和4年度,2653096,2620030,33066,2050,31016,22149,100253,44551,0,166953
2022,61,204501,長野県,山形村,5,2,決算収支の状況,1,令和4年度,4307515,4169019,138496,25871,112625,-123994,118891,0,0,-5103
2022,61,204510,長野県,朝日村,5,2,決算収支の状況,1,令和4年度,3791002,3660863,130139,15211,114928,1304,410057,0,0,411361
2022,61,204528,長野県,筑北村,5,2,決算収支の状況,1,令和4年度,5408513,5246649,161864,30350,131514,-92508,385626,70184,0,363302
2022,61,204811,長野県,池田町,5,2,決算収支の状況,1,令和4年度,5488605,5378283,110322,47283,63039,5120,74,115100,0,120294
2022,61,204820,長野県,松川村,5,2,決算収支の状況,1,令和4年度,4983648,4859624,124024,98118,25906,18773,187,0,0,18960
2022,61,204854,長野県,白馬村,5,2,決算収支の状況,1,令和4年度,6965601,6700741,264860,52199,212661,72920,84488,0,0,157408
2022,61,204862,長野県,小谷村,5,2,決算収支の状況,1,令和4年度,4760072,4636632,123440,73167,50273,-46315,27653,0,0,-18662
2022,61,205214,長野県,坂城町,5,2,決算収支の状況,1,令和4年度,9067189,8958311,108878,62488,46390,-20311,6543,0,0,-13768
2022,61,205419,長野県,小布施町,5,2,決算収支の状況,1,令和4年度,7114129,6359884,754245,58507,695738,-9379,424906,46000,0,461527
2022,61,205435,長野県,高山村,5,2,決算収支の状況,1,令和4年度,5148853,4848828,300025,28153,271872,-4036,301,0,67000,-70735
2022,61,205613,長野県,山ノ内町,5,2,決算収支の状況,1,令和4年度,8441829,8042130,399699,22348,377351,67425,55314,0,0,122739
2022,61,205621,長野県,木島平村,5,2,決算収支の状況,1,令和4年度,4332266,4142747,189519,7992,181527,-8773,280034,0,278452,-7191
2022,61,205630,長野県,野沢温泉村,5,2,決算収支の状況,1,令和4年度,4166330,3956451,209879,13048,196831,34762,5861,0,0,40623
2022,61,205834,長野県,信濃町,5,2,決算収支の状況,1,令和4年度,6323716,6184585,139131,25353,113778,-5417,9000,0,0,3583
2022,61,205885,長野県,小川村,5,2,決算収支の状況,1,令和4年度,3759245,3391899,367346,23822,343524,-67013,108384,97049,0,138420
2022,61,205907,長野県,飯綱町,5,2,決算収支の状況,1,令和4年度,8933153,8335681,597472,51002,546470,-201434,1800,0,100000,-299634
2022,61,206024,長野県,栄村,5,2,決算収支の状況,1,令和4年度,3361458,2948184,413274,82532,330742,3455,27062,0,0,30517
2022,61,208108,長野県,北佐久郡老人福祉施設組合,6,2,決算収支の状況,1,令和4年度,183426,173993,9433,5272,4161,-35099,24720,0,0,-10379
2022,61,208116,長野県,森泉山財産組合,7,2,決算収支の状況,1,令和4年度,0,0,0,0,0,0,0,0,0,0
2022,61,208132,長野県,川西保健衛生施設組合,6,2,決算収支の状況,1,令和4年度,389194,291798,97396,0,97396,18410,0,0,0,18410
2022,61,208175,長野県,上田市東御市真田共有財産組合,7,2,決算収支の状況,1,令和4年度,0,0,0,0,0,0,0,0,0,0
2022,61,208183,長野県,上田市長和町中学校組合,6,2,決算収支の状況,1,令和4年度,119982,118486,1496,0,1496,-342,0,0,0,-342
2022,61,208191,長野県,青木村及び上田市共有財産組合,7,2,決算収支の状況,1,令和4年度,0,0,0,0,0,0,0,0,0,0
2022,61,208213,長野県,葛尾組合,6,2,決算収支の状況,1,令和4年度,406402,319600,86802,24904,61898,10246,0,0,0,10246
2022,61,208302,長野県,浅麓環境施設組合,6,2,決算収支の状況,1,令和4年度,717674,706312,11362,0,11362,-31279,0,0,0,-31279
2022,61,208311,長野県,千曲衛生施設組合,6,2,決算収支の状況,1,令和4年度,211906,201351,10555,0,10555,-13755,1335,0,0,-12420
2022,61,208329,長野県,松本広域連合,6,2,決算収支の状況,1,令和4年度,4914077,4583490,330587,0,330587,-65286,0,0,0,-65286
2022,61,208388,長野県,佐久平環境衛生組合,6,2,決算収支の状況,1,令和4年度,363661,292749,70912,0,70912,43900,0,0,0,43900
2022,61,208434,長野県,南信地域町村交通災害共済事務組合,7,2,決算収支の状況,1,令和4年度,0,0,0,0,0,0,0,0,0,0
2022,61,208451,長野県,佐久市・北佐久郡環境施設組合,6,2,決算収支の状況,1,令和4年度,831621,719008,112613,0,112613,28666,0,83944,0,112610
2022,61,208469,長野県,辰野町塩尻市小学校組合,6,2,決算収支の状況,1,令和4年度,108685,87123,21562,0,21562,5469,0,0,0,5469
2022,61,208485,長野県,長野広域連合,6,2,決算収支の状況,1,令和4年度,6152649,5263310,889339,0,889339,-291879,3789,0,0,-288090
2022,61,208493,長野県,湖周行政事務組合,6,2,決算収支の状況,1,令和4年度,906414,906414,0,0,0,0,0,0,0,0
2022,61,208531,長野県,安曇野・松本行政事務組合,6,2,決算収支の状況,1,令和4年度,40338,37397,2941,0,2941,-429,0,0,0,-429
2022,61,208566,長野県,安曇野市・松本市山林組合,6,2,決算収支の状況,1,令和4年度,10833,7452,3381,0,3381,1475,0,0,0,1475
2022,61,208574,長野県,中信地域町村交通災害共済事務組合,7,2,決算収支の状況,1,令和4年度,0,0,0,0,0,0,0,0,0,0
2022,61,208604,長野県,穂高広域施設組合,6,2,決算収支の状況,1,令和4年度,1166768,1112098,54670,0,54670,3023,65,0,0,3088
2022,61,208647,長野県,池田松川施設組合,6,2,決算収支の状況,1,令和4年度,186046,185992,54,0,54,-165,0,0,0,-165
2022,61,208701,長野県,松塩安筑老人福祉施設組合,6,2,決算収支の状況,1,令和4年度,406135,378293,27842,0,27842,15743,137,0,29360,-13480
2022,61,208736,長野県,松本市・山形村・朝日村中学校組合,6,2,決算収支の状況,1,令和4年度,192327,183694,8633,0,8633,-3842,0,0,0,-3842
2022,61,208752,長野県,湖北行政事務組合（普通会計分）,6,2,決算収支の状況,1,令和4年度,219132,219132,0,0,0,0,0,0,0,0
2022,61,208787,長野県,諏訪市・茅野市衛生施設組合,6,2,決算収支の状況,1,令和4年度,115421,103644,11777,0,11777,3724,0,0,0,3724
2022,61,208809,長野県,伊那中央行政組合（普通会計分）,6,2,決算収支の状況,1,令和4年度,1990104,1917645,72459,0,72459,47200,0,0,0,47200
2022,61,208825,長野県,伊南行政組合,6,2,決算収支の状況,1,令和4年度,255675,227953,27722,0,27722,-8555,0,0,0,-8555
2022,61,208884,長野県,塩尻市辰野町中学校組合,6,2,決算収支の状況,1,令和4年度,124183,101017,23166,450,22716,3582,0,0,0,3582
2022,61,208931,長野県,北アルプス広域連合,6,2,決算収支の状況,1,令和4年度,2125037,2040399,84638,3960,80678,-27374,2794,0,0,-24580
2022,61,208949,長野県,佐久広域連合,6,2,決算収支の状況,1,令和4年度,3383789,3378939,4850,0,4850,-428,90676,0,95919,-5671
2022,61,208973,長野県,下伊那郡町村総合事務組合,6,2,決算収支の状況,1,令和4年度,10280,9879,401,0,401,-24,0,0,0,-24
2022,61,209058,長野県,佐久市・軽井沢町清掃施設組合,6,2,決算収支の状況,1,令和4年度,366833,292822,74011,0,74011,50275,0,0,0,50275
2022,61,209066,長野県,南佐久環境衛生組合,6,2,決算収支の状況,1,令和4年度,119264,109125,10139,0,10139,3032,0,0,0,3032
2022,61,209112,長野県,六ケ郷用水組合,6,2,決算収支の状況,1,令和4年度,17145,13990,3155,0,3155,160,0,0,0,160
2022,61,209121,長野県,高山村外一市一町財産組合,7,2,決算収支の状況,1,令和4年度,0,0,0,0,0,0,0,0,0,0
2022,61,209147,長野県,下伊那北部総合事務組合,6,2,決算収支の状況,1,令和4年度,80262,74899,5363,0,5363,-791,0,0,0,-791
2022,61,209171,長野県,東北信市町村交通災害共済事務組合,7,2,決算収支の状況,1,令和4年度,0,0,0,0,0,0,0,0,0,0
2022,61,209201,長野県,北部衛生施設組合,6,2,決算収支の状況,1,令和4年度,101543,89741,11802,2178,9624,2658,0,0,0,2658
2022,61,209210,長野県,長水部分林組合,6,2,決算収支の状況,1,令和4年度,75,0,75,75,0,0,0,0,0,0
2022,61,209244,長野県,岳南広域消防組合,6,2,決算収支の状況,1,令和4年度,1131684,1091503,40181,0,40181,6338,0,0,0,6338
2022,61,209252,長野県,長野県市町村自治振興組合,6,2,決算収支の状況,1,令和4年度,1832696,1780008,52688,0,52688,13465,0,0,0,13465
2022,61,209279,長野県,木曽広域連合,6,2,決算収支の状況,1,令和4年度,3983776,3840282,143494,73138,70356,1370,0,0,0,1370
2022,61,209287,長野県,南信州広域連合,6,2,決算収支の状況,1,令和4年度,4159319,3979263,180056,28827,151229,-2160,37937,0,0,35777
2022,61,209295,長野県,長野県地方税滞納整理機構,6,2,決算収支の状況,1,令和4年度,210248,206055,4193,0,4193,-2948,3572,0,6000,-5376
2022,61,209317,長野県,依田窪医療福祉事務組合,6,2,決算収支の状況,1,令和4年度,33317,32230,1087,0,1087,381,0,0,0,381
2022,61,209333,長野県,上伊那広域連合,6,2,決算収支の状況,1,令和4年度,4951055,4815051,136004,0,136004,26660,0,0,0,26660
2022,61,209368,長野県,須高行政事務組合,6,2,決算収支の状況,1,令和4年度,225959,216914,9045,0,9045,48,0,0,0,48
2022,61,209392,長野県,下伊那郡土木技術センター組合,6,2,決算収支の状況,1,令和4年度,169292,162702,6590,0,6590,-403,12000,0,0,11597
2022,61,209406,長野県,上田地域広域連合,6,2,決算収支の状況,1,令和4年度,4939976,4674261,265715,28065,237650,-4220,0,0,0,-4220
2022,61,209422,長野県,岳北広域行政組合,6,2,決算収支の状況,1,令和4年度,1420015,1380420,39595,0,39595,-2554,0,0,0,-2554
2022,61,209431,長野県,小海町北相木村南相木村中学校組合,6,2,決算収支の状況,1,令和4年度,179600,172540,7060,0,7060,1607,0,0,0,1607
2022,61,209449,長野県,長野県市町村総合事務組合,6,2,決算収支の状況,1,令和4年度,6558759,6155145,403614,0,403614,-535591,0,0,0,-535591
2022,61,209457,長野県,長野県民交通災害共済組合,7,2,決算収支の状況,1,令和4年度,0,0,0,0,0,0,0,0,0,0
2022,61,209490,長野県,北信保健衛生施設組合,6,2,決算収支の状況,1,令和4年度,845961,813514,32447,0,32447,6483,0,0,0,6483
2022,61,209546,長野県,千曲坂城消防組合,6,2,決算収支の状況,1,令和4年度,1105981,1044438,61543,0,61543,8646,10,0,6155,2501
2022,61,209554,長野県,諏訪広域公立大学事務組合,6,2,決算収支の状況,1,令和4年度,2074471,2069929,4542,0,4542,81,0,0,0,81
2022,61,209601,長野県,松塩地区広域施設組合,6,2,決算収支の状況,1,令和4年度,2841409,2664547,176862,0,176862,87978,0,0,0,87978
2022,61,209651,長野県,南諏衛生施設組合,6,2,決算収支の状況,1,令和4年度,178143,143129,35014,4400,30614,-21923,0,0,0,-21923
2022,61,209716,長野県,下伊那郡西部衛生施設組合,6,2,決算収支の状況,1,令和4年度,86101,77953,8148,0,8148,-4993,0,0,0,-4993
2022,61,209791,長野県,長野県後期高齢者医療広域連合,7,2,決算収支の状況,1,令和4年度,238595,188256,50339,0,50339,-3269,0,0,0,-3269
2022,61,209805,長野県,北信広域連合,6,2,決算収支の状況,1,令和4年度,594202,579885,14317,373,13944,-130,30739,0,0,30609
2022,61,209813,長野県,諏訪広域連合,6,2,決算収支の状況,1,令和4年度,3295147,3085612,209535,5869,203666,-32492,188,0,0,-32304
2022,61,209881,長野県,白馬山麓事務組合,6,2,決算収支の状況,1,令和4年度,329886,317941,11945,0,11945,1540,0,0,0,1540
2022,61,209902,長野県,諏訪南行政事務組合,6,2,決算収支の状況,1,令和4年度,826878,743222,83656,15015,68641,-139671,0,0,0,-139671
2022,61,209911,長野県,下伊那自治センター組合,6,2,決算収支の状況,1,令和4年度,2249,2129,120,0,120,-26,0,0,0,-26
2022,61,209953,長野県,白樺湖下水道組合,6,2,決算収支の状況,1,令和4年度,25696,20682,5014,0,5014,-1315,0,0,0,-1315
2022,61,209970,長野県,下伊那南部総合事務組合,6,2,決算収支の状況,1,令和4年度,131341,121603,9738,0,9738,3082,13296,0,0,16378
2022,61,209996,長野県,安曇野松筑広域環境施設組合,6,2,決算収支の状況,1,令和4年度,128285,122493,5792,0,5792,2250,1006,0,5200,-1944
2022,61,212016,岐阜県,岐阜市,8,2,決算収支の状況,1,令和4年度,196878547,188492600,8385947,430603,7955344,-926043,1000966,0,0,74923
2022,61,212024,岐阜県,大垣市,3,2,決算収支の状況,1,令和4年度,67952641,65604456,2348185,82039,2266146,-2486899,1605300,0,0,-881599
2022,61,212032,岐阜県,高山市,4,2,決算収支の状況,1,令和4年度,58176489,52895871,5280618,1165949,4114669,1309769,41526,0,1200000,151295
2022,61,212041,岐阜県,多治見市,3,2,決算収支の状況,1,令和4年度,49932938,44989859,4943079,546233,4396846,-707379,35375,0,1645775,-2317779
2022,61,212059,岐阜県,関市,4,2,決算収支の状況,1,令和4年度,54156592,49554242,4602350,543844,4058506,-355164,760192,0,3500000,-3094972
2022,61,212067,岐阜県,中津川市,4,2,決算収支の状況,1,令和4年度,49279547,43078716,6200831,903282,5297549,-221929,3709,0,1298106,-1516326
2022,61,212075,岐阜県,美濃市,4,2,決算収支の状況,1,令和4年度,11460252,10924849,535403,55844,479559,-144306,8070,0,0,-136236
2022,61,212083,岐阜県,瑞浪市,4,2,決算収支の状況,1,令和4年度,18503129,17596035,907094,180076,727018,8,281100,0,496000,-214892
2022,61,212091,岐阜県,羽島市,4,2,決算収支の状況,1,令和4年度,26312709,24849234,1463475,23151,1440324,164156,700132,0,600000,264288
2022,61,212105,岐阜県,恵那市,4,2,決算収支の状況,1,令和4年度,32356201,29897911,2458290,737999,1720291,-732982,15484,247009,0,-470489
2022,61,212113,岐阜県,美濃加茂市,4,2,決算収支の状況,1,令和4年度,25030602,22877291,2153311,109244,2044067,-83947,114008,0,0,30061
2022,61,212121,岐阜県,土岐市,4,2,決算収支の状況,1,令和4年度,25928103,25390534,537569,117459,420110,-584872,352744,0,0,-232128
2022,61,212130,岐阜県,各務原市,3,2,決算収支の状況,1,令和4年度,60091624,56570232,3521392,400917,3120475,-1491700,701786,0,0,-789914
2022,61,212148,岐阜県,可児市,4,2,決算収支の状況,1,令和4年度,39073554,36233940,2839614,241943,2597671,223615,1309480,0,0,1533095
2022,61,212156,岐阜県,山県市,4,2,決算収支の状況,1,令和4年度,14742246,13978960,763286,98855,664431,-92381,616,0,0,-91765
2022,61,212164,岐阜県,瑞穂市,4,2,決算収支の状況,1,令和4年度,22268522,21083784,1184738,300594,884144,-84109,1015,0,195791,-278885
2022,61,212172,岐阜県,飛騨市,4,2,決算収支の状況,1,令和4年度,23673262,22068907,1604355,344468,1259887,-285276,781054,66360,570000,-7862
2022,61,212181,岐阜県,本巣市,4,2,決算収支の状況,1,令和4年度,22694096,21430252,1263844,378404,885440,-265497,315000,0,401000,-351497
2022,61,212199,岐阜県,郡上市,4,2,決算収支の状況,1,令和4年度,30735282,29247711,1487571,388003,1099568,-229476,355710,0,0,126234
2022,61,212202,岐阜県,下呂市,4,2,決算収支の状況,1,令和4年度,27899046,25993985,1905061,527341,1377720,97978,815069,0,1037000,-123953
2022,61,212211,岐阜県,海津市,4,2,決算収支の状況,1,令和4年度,19049292,18208903,840389,35634,804755,-203785,602707,0,0,398922
2022,61,213021,岐阜県,岐南町,5,2,決算収支の状況,1,令和4年度,10605693,9891581,714112,52892,661220,-216887,323500,0,200000,-93387
2022,61,213039,岐阜県,笠松町,5,2,決算収支の状況,1,令和4年度,8619456,8132230,487226,24249,462977,-190124,239656,0,0,49532
2022,61,213411,岐阜県,養老町,5,2,決算収支の状況,1,令和4年度,13477033,12396961,1080072,14903,1065169,-90630,5476,0,0,-85154
2022,61,213616,岐阜県,垂井町,5,2,決算収支の状況,1,令和4年度,10642435,10180279,462156,14153,448003,-170574,93123,0,0,-77451
2022,61,213624,岐阜県,関ケ原町,5,2,決算収支の状況,1,令和4年度,4659812,4275474,384338,0,384338,3014,10084,0,0,13098
2022,61,213811,岐阜県,神戸町,5,2,決算収支の状況,1,令和4年度,7782351,7489233,293118,44281,248837,-339511,600565,0,182500,78554
2022,61,213829,岐阜県,輪之内町,5,2,決算収支の状況,1,令和4年度,4786859,4595469,191390,0,191390,-40044,15468,0,0,-24576
2022,61,213837,岐阜県,安八町,5,2,決算収支の状況,1,令和4年度,7431714,6919484,512230,76826,435404,-21965,57002,0,403414,-368377
2022,61,214019,岐阜県,揖斐川町,5,2,決算収支の状況,1,令和4年度,15907924,15255815,652109,55989,596120,-341893,461801,0,0,119908
2022,61,214035,岐阜県,大野町,5,2,決算収支の状況,1,令和4年度,8815449,8671339,144110,3478,140632,-276690,246,51692,49000,-273752
2022,61,214043,岐阜県,池田町,5,2,決算収支の状況,1,令和4年度,10929452,10430112,499340,0,499340,-457858,483725,0,320000,-294133
2022,61,214213,岐阜県,北方町,5,2,決算収支の状況,1,令和4年度,9506398,8867637,638761,4040,634721,70339,902165,0,0,972504
2022,61,215015,岐阜県,坂祝町,5,2,決算収支の状況,1,令和4年度,4058668,3816711,241957,10687,231270,20949,126942,0,14475,133416
2022,61,215023,岐阜県,富加町,5,2,決算収支の状況,1,令和4年度,3384441,3237588,146853,2033,144820,-56954,79376,0,0,22422
2022,61,215031,岐阜県,川辺町,5,2,決算収支の状況,1,令和4年度,5893954,5604571,289383,20672,268711,8318,5118,0,127190,-113754
2022,61,215040,岐阜県,七宗町,5,2,決算収支の状況,1,令和4年度,3334782,3182217,152565,0,152565,21641,66208,0,0,87849
2022,61,215058,岐阜県,八百津町,5,2,決算収支の状況,1,令和4年度,6987273,6491097,496176,4616,491560,107160,1242,1869,0,110271
2022,61,215066,岐阜県,白川町,5,2,決算収支の状況,1,令和4年度,7257109,6712763,544346,160844,383502,-17526,0,0,0,-17526
2022,61,215074,岐阜県,東白川村,5,2,決算収支の状況,1,令和4年度,3292109,2916919,375190,20872,354318,-30533,100300,0,100000,-30233
2022,61,215210,岐阜県,御嵩町,5,2,決算収支の状況,1,令和4年度,9182125,8874568,307557,15464,292093,143276,109532,0,0,252808
2022,61,216046,岐阜県,白川村,5,2,決算収支の状況,1,令和4年度,4454869,3918784,536085,15034,521051,431781,0,0,0,431781
2022,61,218219,岐阜県,岐阜羽島衛生施設組合,6,2,決算収支の状況,1,令和4年度,636992,526192,110800,0,110800,-86789,0,0,0,-86789
2022,61,218227,岐阜県,大垣衛生施設組合,6,2,決算収支の状況,1,令和4年度,547492,483376,64116,0,64116,-41404,0,0,0,-41404
2022,61,218235,岐阜県,可茂衛生施設利用組合,6,2,決算収支の状況,1,令和4年度,3470577,3339096,131481,18058,113423,-5347,11847,0,47500,-41000
2022,61,218243,岐阜県,南濃衛生施設利用事務組合,6,2,決算収支の状況,1,令和4年度,3133177,3027705,105472,0,105472,21250,0,0,0,21250
2022,61,218391,岐阜県,木曽川右岸地帯水防事務組合,6,2,決算収支の状況,1,令和4年度,41090,29476,11614,0,11614,256,0,0,0,256
2022,61,218405,岐阜県,大垣輪中水防事務組合,6,2,決算収支の状況,1,令和4年度,56350,30411,25939,0,25939,1301,0,0,0,1301
2022,61,218430,岐阜県,揖斐川水防事務組合,6,2,決算収支の状況,1,令和4年度,3329,2029,1300,0,1300,-5,0,0,0,-5
2022,61,218472,岐阜県,土岐川防災ダム一部事務組合,6,2,決算収支の状況,1,令和4年度,19610,16928,2682,0,2682,245,0,0,0,245
2022,61,218481,岐阜県,可児川防災等ため池組合,6,2,決算収支の状況,1,令和4年度,42413,39377,3036,0,3036,-1477,0,0,0,-1477
2022,61,218499,岐阜県,揖斐郡養基小学校養基保育所組合,6,2,決算収支の状況,1,令和4年度,207976,194901,13075,0,13075,3800,0,0,0,3800
2022,61,218537,岐阜県,大垣市安八郡安八町東安中学校組合,6,2,決算収支の状況,1,令和4年度,113475,104315,9160,0,9160,-2868,0,0,0,-2868
2022,61,218588,岐阜県,可児市・御嵩町中学校組合,6,2,決算収支の状況,1,令和4年度,65319,64394,925,0,925,-1114,0,0,0,-1114
2022,61,218669,岐阜県,岐阜県市町村会館組合,6,2,決算収支の状況,1,令和4年度,61127,56065,5062,0,5062,852,1,0,0,853
2022,61,218693,岐阜県,樫原谷林野組合,6,2,決算収支の状況,1,令和4年度,1870,113,1757,0,1757,1626,0,0,0,1626
2022,61,218707,岐阜県,足打谷林野組合,6,2,決算収支の状況,1,令和4年度,3838,114,3724,0,3724,2527,0,0,0,2527
2022,61,218782,岐阜県,岐阜県市町村職員退職手当組合,6,2,決算収支の状況,1,令和4年度,6958181,6929467,28714,0,28714,-355067,0,0,0,-355067
2022,61,218791,岐阜県,不破消防組合,6,2,決算収支の状況,1,令和4年度,739071,695352,43719,0,43719,-15327,0,0,0,-15327
2022,61,218821,岐阜県,美濃加茂市富加町中学校組合,6,2,決算収支の状況,1,令和4年度,103715,91406,12309,0,12309,7707,6,0,12593,-4880
2022,61,218898,岐阜県,揖斐郡消防組合,6,2,決算収支の状況,1,令和4年度,866589,839683,26906,15636,11270,-16485,30286,0,19000,-5199
2022,61,218901,岐阜県,可茂消防事務組合,6,2,決算収支の状況,1,令和4年度,2969681,2838737,130944,0,130944,-14831,76,0,0,-14755
2022,61,218936,岐阜県,岐阜県地方競馬組合,7,2,決算収支の状況,1,令和4年度,0,0,0,0,0,0,0,0,0,0
2022,61,218944,岐阜県,大垣消防組合,6,2,決算収支の状況,1,令和4年度,3551713,3432824,118889,0,118889,-88940,0,0,0,-88940
2022,61,218952,岐阜県,西濃環境整備組合,6,2,決算収支の状況,1,令和4年度,1532945,1516886,16059,0,16059,-19966,7,0,226504,-246463
2022,61,219002,岐阜県,岐北衛生施設利用組合,6,2,決算収支の状況,1,令和4年度,252736,231029,21707,0,21707,-9270,0,0,0,-9270
2022,61,219070,岐阜県,中濃地域広域行政事務組合,6,2,決算収支の状況,1,令和4年度,1565058,1414493,150565,0,150565,2392,700,0,1191,1901
2022,61,219088,岐阜県,中濃消防組合,6,2,決算収支の状況,1,令和4年度,1943036,1773030,170006,63250,106756,-13531,0,0,0,-13531
2022,61,219169,岐阜県,東濃西部広域行政事務組合,6,2,決算収支の状況,1,令和4年度,241141,223892,17249,0,17249,2070,0,0,0,2070
2022,61,219177,岐阜県,西南濃粗大廃棄物処理組合,6,2,決算収支の状況,1,令和4年度,576052,502373,73679,0,73679,8609,0,0,0,8609
2022,61,219321,岐阜県,岐阜地域児童発達支援センター組合,6,2,決算収支の状況,1,令和4年度,146015,140674,5341,0,5341,-2452,0,0,0,-2452
2022,61,219371,岐阜県,土岐市及び瑞浪市休日急病診療所組合,6,2,決算収支の状況,1,令和4年度,61714,58215,3499,0,3499,-1475,0,0,0,-1475
2022,61,219754,岐阜県,安八郡広域連合,7,2,決算収支の状況,1,令和4年度,0,0,0,0,0,0,0,0,0,0
2022,61,219762,岐阜県,揖斐広域連合,6,2,決算収支の状況,1,令和4年度,379547,377998,1549,0,1549,-7852,1,0,0,-7851
2022,61,219771,岐阜県,もとす広域連合（普通会計分）,6,2,決算収支の状況,1,令和4年度,705946,656661,49285,829,48456,17816,24195,0,133845,-91834
2022,61,219843,岐阜県,羽島郡広域連合,6,2,決算収支の状況,1,令和4年度,783176,760799,22377,0,22377,-22354,0,0,0,-22354
2022,61,219851,岐阜県,古川国府給食センター利用組合,6,2,決算収支の状況,1,令和4年度,311739,311688,51,0,51,48,0,0,0,48
2022,61,219860,岐阜県,岐阜県後期高齢者医療広域連合,7,2,決算収支の状況,1,令和4年度,156816,125000,31816,0,31816,12635,0,0,0,12635
2022,61,221007,静岡県,静岡市,1,2,決算収支の状況,1,令和4年度,360822341,349544762,11277579,4411306,6866273,274597,3301133,31942,3270960,336712
2022,61,221309,静岡県,浜松市,1,2,決算収支の状況,1,令和4年度,396006285,381204906,14801379,5482924,9318455,2085088,4316371,0,5000000,1401459
2022,61,222038,静岡県,沼津市,9,2,決算収支の状況,1,令和4年度,91055621,87851541,3204080,92125,3111955,-362592,1782875,0,1122757,297526
2022,61,222054,静岡県,熱海市,4,2,決算収支の状況,1,令和4年度,23588550,20409688,3178862,447340,2731522,949193,369551,0,968786,349958
2022,61,222062,静岡県,三島市,3,2,決算収支の状況,1,令和4年度,42889680,40505433,2384247,101995,2282252,170700,866036,0,466000,570736
2022,61,222071,静岡県,富士宮市,3,2,決算収支の状況,1,令和4年度,57579185,54495225,3083960,408479,2675481,-834351,1888823,0,1807000,-752528
2022,61,222089,静岡県,伊東市,4,2,決算収支の状況,1,令和4年度,31243880,30134406,1109474,244291,865183,-35800,460029,0,0,424229
2022,61,222097,静岡県,島田市,4,2,決算収支の状況,1,令和4年度,47625138,45936883,1688255,385162,1303093,-524200,406,0,0,-523794
2022,61,222101,静岡県,富士市,9,2,決算収支の状況,1,令和4年度,100744054,96023003,4721051,248975,4472076,341185,2586767,63600,326337,2665215
2022,61,222119,静岡県,磐田市,3,2,決算収支の状況,1,令和4年度,70391681,66149706,4241975,817200,3424775,676431,13617,0,1301871,-611823
2022,61,222127,静岡県,焼津市,3,2,決算収支の状況,1,令和4年度,63865857,60378568,3487289,461653,3025636,114808,11279,0,0,126087
2022,61,222135,静岡県,掛川市,3,2,決算収支の状況,1,令和4年度,53101622,50966062,2135560,187606,1947954,-264043,27250,0,0,-236793
2022,61,222143,静岡県,藤枝市,3,2,決算収支の状況,1,令和4年度,58657677,55808756,2848921,238794,2610127,-1090614,28327,5096,0,-1057191
2022,61,222151,静岡県,御殿場市,4,2,決算収支の状況,1,令和4年度,44222544,40846034,3376510,448388,2928122,759833,2427699,0,1704164,1483368
2022,61,222160,静岡県,袋井市,4,2,決算収支の状況,1,令和4年度,39860038,37837204,2022834,494985,1527849,62116,7377,14530,0,84023
2022,61,222194,静岡県,下田市,4,2,決算収支の状況,1,令和4年度,13152290,12146312,1005978,50938,955040,52315,450007,0,360000,142322
2022,61,222208,静岡県,裾野市,4,2,決算収支の状況,1,令和4年度,24154334,22409329,1745005,569877,1175128,393512,150592,0,0,544104
2022,61,222216,静岡県,湖西市,4,2,決算収支の状況,1,令和4年度,28025828,25718967,2306861,344347,1962514,299345,66,0,1150138,-850727
2022,61,222224,静岡県,伊豆市,4,2,決算収支の状況,1,令和4年度,24195802,22539974,1655828,128175,1527653,57748,748846,0,0,806594
2022,61,222232,静岡県,御前崎市,4,2,決算収支の状況,1,令和4年度,16469443,15856549,612894,30638,582256,102215,214612,0,696737,-379910
2022,61,222241,静岡県,菊川市,4,2,決算収支の状況,1,令和4年度,21699270,20973984,725286,98579,626707,-46765,30,0,274598,-321333
2022,61,222259,静岡県,伊豆の国市,4,2,決算収支の状況,1,令和4年度,23949249,22970981,978268,77351,900917,-203769,556702,0,401920,-48987
2022,61,222267,静岡県,牧之原市,4,2,決算収支の状況,1,令和4年度,22940877,21795523,1145354,172474,972880,-124040,867768,0,0,743728
2022,61,223018,静岡県,東伊豆町,5,2,決算収支の状況,1,令和4年度,6566959,6111259,455700,34726,420974,-30396,269600,0,0,239204
2022,61,223026,静岡県,河津町,5,2,決算収支の状況,1,令和4年度,5054705,4779357,275348,89932,185416,-68126,158377,0,0,90251
2022,61,223042,静岡県,南伊豆町,5,2,決算収支の状況,1,令和4年度,5701480,5407966,293514,16119,277395,1954,103225,3761,0,108940
2022,61,223051,静岡県,松崎町,5,2,決算収支の状況,1,令和4年度,4298564,4015294,283270,147874,135396,33504,70000,0,160000,-56496
2022,61,223069,静岡県,西伊豆町,5,2,決算収支の状況,1,令和4年度,9863235,9225373,637862,208120,429742,117583,136843,0,300000,-45574
2022,61,223255,静岡県,函南町,5,2,決算収支の状況,1,令和4年度,14064593,13351515,713078,14806,698272,29732,634544,0,539680,124596
2022,61,223417,静岡県,清水町,5,2,決算収支の状況,1,令和4年度,12138151,11574329,563822,32496,531326,-336106,553362,0,0,217256
2022,61,223425,静岡県,長泉町,5,2,決算収支の状況,1,令和4年度,17154002,16550405,603597,51021,552576,70458,202846,0,200000,73304
2022,61,223441,静岡県,小山町,5,2,決算収支の状況,1,令和4年度,13965125,13336015,629110,263108,366002,-168079,510010,0,488449,-146518
2022,61,224243,静岡県,吉田町,5,2,決算収支の状況,1,令和4年度,14018980,12933277,1085703,58848,1026855,-168046,966077,0,626103,171928
2022,61,224294,静岡県,川根本町,5,2,決算収支の状況,1,令和4年度,6765653,5821362,944291,153648,790643,71136,1653,0,0,72789
2022,61,224618,静岡県,森町,5,2,決算収支の状況,1,令和4年度,10727685,9930548,797137,91805,705332,-477911,12524,0,0,-465387
2022,61,228052,静岡県,浜名湖競艇企業団,7,2,決算収支の状況,1,令和4年度,0,0,0,0,0,0,0,0,0,0
2022,61,228087,静岡県,牧之原市菊川市学校組合,6,2,決算収支の状況,1,令和4年度,294377,245832,48545,0,48545,20523,0,0,0,20523
2022,61,228125,静岡県,小笠老人ホーム施設組合,6,2,決算収支の状況,1,令和4年度,143082,128336,14746,0,14746,-3261,0,0,0,-3261
2022,61,228168,静岡県,東遠広域施設組合,6,2,決算収支の状況,1,令和4年度,428083,374803,53280,0,53280,359,0,0,0,359
2022,61,228176,静岡県,静岡県市町総合事務組合,6,2,決算収支の状況,1,令和4年度,4657075,4588126,68949,0,68949,-196565,0,0,0,-196565
2022,61,228192,静岡県,三島函南広域行政組合,6,2,決算収支の状況,1,令和4年度,345657,323859,21798,0,21798,-3927,0,0,0,-3927
2022,61,228206,静岡県,牧之原市御前崎市広域施設組合,6,2,決算収支の状況,1,令和4年度,1247653,1089154,158499,0,158499,62106,0,0,0,62106
2022,61,228249,静岡県,御殿場市・小山町広域行政組合,6,2,決算収支の状況,1,令和4年度,3473359,3335130,138229,3189,135040,36544,0,0,0,36544
2022,61,228257,静岡県,東河環境センター,6,2,決算収支の状況,1,令和4年度,806271,619843,186428,122562,63866,14219,31648,0,0,45867
2022,61,228281,静岡県,南豆衛生プラント組合,6,2,決算収支の状況,1,令和4年度,120088,116410,3678,0,3678,-582,0,0,0,-582
2022,61,228419,静岡県,太田川原野谷川治水水防組合,6,2,決算収支の状況,1,令和4年度,6129,5553,576,0,576,147,0,0,0,147
2022,61,228427,静岡県,箱根山御山組合,7,2,決算収支の状況,1,令和4年度,0,0,0,0,0,0,0,0,0,0
2022,61,228435,静岡県,三島市外五ヶ市町箱根山組合,6,2,決算収支の状況,1,令和4年度,0,0,0,0,0,0,0,0,0,0
2022,61,228478,静岡県,西豆衛生プラント組合,6,2,決算収支の状況,1,令和4年度,215200,181185,34015,0,34015,26405,0,0,0,26405
2022,61,228516,静岡県,三島市外三ヶ市町箱根山林組合,6,2,決算収支の状況,1,令和4年度,0,0,0,0,0,0,0,0,0,0
2022,61,228532,静岡県,裾野市長泉町衛生施設組合,6,2,決算収支の状況,1,令和4年度,344021,312076,31945,0,31945,-14807,0,0,0,-14807
2022,61,228541,静岡県,箱根山禁伐林組合,7,2,決算収支の状況,1,令和4年度,0,0,0,0,0,0,0,0,0,0
2022,61,228591,静岡県,静岡県芦湖水利組合,6,2,決算収支の状況,1,令和4年度,9538,3619,5919,0,5919,-967,0,0,0,-967
2022,61,228613,静岡県,伊豆市沼津市衛生施設組合,6,2,決算収支の状況,1,令和4年度,111895,90080,21815,0,21815,-11591,1,0,0,-11590
2022,61,228621,静岡県,箱根山殖産林組合,7,2,決算収支の状況,1,令和4年度,0,0,0,0,0,0,0,0,0,0
2022,61,228893,静岡県,駿東地区交通災害共済組合,7,2,決算収支の状況,1,令和4年度,0,0,0,0,0,0,0,0,0,0
2022,61,228923,静岡県,岳南排水路管理組合,6,2,決算収支の状況,1,令和4年度,585197,539212,45985,0,45985,-8127,0,0,0,-8127
2022,61,228958,静岡県,駿遠学園管理組合,6,2,決算収支の状況,1,令和4年度,289765,254515,35250,0,35250,11451,0,0,0,11451
2022,61,228991,静岡県,御前崎市牧之原市学校組合,6,2,決算収支の状況,1,令和4年度,130622,121000,9622,0,9622,-2418,0,0,0,-2418
2022,61,229024,静岡県,東遠学園組合,6,2,決算収支の状況,1,令和4年度,853751,826811,26940,0,26940,-46749,0,0,0,-46749
2022,61,229041,静岡県,浜名学園組合,6,2,決算収支の状況,1,令和4年度,438778,395142,43636,0,43636,1361,18612,0,18612,1361
2022,61,229075,静岡県,駿豆学園管理組合,6,2,決算収支の状況,1,令和4年度,311564,270672,40892,16390,24502,-6384,0,0,0,-6384
2022,61,229091,静岡県,袋井市森町広域行政組合,6,2,決算収支の状況,1,令和4年度,3236156,3188301,47855,0,47855,8858,26430,0,4000,31288
2022,61,229113,静岡県,駿東伊豆消防組合,6,2,決算収支の状況,1,令和4年度,6627407,6505255,122152,8538,113614,47954,35201,0,99233,-16078
2022,61,229202,静岡県,中遠広域事務組合,6,2,決算収支の状況,1,令和4年度,758831,701826,57005,0,57005,-16202,2,0,26905,-43105
2022,61,229211,静岡県,志太広域事務組合,6,2,決算収支の状況,1,令和4年度,5940037,5672509,267528,411,267117,-174429,0,0,0,-174429
2022,61,229326,静岡県,東遠地区聖苑組合,6,2,決算収支の状況,1,令和4年度,217099,213454,3645,0,3645,-407,0,0,0,-407
2022,61,229351,静岡県,伊豆斎場組合,6,2,決算収支の状況,1,令和4年度,87971,67384,20587,0,20587,3583,0,0,0,3583
2022,61,229377,静岡県,吉田町牧之原市広域施設組合,6,2,決算収支の状況,1,令和4年度,2065910,1991437,74473,0,74473,23285,0,0,0,23285
2022,61,229393,静岡県,下田地区消防組合,6,2,決算収支の状況,1,令和4年度,1323282,1294694,28588,0,28588,-9048,0,0,0,-9048
2022,61,229466,静岡県,中東遠看護専門学校組合,6,2,決算収支の状況,1,令和4年度,406013,389038,16975,0,16975,-10731,14790,0,0,4059
2022,61,229504,静岡県,一部事務組合下田メディカルセンター（普通会計分）,6,2,決算収支の状況,1,令和4年度,35380,35008,372,0,372,8,0,0,0,8
2022,61,229539,静岡県,榛原総合病院組合（普通会計分）,6,2,決算収支の状況,1,令和4年度,112338,102720,9618,0,9618,-8449,0,0,0,-8449
2022,61,229547,静岡県,掛川市・菊川市衛生施設組合,6,2,決算収支の状況,1,令和4年度,2081309,1751089,330220,0,330220,243109,0,0,0,243109
2022,61,229563,静岡県,静岡県後期高齢者医療広域連合,7,2,決算収支の状況,1,令和4年度,129180,122959,6221,0,6221,-2882,0,0,0,-2882
2022,61,229571,静岡県,静岡地方税滞納整理機構,6,2,決算収支の状況,1,令和4年度,301347,290435,10912,0,10912,-4512,8716,0,6598,-2394
2022,61,229598,静岡県,伊豆市伊豆の国市廃棄物処理施設組合,6,2,決算収支の状況,1,令和4年度,4234769,4210841,23928,0,23928,15756,0,0,0,15756
2022,61,229601,静岡県,富士山南東消防組合,6,2,決算収支の状況,1,令和4年度,3124249,3077216,47033,4436,42597,-22853,0,0,0,-22853
2022,61,231002,愛知県,名古屋市,1,2,決算収支の状況,1,令和4年度,1435285544,1419455934,15829610,7627367,8202243,-2042546,12258815,1107238,0,11323507
2022,61,232017,愛知県,豊橋市,8,2,決算収支の状況,1,令和4年度,143690763,138054233,5636530,1481051,4155479,-1078004,15152,0,1159497,-2222349
2022,61,232025,愛知県,岡崎市,8,2,決算収支の状況,1,令和4年度,152576812,143135806,9441006,2145069,7295937,281505,4949729,0,9815252,-4584018
2022,61,232033,愛知県,一宮市,8,2,決算収支の状況,1,令和4年度,145599914,139126187,6473727,507862,5965865,-952689,4304621,0,3200000,151932
2022,61,232041,愛知県,瀬戸市,3,2,決算収支の状況,1,令和4年度,46941841,44344699,2597142,579860,2017282,-273002,422769,0,398732,-248965
2022,61,232050,愛知県,半田市,3,2,決算収支の状況,1,令和4年度,49856753,47202119,2654634,640003,2014631,-639242,1764499,0,616189,509068
2022,61,232068,愛知県,春日井市,9,2,決算収支の状況,1,令和4年度,119422549,118925365,497184,428640,68544,-931686,511000,0,550000,-970686
2022,61,232076,愛知県,豊川市,3,2,決算収支の状況,1,令和4年度,79999533,75619605,4379928,415579,3964349,198423,1905708,0,708375,1395756
2022,61,232084,愛知県,津島市,4,2,決算収支の状況,1,令和4年度,25872868,24182354,1690514,179310,1511204,503845,535026,0,0,1038871
2022,61,232092,愛知県,碧南市,4,2,決算収支の状況,1,令和4年度,37219711,34018310,3201401,112213,3089188,230237,477286,0,0,707523
2022,61,232106,愛知県,刈谷市,3,2,決算収支の状況,1,令和4年度,69293393,62607011,6686382,1914211,4772171,-280919,459508,0,8595,169994
2022,61,232114,愛知県,豊田市,8,2,決算収支の状況,1,令和4年度,216652764,199882435,16770329,10705353,6064976,-2859771,4500000,33000,1700000,-26771
2022,61,232122,愛知県,安城市,3,2,決算収支の状況,1,令和4年度,77077128,72155007,4922121,819581,4102540,-401812,324340,0,0,-77472
2022,61,232131,愛知県,西尾市,3,2,決算収支の状況,1,令和4年度,67334621,64095376,3239245,296522,2942723,-898604,3004,0,0,-895600
2022,61,232149,愛知県,蒲郡市,4,2,決算収支の状況,1,令和4年度,40895500,38971797,1923703,378961,1544742,-1635321,651668,0,0,-983653
2022,61,232157,愛知県,犬山市,4,2,決算収支の状況,1,令和4年度,30146439,28468991,1677448,432463,1244985,80198,1435912,0,1349342,166768
2022,61,232165,愛知県,常滑市,4,2,決算収支の状況,1,令和4年度,28446004,27216226,1229778,93218,1136560,-440770,1100286,0,1000000,-340484
2022,61,232173,愛知県,江南市,4,2,決算収支の状況,1,令和4年度,37740769,36201965,1538804,352813,1185991,-615123,901582,0,175506,110953
2022,61,232190,愛知県,小牧市,3,2,決算収支の状況,1,令和4年度,63817183,60909833,2907350,539156,2368194,763802,8248,0,400000,372050
2022,61,232203,愛知県,稲沢市,3,2,決算収支の状況,1,令和4年度,55137938,51315890,3822048,544560,3277488,-781056,301169,0,0,-479887
2022,61,232211,愛知県,新城市,4,2,決算収支の状況,1,令和4年度,26291373,24671617,1619756,124057,1495699,170132,337851,0,197814,310169
2022,61,232220,愛知県,東海市,3,2,決算収支の状況,1,令和4年度,58209302,54020252,4189050,651011,3538039,-806907,5921,0,1153233,-1954219
2022,61,232238,愛知県,大府市,4,2,決算収支の状況,1,令和4年度,39068634,37065662,2002972,384109,1618863,-291238,10259,0,22138,-303117
2022,61,232246,愛知県,知多市,4,2,決算収支の状況,1,令和4年度,32390267,30791481,1598786,57635,1541151,-410508,1413,0,168384,-577479
2022,61,232254,愛知県,知立市,4,2,決算収支の状況,1,令和4年度,26011070,24507757,1503313,87007,1416306,-107117,257319,0,0,150202
2022,61,232262,愛知県,尾張旭市,4,2,決算収支の状況,1,令和4年度,30757054,28949520,1807534,613444,1194090,16526,589850,410850,160000,857226
2022,61,232271,愛知県,高浜市,4,2,決算収支の状況,1,令和4年度,18279002,17356300,922702,209139,713563,-216817,1273,0,165286,-380830
2022,61,232289,愛知県,岩倉市,4,2,決算収支の状況,1,令和4年度,18710062,17704846,1005216,126287,878929,-236279,251476,0,0,15197
2022,61,232297,愛知県,豊明市,4,2,決算収支の状況,1,令和4年度,27819145,26640535,1178610,29068,1149542,-601093,946968,0,1279225,-933350
2022,61,232301,愛知県,日進市,4,2,決算収支の状況,1,令和4年度,32911929,30683923,2228006,603863,1624143,-175035,29162,0,0,-145873
2022,61,232319,愛知県,田原市,4,2,決算収支の状況,1,令和4年度,32014400,30681438,1332962,775222,557740,-323206,3701,0,0,-319505
2022,61,232327,愛知県,愛西市,4,2,決算収支の状況,1,令和4年度,25920688,24780063,1140625,72857,1067768,17466,558438,0,549982,25922
2022,61,232335,愛知県,清須市,4,2,決算収支の状況,1,令和4年度,32109392,30635591,1473801,183267,1290534,-201438,1650,0,22405,-222193
2022,61,232343,愛知県,北名古屋市,4,2,決算収支の状況,1,令和4年度,31733815,30336441,1397374,214974,1182400,-759555,499,0,433167,-1192223
2022,61,232351,愛知県,弥富市,4,2,決算収支の状況,1,令和4年度,18461820,17526275,935545,0,935545,148828,258755,0,0,407583
2022,61,232360,愛知県,みよし市,4,2,決算収支の状況,1,令和4年度,31498484,28894956,2603528,359957,2243571,-120655,1734865,0,872949,741261
2022,61,232378,愛知県,あま市,4,2,決算収支の状況,1,令和4年度,40854199,39018029,1836170,12736,1823434,332132,2589116,0,974203,1947045
2022,61,232386,愛知県,長久手市,4,2,決算収支の状況,1,令和4年度,24767127,23867737,899390,45352,854038,-301186,576609,0,406282,-130859
2022,61,233021,愛知県,東郷町,5,2,決算収支の状況,1,令和4年度,15136425,14302949,833476,46468,787008,-178739,394,0,106952,-285297
2022,61,233421,愛知県,豊山町,5,2,決算収支の状況,1,令和4年度,8163444,7856891,306553,44066,262487,-167599,416769,0,325768,-76598
2022,61,233617,愛知県,大口町,5,2,決算収支の状況,1,令和4年度,11182694,10578528,604166,342553,261613,78076,270064,0,0,348140
2022,61,233625,愛知県,扶桑町,5,2,決算収支の状況,1,令和4年度,12600987,12206809,394178,14068,380110,-45943,212058,0,389755,-223640
2022,61,234249,愛知県,大治町,5,2,決算収支の状況,1,令和4年度,11057749,10715977,341772,11307,330465,-262813,572707,0,200000,109894
2022,61,234257,愛知県,蟹江町,5,2,決算収支の状況,1,令和4年度,13345589,12853092,492497,0,492497,-137903,435536,0,400000,-102367
2022,61,234273,愛知県,飛島村,5,2,決算収支の状況,1,令和4年度,6828414,6433317,395097,15600,379497,9735,187675,0,187675,9735
2022,61,234419,愛知県,阿久比町,5,2,決算収支の状況,1,令和4年度,12723639,12214397,509242,3695,505547,-15953,261248,0,213000,32295
2022,61,234427,愛知県,東浦町,5,2,決算収支の状況,1,令和4年度,18853433,18112058,741375,183794,557581,-564378,2259,0,233000,-795119
2022,61,234451,愛知県,南知多町,5,2,決算収支の状況,1,令和4年度,8550978,8139202,411776,27026,384750,75875,163388,0,0,239263
2022,61,234460,愛知県,美浜町,5,2,決算収支の状況,1,令和4年度,9870118,9490717,379401,13918,365483,-6929,77062,0,0,70133
2022,61,234478,愛知県,武豊町,5,2,決算収支の状況,1,令和4年度,14776787,14219024,557763,123155,434608,-641799,486,0,100000,-741313
2022,61,235016,愛知県,幸田町,5,2,決算収支の状況,1,令和4年度,20457648,18953519,1504129,94516,1409613,176553,1179,0,0,177732
2022,61,235610,愛知県,設楽町,5,2,決算収支の状況,1,令和4年度,6450240,6297775,152465,87465,65000,-55519,716,0,423562,-478365
2022,61,235628,愛知県,東栄町,5,2,決算収支の状況,1,令和4年度,4217971,3923075,294896,101303,193593,-35426,429,0,115859,-150856
2022,61,235636,愛知県,豊根村,5,2,決算収支の状況,1,令和4年度,2575298,2462920,112378,2404,109974,3498,986,0,0,4484
2022,61,238015,愛知県,名古屋港管理組合,6,2,決算収支の状況,1,令和4年度,32463852,29196403,3267449,1844972,1422477,282281,0,0,0,282281
2022,61,238023,愛知県,愛知県競馬組合,7,2,決算収支の状況,1,令和4年度,0,0,0,0,0,0,0,0,0,0
2022,61,238031,愛知県,名古屋競輪組合,7,2,決算収支の状況,1,令和4年度,0,0,0,0,0,0,0,0,0,0
2022,61,238121,愛知県,岡崎市額田郡模範造林組合,6,2,決算収支の状況,1,令和4年度,12525,11849,676,0,676,-1521,0,0,0,-1521
2022,61,238171,愛知県,海部南部広域事務組合（普通会計分）,6,2,決算収支の状況,1,令和4年度,93589,84085,9504,0,9504,-15784,0,0,0,-15784
2022,61,238295,愛知県,知多中部広域事務組合（普通会計分）,6,2,決算収支の状況,1,令和4年度,2800498,2759845,40653,8725,31928,-9554,0,0,0,-9554
2022,61,238309,愛知県,愛知県市町村職員退職手当組合,6,2,決算収支の状況,1,令和4年度,7253769,6916792,336977,0,336977,-327331,1780000,0,0,1452669
2022,61,238333,愛知県,愛北広域事務組合,6,2,決算収支の状況,1,令和4年度,551354,519357,31997,0,31997,3573,0,0,0,3573
2022,61,238350,愛知県,中部知多衛生組合,6,2,決算収支の状況,1,令和4年度,816625,809342,7283,0,7283,-8616,0,0,0,-8616
2022,61,238376,愛知県,東部知多衛生組合,6,2,決算収支の状況,1,令和4年度,2701305,2619521,81784,0,81784,-6231,0,0,0,-6231
2022,61,238384,愛知県,衣浦衛生組合,6,2,決算収支の状況,1,令和4年度,2377413,2280286,97127,0,97127,1407,0,0,0,1407
2022,61,238414,愛知県,常滑武豊衛生組合,6,2,決算収支の状況,1,令和4年度,155820,139620,16200,13861,2339,-21442,0,0,0,-21442
2022,61,238422,愛知県,蒲郡市幸田町衛生組合,6,2,決算収支の状況,1,令和4年度,311917,298122,13795,0,13795,-28153,0,0,0,-28153
2022,61,238465,愛知県,西知多医療厚生組合,6,2,決算収支の状況,1,令和4年度,6516561,6257659,258902,0,258902,56187,0,0,0,56187
2022,61,238481,愛知県,尾張東部衛生組合,6,2,決算収支の状況,1,令和4年度,1715886,1650569,65317,0,65317,-75415,0,0,0,-75415
2022,61,238490,愛知県,海部地区環境事務組合,6,2,決算収支の状況,1,令和4年度,2752004,2615172,136832,107976,28856,-26510,27767,0,156822,-155565
2022,61,238511,愛知県,小牧岩倉衛生組合,6,2,決算収支の状況,1,令和4年度,2498398,2398662,99736,19594,80142,162,0,0,0,162
2022,61,238538,愛知県,知多南部衛生組合,6,2,決算収支の状況,1,令和4年度,927521,899216,28305,0,28305,1250,0,0,0,1250
2022,61,238589,愛知県,刈谷知立環境組合,6,2,決算収支の状況,1,令和4年度,2241473,2125709,115764,0,115764,41511,0,0,0,41511
2022,61,238597,愛知県,江南丹羽環境管理組合,6,2,決算収支の状況,1,令和4年度,1105141,1059185,45956,0,45956,4529,0,0,0,4529
2022,61,238651,愛知県,新城北設楽交通災害共済組合,7,2,決算収支の状況,1,令和4年度,0,0,0,0,0,0,0,0,0,0
2022,61,238686,愛知県,半田常滑看護専門学校管理組合,6,2,決算収支の状況,1,令和4年度,169506,160949,8557,0,8557,1009,0,0,0,1009
2022,61,238694,愛知県,北設広域事務組合,6,2,決算収支の状況,1,令和4年度,624510,597840,26670,0,26670,966,25400,0,0,26366
2022,61,238708,愛知県,海部東部消防組合（普通会計分）,6,2,決算収支の状況,1,令和4年度,1630840,1596275,34565,0,34565,-18569,20536,0,47000,-45033
2022,61,238724,愛知県,尾三消防組合,6,2,決算収支の状況,1,令和4年度,4074716,3976645,98071,0,98071,23030,88195,0,88203,23022
2022,61,238741,愛知県,北名古屋衛生組合,6,2,決算収支の状況,1,令和4年度,1834441,1725520,108921,37416,71505,4374,26491,0,68799,-37934
2022,61,238791,愛知県,海部南部消防組合,6,2,決算収支の状況,1,令和4年度,1197247,1129619,67628,0,67628,-5821,28581,0,51769,-29009
2022,61,238805,愛知県,海部地区水防事務組合,6,2,決算収支の状況,1,令和4年度,38838,35848,2990,0,2990,811,0,0,2000,-1189
2022,61,238821,愛知県,瀬戸旭看護専門学校組合,6,2,決算収支の状況,1,令和4年度,305412,283559,21853,0,21853,4576,0,0,0,4576
2022,61,238848,愛知県,尾張東部火葬場管理組合,6,2,決算収支の状況,1,令和4年度,286550,264296,22254,0,22254,-19576,0,0,0,-19576
2022,61,238872,愛知県,尾三衛生組合,6,2,決算収支の状況,1,令和4年度,1532718,1445907,86811,0,86811,-13021,99940,0,169455,-82536
2022,61,238970,愛知県,知多南部消防組合,6,2,決算収支の状況,1,令和4年度,777359,769433,7926,0,7926,582,3674,0,0,4256
2022,61,238988,愛知県,知北平和公園組合,6,2,決算収支の状況,1,令和4年度,373631,362966,10665,0,10665,4557,0,0,0,4557
2022,61,238996,愛知県,五条広域事務組合,6,2,決算収支の状況,1,令和4年度,665136,616892,48244,0,48244,11537,1887,0,0,13424
2022,61,239046,愛知県,海部地区急病診療所組合,6,2,決算収支の状況,1,令和4年度,170893,86659,84234,0,84234,51023,1,0,0,51024
2022,61,239054,愛知県,春日井小牧看護専門学校管理組合,6,2,決算収支の状況,1,令和4年度,282881,261569,21312,0,21312,3272,0,0,0,3272
2022,61,239178,愛知県,知多北部広域連合,6,2,決算収支の状況,1,令和4年度,4021545,4008413,13132,0,13132,-8812,10439,0,13876,-12249
2022,61,239267,愛知県,丹羽広域事務組合（普通会計分）,6,2,決算収支の状況,1,令和4年度,899124,873256,25868,0,25868,-4823,0,0,0,-4823
2022,61,239283,愛知県,衣浦東部広域連合,6,2,決算収支の状況,1,令和4年度,5872438,5521782,350656,104007,246649,53976,0,0,0,53976
2022,61,239291,愛知県,西春日井広域事務組合,6,2,決算収支の状況,1,令和4年度,1966477,1839902,126575,71046,55529,-47643,4,0,1000,-48639
2022,61,239305,愛知県,愛知県後期高齢者医療広域連合,7,2,決算収支の状況,1,令和4年度,2068175,1957390,110785,0,110785,-31596,1800006,0,0,1768410
2022,61,239321,愛知県,知多南部広域環境組合,6,2,決算収支の状況,1,令和4年度,1331843,1215465,116378,0,116378,74475,0,0,0,74475
2022,61,239330,愛知県,東三河広域連合,6,2,決算収支の状況,1,令和4年度,9178702,8930829,247873,0,247873,24839,0,0,0,24839
2022,61,239348,愛知県,尾張北部環境組合,6,2,決算収支の状況,1,令和4年度,90655,86386,4269,0,4269,-4531,0,0,0,-4531
2022,61,242012,三重県,津市,3,2,決算収支の状況,1,令和4年度,117913132,116866178,1046954,255481,791473,-2031199,1440397,0,0,-590802
2022,61,242021,三重県,四日市市,9,2,決算収支の状況,1,令和4年度,146111719,139137789,6973930,2724252,4249678,-4223885,4246924,0,3901157,-3878118
2022,61,242039,三重県,伊勢市,3,2,決算収支の状況,1,令和4年度,58853640,58405884,447756,144158,303598,-213188,19223,0,250000,-443965
2022,61,242047,三重県,松阪市,3,2,決算収支の状況,1,令和4年度,78044330,74372242,3672088,208429,3463659,1431242,1015639,0,678015,1768866
2022,61,242055,三重県,桑名市,3,2,決算収支の状況,1,令和4年度,63534065,59695754,3838311,398449,3439862,369360,2454511,0,1003759,1820112
2022,61,242071,三重県,鈴鹿市,3,2,決算収支の状況,1,令和4年度,73565101,72262247,1302854,355011,947843,-2090942,240,0,0,-2090702
2022,61,242080,三重県,名張市,4,2,決算収支の状況,1,令和4年度,32416694,31848330,568364,28958,539406,-726162,633052,0,0,-93110
2022,61,242098,三重県,尾鷲市,4,2,決算収支の状況,1,令和4年度,12117321,11794996,322325,10361,311964,-27159,687411,0,235302,424950
2022,61,242101,三重県,亀山市,4,2,決算収支の状況,1,令和4年度,24776434,23991060,785374,91112,694262,-400742,2444,0,790574,-1188872
2022,61,242110,三重県,鳥羽市,4,2,決算収支の状況,1,令和4年度,13593629,12965604,628025,7295,620730,-249298,219388,0,0,-29910
2022,61,242128,三重県,熊野市,4,2,決算収支の状況,1,令和4年度,14589885,13582514,1007371,112383,894988,50917,6177,0,0,57094
2022,61,242144,三重県,いなべ市,4,2,決算収支の状況,1,令和4年度,25731593,23946798,1784795,188897,1595898,-139769,869546,0,734332,-4555
2022,61,242152,三重県,志摩市,4,2,決算収支の状況,1,令和4年度,28742374,27690584,1051790,77180,974610,31284,521430,0,681052,-128338
2022,61,242161,三重県,伊賀市,4,2,決算収支の状況,1,令和4年度,47539812,45445713,2094099,279843,1814256,48129,908455,0,0,956584
2022,61,243035,三重県,木曽岬町,5,2,決算収支の状況,1,令和4年度,3714391,3525023,189368,6330,183038,-89111,138977,0,0,49866
2022,61,243248,三重県,東員町,5,2,決算収支の状況,1,令和4年度,11606934,10668304,938630,7883,930747,-556320,203573,0,0,-352747
2022,61,243418,三重県,菰野町,5,2,決算収支の状況,1,令和4年度,14560796,14105516,455280,38497,416783,-452737,2317,0,370000,-820420
2022,61,243434,三重県,朝日町,5,2,決算収支の状況,1,令和4年度,5016728,4884115,132613,8659,123954,-88044,188983,0,320658,-219719
2022,61,243442,三重県,川越町,5,2,決算収支の状況,1,令和4年度,8279821,7969311,310510,1809,308701,-114895,28524,0,405563,-491934
2022,61,244414,三重県,多気町,5,2,決算収支の状況,1,令和4年度,9605401,9192317,413084,116663,296421,-72396,184255,0,132877,-21018
2022,61,244422,三重県,明和町,5,2,決算収支の状況,1,令和4年度,13166385,12467687,698698,41583,657115,-549682,688400,0,0,138718
2022,61,244431,三重県,大台町,5,2,決算収支の状況,1,令和4年度,8437867,8180510,257357,50400,206957,-47955,129894,0,316220,-234281
2022,61,244619,三重県,玉城町,5,2,決算収支の状況,1,令和4年度,7635992,7288845,347147,117194,229953,-41259,90782,0,150000,-100477
2022,61,244708,三重県,度会町,5,2,決算収支の状況,1,令和4年度,4615409,4443700,171709,13554,158155,-13548,149102,0,0,135554
2022,61,244716,三重県,大紀町,5,2,決算収支の状況,1,令和4年度,8137352,7832006,305346,9493,295853,-69834,100756,1121903,1144000,8825
2022,61,244724,三重県,南伊勢町,5,2,決算収支の状況,1,令和4年度,10799521,10426746,372775,66318,306457,-103017,301,0,0,-102716
2022,61,245437,三重県,紀北町,5,2,決算収支の状況,1,令和4年度,11218136,10570757,647379,33111,614268,42934,285700,0,432687,-104053
2022,61,245615,三重県,御浜町,5,2,決算収支の状況,1,令和4年度,5588960,5231560,357400,92705,264695,-158246,761,0,50000,-207485
2022,61,245623,三重県,紀宝町,5,2,決算収支の状況,1,令和4年度,7240662,6874205,366457,24624,341833,-279976,340,0,0,-279636
2022,61,248011,三重県,四日市港管理組合,6,2,決算収支の状況,1,令和4年度,6433618,6324857,108761,72519,36242,2183,1,0,34060,-31876
2022,61,248274,三重県,三重県多気郡多気町松阪市学校組合,6,2,決算収支の状況,1,令和4年度,127213,121001,6212,0,6212,3245,0,0,0,3245
2022,61,248347,三重県,わたらい老人福祉施設組合,6,2,決算収支の状況,1,令和4年度,140198,138765,1433,0,1433,-331,200,0,4100,-4231
2022,61,248355,三重県,宮川福祉施設組合,6,2,決算収支の状況,1,令和4年度,69722,28958,40764,0,40764,35562,0,0,36585,-1023
2022,61,248371,三重県,紀南社会福祉施設組合,6,2,決算収支の状況,1,令和4年度,167045,158097,8948,0,8948,2944,2133,0,0,5077
2022,61,248398,三重県,三重県三重郡老人福祉施設組合,6,2,決算収支の状況,1,令和4年度,308542,285858,22684,6000,16684,3253,0,0,0,3253
2022,61,248533,三重県,朝日町、川越町組合立環境クリーンセンター,6,2,決算収支の状況,1,令和4年度,263570,241687,21883,0,21883,5315,8358,0,20000,-6327
2022,61,248592,三重県,奥伊勢広域行政組合,6,2,決算収支の状況,1,令和4年度,149607,131512,18095,0,18095,-2159,0,0,0,-2159
2022,61,248622,三重県,朝明広域衛生組合,6,2,決算収支の状況,1,令和4年度,365964,359096,6868,0,6868,318,0,0,0,318
2022,61,248631,三重県,松阪地区広域衛生組合,6,2,決算収支の状況,1,令和4年度,511271,483092,28179,0,28179,12466,0,0,0,12466
2022,61,248754,三重県,伊賀南部環境衛生組合,6,2,決算収支の状況,1,令和4年度,1992588,1906307,86281,0,86281,-28195,0,0,0,-28195
2022,61,248771,三重県,三重紀北消防組合,6,2,決算収支の状況,1,令和4年度,1020131,1010549,9582,0,9582,278,0,0,0,278
2022,61,248789,三重県,南牟婁清掃施設組合,6,2,決算収支の状況,1,令和4年度,296652,237814,58838,0,58838,3154,0,0,0,3154
2022,61,248835,三重県,松阪地区広域消防組合,6,2,決算収支の状況,1,令和4年度,2778071,2717897,60174,0,60174,29067,0,0,0,29067
2022,61,248959,三重県,桑名広域清掃事業組合,6,2,決算収支の状況,1,令和4年度,2489767,2435021,54746,0,54746,5370,1086883,0,0,1092253
2022,61,248967,三重県,志摩広域行政組合,6,2,決算収支の状況,1,令和4年度,236685,226410,10275,0,10275,623,11845,0,7800,4668
2022,61,249106,三重県,三重県市町総合事務組合,6,2,決算収支の状況,1,令和4年度,7700598,7087083,613515,0,613515,-411315,2190000,0,0,1778685
2022,61,249149,三重県,紀勢地区広域消防組合,6,2,決算収支の状況,1,令和4年度,884489,868364,16125,0,16125,-3989,97,0,81515,-85407
2022,61,249173,三重県,荷坂やすらぎ苑組合,6,2,決算収支の状況,1,令和4年度,31529,31008,521,0,521,-1172,0,0,0,-1172
2022,61,249181,三重県,香肌奥伊勢資源化広域連合,6,2,決算収支の状況,1,令和4年度,712848,692070,20778,2508,18270,-5714,0,0,0,-5714
2022,61,249203,三重県,鳥羽志勢広域連合,6,2,決算収支の状況,1,令和4年度,2129958,2022724,107234,0,107234,13850,100388,0,93384,20854
2022,61,249211,三重県,紀北広域連合,6,2,決算収支の状況,1,令和4年度,410857,400985,9872,80,9792,-6792,0,0,0,-6792
2022,61,249220,三重県,紀南介護保険広域連合,6,2,決算収支の状況,1,令和4年度,1097067,1088756,8311,0,8311,1032,1,0,0,1033
2022,61,249262,三重県,度会広域連合,6,2,決算収支の状況,1,令和4年度,112373,104877,7496,0,7496,-1461,8956,0,5277,2218
2022,61,249271,三重県,鈴鹿亀山地区広域連合,6,2,決算収支の状況,1,令和4年度,373239,373177,62,0,62,28,0,0,0,28
2022,61,249289,三重県,桑名・員弁広域連合,6,2,決算収支の状況,1,令和4年度,425068,422802,2266,0,2266,-555,0,0,0,-555
2022,61,249335,三重県,伊勢広域環境組合,6,2,決算収支の状況,1,令和4年度,2647010,2436481,210529,167184,43345,-14403,102,0,63470,-77771
2022,61,249343,三重県,三重地方税管理回収機構,6,2,決算収支の状況,1,令和4年度,272602,174269,98333,0,98333,4893,0,0,0,4893
2022,61,249351,三重県,三重県後期高齢者医療広域連合,7,2,決算収支の状況,1,令和4年度,82116,78637,3479,0,3479,366,1557,0,0,1923
2022,61,249360,三重県,東紀州環境施設組合,6,2,決算収支の状況,1,令和4年度,149412,141677,7735,0,7735,-38101,0,0,0,-38101
2022,61,252018,滋賀県,大津市,8,2,決算収支の状況,1,令和4年度,144160662,139577615,4583047,886255,3696792,-940185,1816273,502514,0,1378602
2022,61,252026,滋賀県,彦根市,3,2,決算収支の状況,1,令和4年度,55179232,52658201,2521031,169944,2351087,98746,1200054,0,755907,542893
2022,61,252034,滋賀県,長浜市,3,2,決算収支の状況,1,令和4年度,59368658,57051770,2316888,464193,1852695,613883,18439,878101,440651,1069772
2022,61,252042,滋賀県,近江八幡市,4,2,決算収支の状況,1,令和4年度,46630599,45479767,1150832,342159,808673,-302355,556696,380060,300000,334401
2022,61,252069,滋賀県,草津市,3,2,決算収支の状況,1,令和4年度,55398973,54466414,932559,263959,668600,155388,857939,0,0,1013327
2022,61,252077,滋賀県,守山市,4,2,決算収支の状況,1,令和4年度,41547277,39963704,1583573,886459,697114,-125077,1002729,0,500000,377652
2022,61,252085,滋賀県,栗東市,4,2,決算収支の状況,1,令和4年度,28222618,27394005,828613,78298,750315,-105614,100142,0,0,-5472
2022,61,252093,滋賀県,甲賀市,4,2,決算収支の状況,1,令和4年度,46229457,43420932,2808525,386024,2422501,-52753,738345,0,471256,214336
2022,61,252107,滋賀県,野洲市,4,2,決算収支の状況,1,令和4年度,26458709,25333689,1125020,282347,842673,-108485,1117128,0,0,1008643
2022,61,252115,滋賀県,湖南市,4,2,決算収支の状況,1,令和4年度,23388235,22785995,602240,93477,508763,-360759,441249,41800,539355,-417065
2022,61,252123,滋賀県,高島市,4,2,決算収支の状況,1,令和4年度,32217131,31443638,773493,85588,687905,-73836,686287,0,1036712,-424261
2022,61,252131,滋賀県,東近江市,3,2,決算収支の状況,1,令和4年度,53629671,51949730,1679941,208795,1471146,-665201,1361129,0,0,695928
2022,61,252140,滋賀県,米原市,4,2,決算収支の状況,1,令和4年度,23725752,22818436,907316,134112,773204,-276785,9276,526358,0,258849
2022,61,253839,滋賀県,日野町,5,2,決算収支の状況,1,令和4年度,10718475,9792835,925640,103907,821733,107972,97,0,0,108069
2022,61,253847,滋賀県,竜王町,5,2,決算収支の状況,1,令和4年度,7367338,6758537,608801,397693,211108,-181402,27306,0,0,-154096
2022,61,254258,滋賀県,愛荘町,5,2,決算収支の状況,1,令和4年度,11639074,11038948,600126,150089,450037,-49180,560,0,95000,-143620
2022,61,254410,滋賀県,豊郷町,5,2,決算収支の状況,1,令和4年度,5514566,5095075,419491,140661,278830,104990,87370,0,48760,143600
2022,61,254428,滋賀県,甲良町,5,2,決算収支の状況,1,令和4年度,4184772,4005599,179173,33775,145398,14203,100004,8100,0,122307
2022,61,254436,滋賀県,多賀町,5,2,決算収支の状況,1,令和4年度,6220257,5510762,709495,377705,331790,91328,156270,0,406477,-158879
2022,61,258024,滋賀県,滋賀県市町村職員退職手当組合,6,2,決算収支の状況,1,令和4年度,3454021,3112401,341620,0,341620,49924,508087,0,55213,502798
2022,61,258130,滋賀県,彦根市犬上郡営林組合,6,2,決算収支の状況,1,令和4年度,21560,13677,7883,6354,1529,-596,13,0,4862,-5445
2022,61,258148,滋賀県,彦根市米原市山林組合,6,2,決算収支の状況,1,令和4年度,291,138,153,0,153,-17,7,0,100,-110
2022,61,258156,滋賀県,大滝山林組合,6,2,決算収支の状況,1,令和4年度,143573,125258,18315,0,18315,3153,0,0,9606,-6453
2022,61,258318,滋賀県,湖北広域行政事務センター,6,2,決算収支の状況,1,令和4年度,2829972,2692963,137009,0,137009,-106889,0,0,0,-106889
2022,61,258334,滋賀県,八日市布引ライフ組合,6,2,決算収支の状況,1,令和4年度,709233,587781,121452,103590,17862,-7385,10381,0,80970,-77974
2022,61,258351,滋賀県,滋賀県市町村議会議員公務災害補償等組合,6,2,決算収支の状況,1,令和4年度,32736,32289,447,0,447,-131,1,0,500,-630
2022,61,258415,滋賀県,中部清掃組合,6,2,決算収支の状況,1,令和4年度,1809684,1759780,49904,17600,32304,-34140,94,0,90530,-124576
2022,61,258458,滋賀県,東近江行政組合,6,2,決算収支の状況,1,令和4年度,3571730,3481697,90033,0,90033,42515,222,0,24964,17773
2022,61,258474,滋賀県,甲賀広域行政組合,6,2,決算収支の状況,1,令和4年度,4861631,4821633,39998,0,39998,-8660,0,0,0,-8660
2022,61,258580,滋賀県,湖東広域衛生管理組合,6,2,決算収支の状況,1,令和4年度,711793,695924,15869,0,15869,1961,11827,0,19670,-5882
2022,61,258598,滋賀県,愛知郡広域行政組合（普通会計分）,6,2,決算収支の状況,1,令和4年度,68210,35741,32469,19760,12709,-2513,87,0,19760,-22186
2022,61,258679,滋賀県,公立甲賀病院組合（普通会計分）,6,2,決算収支の状況,1,令和4年度,886672,883585,3087,0,3087,2256,0,0,0,2256
2022,61,258695,滋賀県,守山野洲行政事務組合,6,2,決算収支の状況,1,令和4年度,206194,182976,23218,0,23218,-10163,0,0,0,-10163
2022,61,258717,滋賀県,湖南広域行政組合,6,2,決算収支の状況,1,令和4年度,4657561,4595572,61989,0,61989,19631,20,0,0,19651
2022,61,258741,滋賀県,彦根愛知犬上広域行政組合,6,2,決算収支の状況,1,令和4年度,550874,534334,16540,898,15642,681,12976,0,0,13657
2022,61,258750,滋賀県,滋賀県市町村職員研修センター,6,2,決算収支の状況,1,令和4年度,78476,71673,6803,0,6803,2018,1,0,0,2019
2022,61,258768,滋賀県,湖北地域消防組合,6,2,決算収支の状況,1,令和4年度,3060237,2749801,310436,178138,132298,58551,2,0,0,58553
2022,61,258776,滋賀県,滋賀県後期高齢者医療広域連合,7,2,決算収支の状況,1,令和4年度,176287,163337,12950,0,12950,3503,0,0,0,3503
2022,61,258784,滋賀県,草津栗東行政事務組合,6,2,決算収支の状況,1,令和4年度,269046,269046,0,0,0,0,0,0,0,0
2022,61,261009,京都府,京都市,1,2,決算収支の状況,1,令和4年度,963093117,946554582,16538535,8831906,7706629,7318701,2074083,0,2500000,6892784
2022,61,262013,京都府,福知山市,4,2,決算収支の状況,1,令和4年度,47570655,45827537,1743118,606303,1136815,132708,4928,609990,420000,327626
2022,61,262021,京都府,舞鶴市,4,2,決算収支の状況,1,令和4年度,39240855,38189693,1051162,479060,572102,-906182,746550,1460,0,-158172
2022,61,262030,京都府,綾部市,4,2,決算収支の状況,1,令和4年度,19212706,19140660,72046,15722,56324,9868,145312,0,0,155180
2022,61,262048,京都府,宇治市,3,2,決算収支の状況,1,令和4年度,70955733,69606017,1349716,491390,858326,25520,302626,0,0,328146
2022,61,262056,京都府,宮津市,4,2,決算収支の状況,1,令和4年度,12233850,11940597,293253,6888,286365,-196782,138000,0,0,-58782
2022,61,262064,京都府,亀岡市,4,2,決算収支の状況,1,令和4年度,45719882,44320264,1399618,144818,1254800,-532069,920524,0,0,388455
2022,61,262072,京都府,城陽市,4,2,決算収支の状況,1,令和4年度,33478614,33074859,403755,328247,75508,737,37597,0,25000,13334
2022,61,262081,京都府,向日市,4,2,決算収支の状況,1,令和4年度,25031347,23146031,1885316,126706,1758610,97798,484,0,0,98282
2022,61,262099,京都府,長岡京市,4,2,決算収支の状況,1,令和4年度,40524004,38366118,2157886,337937,1819949,-216422,105502,0,0,-110920
2022,61,262102,京都府,八幡市,4,2,決算収支の状況,1,令和4年度,35669870,34882319,787551,77879,709672,-119866,115800,389460,416600,-31206
2022,61,262111,京都府,京田辺市,4,2,決算収支の状況,1,令和4年度,32865820,32121805,744015,239976,504039,-333268,418630,0,500000,-414638
2022,61,262129,京都府,京丹後市,4,2,決算収支の状況,1,令和4年度,39470191,38115585,1354606,176910,1177696,151265,600852,0,0,752117
2022,61,262137,京都府,南丹市,4,2,決算収支の状況,1,令和4年度,24707459,23660337,1047122,185214,861908,-85136,472628,0,603268,-215776
2022,61,262145,京都府,木津川市,4,2,決算収支の状況,1,令和4年度,35915135,33920531,1994604,162947,1831657,863007,486287,0,419435,929859
2022,61,263036,京都府,大山崎町,5,2,決算収支の状況,1,令和4年度,7622148,7374895,247253,23657,223596,97542,359552,0,69177,387917
2022,61,263222,京都府,久御山町,5,2,決算収支の状況,1,令和4年度,8682006,8267129,414877,30483,384394,-17997,569812,0,0,551815
2022,61,263435,京都府,井手町,5,2,決算収支の状況,1,令和4年度,7770890,7325762,445128,61177,383951,14884,7094,0,0,21978
2022,61,263443,京都府,宇治田原町,5,2,決算収支の状況,1,令和4年度,5663073,5479056,184017,16986,167031,-34903,110044,0,20000,55141
2022,61,263648,京都府,笠置町,5,2,決算収支の状況,1,令和4年度,1577287,1487716,89571,5735,83836,-19017,39356,0,0,20339
2022,61,263656,京都府,和束町,5,2,決算収支の状況,1,令和4年度,4246068,4183095,62973,18345,44628,4285,11,0,5312,-1016
2022,61,263664,京都府,精華町,5,2,決算収支の状況,1,令和4年度,15331217,14646375,684842,512103,172739,-53671,51510,0,0,-2161
2022,61,263672,京都府,南山城村,5,2,決算収支の状況,1,令和4年度,2781185,2715605,65580,54570,11010,-54468,22,0,0,-54446
2022,61,264075,京都府,京丹波町,5,2,決算収支の状況,1,令和4年度,11583546,11298071,285475,52800,232675,-133068,83081,0,0,-49987
2022,61,264636,京都府,伊根町,5,2,決算収支の状況,1,令和4年度,4104347,3730308,374039,107927,266112,63033,103489,0,5880,160642
2022,61,264652,京都府,与謝野町,5,2,決算収支の状況,1,令和4年度,12213521,12130960,82561,29682,52879,36750,669,0,0,37419
2022,61,268020,京都府,与謝野町宮津市中学校組合,6,2,決算収支の状況,1,令和4年度,110074,98996,11078,456,10622,-213,0,0,0,-213
2022,61,268038,京都府,加茂笠置組合,7,2,決算収支の状況,1,令和4年度,0,0,0,0,0,0,0,0,0,0
2022,61,268160,京都府,亀岡市及び南丹市財産区組合,7,2,決算収支の状況,1,令和4年度,0,0,0,0,0,0,0,0,0,0
2022,61,268178,京都府,船井郡衛生管理組合,6,2,決算収支の状況,1,令和4年度,1722562,1682100,40462,13640,26822,-12496,13,0,0,-12483
2022,61,268208,京都府,城南衛生管理組合,6,2,決算収支の状況,1,令和4年度,6319962,6211869,108093,41207,66886,9003,29022,0,0,38025
2022,61,268216,京都府,木津川市精華町環境施設組合,6,2,決算収支の状況,1,令和4年度,722895,715860,7035,0,7035,324,24,0,0,348
2022,61,268224,京都府,京都府市町村職員退職手当組合,6,2,決算収支の状況,1,令和4年度,4074600,4013426,61174,0,61174,-152566,0,0,0,-152566
2022,61,268283,京都府,乙訓環境衛生組合,6,2,決算収支の状況,1,令和4年度,1530086,1509915,20171,0,20171,1924,44629,0,94562,-48009
2022,61,268305,京都府,桂川・小畑川水防事務組合,6,2,決算収支の状況,1,令和4年度,22603,15824,6779,0,6779,1399,1001,0,0,2400
2022,61,268313,京都府,澱川右岸水防事務組合,6,2,決算収支の状況,1,令和4年度,24838,19376,5462,0,5462,1936,510,0,0,2446
2022,61,268348,京都府,淀川・木津川水防事務組合,6,2,決算収支の状況,1,令和4年度,14929,10463,4466,0,4466,-485,1000,0,0,515
2022,61,268364,京都府,京都府市町村議会議員公務災害補償等組合,6,2,決算収支の状況,1,令和4年度,2644,1000,1644,0,1644,-62,0,0,0,-62
2022,61,268411,京都府,相楽中部消防組合,6,2,決算収支の状況,1,令和4年度,1912323,1875471,36852,0,36852,-3734,0,0,0,-3734
2022,61,268445,京都府,乙訓福祉施設事務組合,6,2,決算収支の状況,1,令和4年度,490288,469033,21255,0,21255,1379,0,0,1133,246
2022,61,268470,京都府,宮津与謝消防組合,6,2,決算収支の状況,1,令和4年度,964861,944985,19876,0,19876,-14731,0,0,0,-14731
2022,61,268496,京都府,相楽郡広域事務組合,6,2,決算収支の状況,1,令和4年度,1010534,983826,26708,0,26708,17383,0,0,0,17383
2022,61,268500,京都府,京都中部広域消防組合,6,2,決算収支の状況,1,令和4年度,2378847,2350665,28182,0,28182,11380,12,0,0,11392
2022,61,268542,京都府,京都府自治会館管理組合,6,2,決算収支の状況,1,令和4年度,97157,94190,2967,0,2967,-606,0,0,0,-606
2022,61,268569,京都府,京都府住宅新築資金等貸付事業管理組合,6,2,決算収支の状況,1,令和4年度,774019,124592,649427,0,649427,74181,0,0,0,74181
2022,61,268577,京都府,乙訓消防組合,6,2,決算収支の状況,1,令和4年度,2050151,2034980,15171,0,15171,-80881,8,0,0,-80873
2022,61,268585,京都府,京都府後期高齢者医療広域連合,7,2,決算収支の状況,1,令和4年度,1239614,1116646,122968,0,122968,-91866,9,0,29180,-121037
2022,61,268593,京都府,相楽東部広域連合,6,2,決算収支の状況,1,令和4年度,862070,830866,31204,0,31204,8668,0,0,0,8668
2022,61,268607,京都府,京都地方税機構,6,2,決算収支の状況,1,令和4年度,2468699,2467700,999,0,999,24,0,0,0,24
2022,61,268615,京都府,宮津与謝環境組合,6,2,決算収支の状況,1,令和4年度,563852,540170,23682,0,23682,-4955,0,0,0,-4955
2022,61,271004,大阪府,大阪市,1,2,決算収支の状況,1,令和4年度,1938280969,1906782922,31498047,5725087,25772960,-5023504,32179547,0,604,27155439
2022,61,271403,大阪府,堺市,1,2,決算収支の状況,1,令和4年度,462931510,454091696,8839814,992218,7847596,555416,11979174,0,8319225,4215365
2022,61,272027,大阪府,岸和田市,9,2,決算収支の状況,1,令和4年度,85603291,84143922,1459369,490038,969331,-1307016,479,0,0,-1306537
2022,61,272035,大阪府,豊中市,8,2,決算収支の状況,1,令和4年度,186042090,179343577,6698513,641237,6057276,531189,5119560,0,5430650,220099
2022,61,272043,大阪府,池田市,3,2,決算収支の状況,1,令和4年度,41037551,40804878,232673,114292,118381,-392431,1124,0,0,-391307
2022,61,272051,大阪府,吹田市,8,2,決算収支の状況,1,令和4年度,160136757,156308636,3828121,2345978,1482143,-1131500,1296653,0,0,165153
2022,61,272060,大阪府,泉大津市,4,2,決算収支の状況,1,令和4年度,34547099,34024014,523085,203807,319278,-25262,794168,0,300000,468906
2022,61,272078,大阪府,高槻市,8,2,決算収支の状況,1,令和4年度,146739337,145040626,1698711,666489,1032222,-1542415,1965756,0,3000000,-2576659
2022,61,272086,大阪府,貝塚市,4,2,決算収支の状況,1,令和4年度,38162878,37675219,487659,26248,461411,305232,79000,27226,0,411458
2022,61,272094,大阪府,守口市,3,2,決算収支の状況,1,令和4年度,74394524,71984520,2410004,136987,2273017,188176,89949,1414178,19936,1672367
2022,61,272108,大阪府,枚方市,8,2,決算収支の状況,1,令和4年度,163700770,160424875,3275895,784945,2490950,33374,1934474,387373,37500,2317721
2022,61,272116,大阪府,茨木市,9,2,決算収支の状況,1,令和4年度,115482657,112668857,2813800,1830040,983760,38016,530,0,200000,-161454
2022,61,272124,大阪府,八尾市,8,2,決算収支の状況,1,令和4年度,123120328,122716726,403602,347273,56329,-493522,572026,320700,150000,249204
2022,61,272132,大阪府,泉佐野市,3,2,決算収支の状況,1,令和4年度,76818888,76316581,502307,93571,408736,23735,232051,1116000,0,1371786
2022,61,272141,大阪府,富田林市,3,2,決算収支の状況,1,令和4年度,46401557,45231070,1170487,207139,963348,107120,505600,0,0,612720
2022,61,272159,大阪府,寝屋川市,8,2,決算収支の状況,1,令和4年度,106712662,105438872,1273790,132895,1140895,6170,1643185,0,1539877,109478
2022,61,272167,大阪府,河内長野市,3,2,決算収支の状況,1,令和4年度,40682657,40530981,151676,132860,18816,-665,25200,0,0,24535
2022,61,272175,大阪府,松原市,3,2,決算収支の状況,1,令和4年度,51356567,50341728,1014839,22718,992121,-53848,1960457,0,6589,1900020
2022,61,272183,大阪府,大東市,3,2,決算収支の状況,1,令和4年度,53850154,52574118,1276036,9833,1266203,-162144,7054,0,0,-155090
2022,61,272191,大阪府,和泉市,3,2,決算収支の状況,1,令和4年度,73757759,73259622,498137,159433,338704,-307584,330470,0,0,22886
2022,61,272205,大阪府,箕面市,3,2,決算収支の状況,1,令和4年度,77027912,71862843,5165069,3602448,1562621,96213,45295,4680052,487956,4333604
2022,61,272213,大阪府,柏原市,4,2,決算収支の状況,1,令和4年度,29885676,29006677,878999,76639,802360,-366671,590386,11700,0,235415
2022,61,272221,大阪府,羽曳野市,3,2,決算収支の状況,1,令和4年度,44885289,44762085,123204,17461,105743,-463469,284722,0,180000,-358747
2022,61,272230,大阪府,門真市,3,2,決算収支の状況,1,令和4年度,64721588,64438586,283002,147804,135198,-353897,489719,30168,0,165990
2022,61,272248,大阪府,摂津市,4,2,決算収支の状況,1,令和4年度,43782657,42936807,845850,875508,-29658,-563971,274912,0,400000,-689059
2022,61,272256,大阪府,高石市,4,2,決算収支の状況,1,令和4年度,27266508,26325958,940550,113379,827171,-358430,610912,0,12639,239843
2022,61,272264,大阪府,藤井寺市,4,2,決算収支の状況,1,令和4年度,25444441,25049099,395342,16388,378954,-38185,18,2379,0,-35788
2022,61,272272,大阪府,東大阪市,8,2,決算収支の状況,1,令和4年度,232102551,227452704,4649847,565681,4084166,792121,4162800,25,1500000,3454946
2022,61,272281,大阪府,泉南市,4,2,決算収支の状況,1,令和4年度,27149449,26556664,592785,19500,573285,-132476,235374,187506,0,290404
2022,61,272299,大阪府,四條畷市,4,2,決算収支の状況,1,令和4年度,22848380,21995295,853085,221936,631149,339243,147826,0,0,487069
2022,61,272302,大阪府,交野市,4,2,決算収支の状況,1,令和4年度,30146372,29513196,633176,74269,558907,107901,233911,154416,2848,493380
2022,61,272311,大阪府,大阪狭山市,4,2,決算収支の状況,1,令和4年度,23268429,22500816,767613,37270,730343,-92462,200587,0,0,108125
2022,61,272329,大阪府,阪南市,4,2,決算収支の状況,1,令和4年度,20875889,20581311,294578,12602,281976,-137562,392885,0,0,255323
2022,61,273015,大阪府,島本町,5,2,決算収支の状況,1,令和4年度,14106426,14017675,88751,35181,53570,-226412,459991,0,0,233579
2022,61,273210,大阪府,豊能町,5,2,決算収支の状況,1,令和4年度,8817926,8339185,478741,130493,348248,-56856,406968,0,200000,150112
2022,61,273228,大阪府,能勢町,5,2,決算収支の状況,1,令和4年度,6251001,6036905,214096,720,213376,-99586,342015,0,73000,169429
2022,61,273414,大阪府,忠岡町,5,2,決算収支の状況,1,令和4年度,8740966,8319346,421620,58279,363341,-184702,613952,0,0,429250
2022,61,273619,大阪府,熊取町,5,2,決算収支の状況,1,令和4年度,17734023,17584111,149912,74023,75889,-538390,308000,0,0,-230390
2022,61,273627,大阪府,田尻町,5,2,決算収支の状況,1,令和4年度,6165576,5562234,603342,65338,538004,-13781,276083,0,0,262302
2022,61,273660,大阪府,岬町,5,2,決算収支の状況,1,令和4年度,8200456,8078125,122331,45646,76685,4902,20030,0,336000,-311068
2022,61,273813,大阪府,太子町,5,2,決算収支の状況,1,令和4年度,6569521,6394939,174582,8695,165887,-15512,91001,0,0,75489
2022,61,273821,大阪府,河南町,5,2,決算収支の状況,1,令和4年度,6795188,6504827,290361,15136,275225,98337,493,0,0,98830
2022,61,273830,大阪府,千早赤阪村,5,2,決算収支の状況,1,令和4年度,4205200,4120003,85197,8114,77083,-28631,54101,23372,0,48842
2022,61,278084,大阪府,恩智川水防事務組合,6,2,決算収支の状況,1,令和4年度,23214,18824,4390,0,4390,1798,0,0,0,1798
2022,61,278092,大阪府,淀川左岸水防事務組合,6,2,決算収支の状況,1,令和4年度,162104,157479,4625,0,4625,1696,0,0,0,1696
2022,61,278106,大阪府,大和川右岸水防事務組合,6,2,決算収支の状況,1,令和4年度,98804,96217,2587,0,2587,-699,636,0,0,-63
2022,61,278122,大阪府,淀川右岸水防事務組合,6,2,決算収支の状況,1,令和4年度,130926,125948,4978,0,4978,399,0,0,0,399
2022,61,278149,大阪府,守口市門真市消防組合,6,2,決算収支の状況,1,令和4年度,4977824,4949205,28619,0,28619,15655,0,0,0,15655
2022,61,278157,大阪府,枚方寝屋川消防組合,6,2,決算収支の状況,1,令和4年度,7453557,7360274,93283,0,93283,42055,0,0,0,42055
2022,61,278165,大阪府,柏原羽曳野藤井寺消防組合,6,2,決算収支の状況,1,令和4年度,3124674,3098645,26029,0,26029,19678,0,0,0,19678
2022,61,278246,大阪府,八尾市柏原市火葬場組合,6,2,決算収支の状況,1,令和4年度,1171,1068,103,0,103,-86,0,0,0,-86
2022,61,278254,大阪府,泉大津市、和泉市墓地組合,6,2,決算収支の状況,1,令和4年度,16629,11752,4877,0,4877,-424,5301,0,0,4877
2022,61,278262,大阪府,高石市泉大津市墓地組合,6,2,決算収支の状況,1,令和4年度,101428,88624,12804,0,12804,-8716,0,0,0,-8716
2022,61,278271,大阪府,豊中市伊丹市クリーンランド,6,2,決算収支の状況,1,令和4年度,4650209,3728097,922112,0,922112,157634,0,0,0,157634
2022,61,278289,大阪府,泉北環境整備施設組合,6,2,決算収支の状況,1,令和4年度,3326401,3188359,138042,3059,134983,-28655,0,0,0,-28655
2022,61,278319,大阪府,柏羽藤環境事業組合,6,2,決算収支の状況,1,令和4年度,2778870,2682175,96695,0,96695,-10896,0,0,0,-10896
2022,61,278327,大阪府,飯盛霊園組合,6,2,決算収支の状況,1,令和4年度,978913,879043,99870,0,99870,-28573,0,0,0,-28573
2022,61,278335,大阪府,泉佐野市田尻町清掃施設組合,6,2,決算収支の状況,1,令和4年度,1632873,1632873,0,0,0,0,0,0,0,0
2022,61,278343,大阪府,東大阪都市清掃施設組合,6,2,決算収支の状況,1,令和4年度,4267792,4199675,68117,2500,65617,-59686,0,0,0,-59686
2022,61,278351,大阪府,四條畷市交野市清掃施設組合,6,2,決算収支の状況,1,令和4年度,1809554,1775871,33683,0,33683,-4966,0,0,0,-4966
2022,61,278360,大阪府,岸和田市貝塚市清掃施設組合,6,2,決算収支の状況,1,令和4年度,3875350,3782439,92911,60688,32223,-316,0,0,0,-316
2022,61,278378,大阪府,南河内環境事業組合,6,2,決算収支の状況,1,令和4年度,2220041,2122228,97813,0,97813,-43968,0,0,0,-43968
2022,61,278386,大阪府,泉南清掃事務組合,6,2,決算収支の状況,1,令和4年度,1589430,1424635,164795,0,164795,85542,0,0,0,85542
2022,61,278408,大阪府,大阪府都市競艇企業団,7,2,決算収支の状況,1,令和4年度,0,0,0,0,0,0,0,0,0,0
2022,61,278530,大阪府,藤井寺市柏原市学校給食組合,6,2,決算収支の状況,1,令和4年度,636450,627887,8563,0,8563,2263,0,0,0,2263
2022,61,278599,大阪府,豊能郡環境施設組合,6,2,決算収支の状況,1,令和4年度,98623,90426,8197,0,8197,-23196,0,0,0,-23196
2022,61,278645,大阪府,くすのき広域連合,7,2,決算収支の状況,1,令和4年度,0,0,0,0,0,0,0,0,0,0
2022,61,278661,大阪府,北河内４市リサイクル施設組合,6,2,決算収支の状況,1,令和4年度,431717,421916,9801,0,9801,4750,0,0,0,4750
2022,61,278670,大阪府,大阪府後期高齢者医療広域連合,7,2,決算収支の状況,1,令和4年度,194271,178428,15843,0,15843,-8404,0,0,0,-8404
2022,61,278696,大阪府,関西広域連合,6,2,決算収支の状況,1,令和4年度,2743208,2681232,61976,0,61976,-11086,36532,0,36532,-11086
2022,61,278700,大阪府,泉州南消防組合,6,2,決算収支の状況,1,令和4年度,3751213,3751213,0,0,0,0,0,0,0,0
2022,61,278718,大阪府,大東四條畷消防組合,6,2,決算収支の状況,1,令和4年度,1968348,1945982,22366,0,22366,1316,0,0,0,1316
2022,61,278726,大阪府,大阪広域環境施設組合,6,2,決算収支の状況,1,令和4年度,23617686,23617686,0,0,0,0,0,0,0,0
2022,61,278734,大阪府,枚方京田辺環境施設組合,6,2,決算収支の状況,1,令和4年度,265986,265837,149,0,149,99,0,0,0,99
2022,61,281000,兵庫県,神戸市,1,2,決算収支の状況,1,令和4年度,976542111,963856264,12685847,11559344,1126503,89971,1036833,0,0,1126804
2022,61,282014,兵庫県,姫路市,8,2,決算収支の状況,1,令和4年度,239739534,230312665,9426869,3656617,5770252,274223,7820,1649110,0,1931153
2022,61,282022,兵庫県,尼崎市,8,2,決算収支の状況,1,令和4年度,227354581,224299753,3054828,740300,2314528,-544757,3436891,1517800,3219032,1190902
2022,61,282031,兵庫県,明石市,8,2,決算収支の状況,1,令和4年度,127828220,126526263,1301957,260066,1041891,-551437,637626,0,800000,-713811
2022,61,282049,兵庫県,西宮市,8,2,決算収支の状況,1,令和4年度,201067541,200150332,917209,397096,520113,-4742380,2601785,0,2100000,-4240595
2022,61,282057,兵庫県,洲本市,4,2,決算収支の状況,1,令和4年度,27736676,26947278,789398,66832,722566,135130,307532,0,0,442662
2022,61,282065,兵庫県,芦屋市,4,2,決算収支の状況,1,令和4年度,48302957,45686492,2616465,241746,2374719,-1216660,3192417,0,0,1975757
2022,61,282073,兵庫県,伊丹市,3,2,決算収支の状況,1,令和4年度,92952656,91861306,1091350,188609,902741,-202272,1356051,202300,0,1356079
2022,61,282081,兵庫県,相生市,4,2,決算収支の状況,1,令和4年度,14857590,14292319,565271,135662,429609,-36730,306608,0,410000,-140122
2022,61,282090,兵庫県,豊岡市,4,2,決算収支の状況,1,令和4年度,52533757,51211808,1321949,266261,1055688,-640221,501681,0,57468,-196008
2022,61,282103,兵庫県,加古川市,9,2,決算収支の状況,1,令和4年度,94033136,92740406,1292730,521209,771521,474864,85227,0,0,560091
2022,61,282120,兵庫県,赤穂市,4,2,決算収支の状況,1,令和4年度,23783289,23155223,628066,34766,593300,-138281,351515,353000,0,566234
2022,61,282138,兵庫県,西脇市,4,2,決算収支の状況,1,令和4年度,21569273,21246100,323173,19826,303347,-470593,4303,0,0,-466290
2022,61,282146,兵庫県,宝塚市,9,2,決算収支の状況,1,令和4年度,91037273,89536890,1500383,293042,1207341,-1176021,1193651,0,0,17630
2022,61,282154,兵庫県,三木市,4,2,決算収支の状況,1,令和4年度,35353481,34825129,528352,134043,394309,-543165,469128,0,0,-74037
2022,61,282162,兵庫県,高砂市,4,2,決算収支の状況,1,令和4年度,42925358,41578969,1346389,55430,1290959,-775639,1034079,0,0,258440
2022,61,282171,兵庫県,川西市,3,2,決算収支の状況,1,令和4年度,62093504,61425978,667526,135934,531592,-827987,547187,0,0,-280800
2022,61,282189,兵庫県,小野市,4,2,決算収支の状況,1,令和4年度,22789791,22188132,601659,178636,423023,-362553,6100,0,500000,-856453
2022,61,282197,兵庫県,三田市,3,2,決算収支の状況,1,令和4年度,42269751,41285040,984711,505291,479420,-417037,497416,0,0,80379
2022,61,282201,兵庫県,加西市,4,2,決算収支の状況,1,令和4年度,27885167,27192475,692692,78942,613750,-374887,639010,0,0,264123
2022,61,282219,兵庫県,丹波篠山市,4,2,決算収支の状況,1,令和4年度,23384826,22937532,447294,132150,315144,-185740,222,0,300000,-485518
2022,61,282227,兵庫県,養父市,4,2,決算収支の状況,1,令和4年度,19222883,18242707,980176,37487,942689,-153928,2620,210186,0,58878
2022,61,282235,兵庫県,丹波市,4,2,決算収支の状況,1,令和4年度,40880015,39220402,1659613,156095,1503518,-438933,9935,650000,327907,-106905
2022,61,282243,兵庫県,南あわじ市,4,2,決算収支の状況,1,令和4年度,33976646,32906027,1070619,76460,994159,-177352,7786,603535,54000,379969
2022,61,282251,兵庫県,朝来市,4,2,決算収支の状況,1,令和4年度,21160125,20448137,711988,222398,489590,-467163,2358,399975,0,-64830
2022,61,282260,兵庫県,淡路市,4,2,決算収支の状況,1,令和4年度,36068152,35843874,224278,136867,87411,-810857,451719,1339146,0,980008
2022,61,282278,兵庫県,宍粟市,4,2,決算収支の状況,1,令和4年度,25068592,24202916,865676,97871,767805,-55722,102793,556778,0,603849
2022,61,282286,兵庫県,加東市,4,2,決算収支の状況,1,令和4年度,23192133,22660197,531936,76189,455747,-111737,6602,0,150000,-255135
2022,61,282294,兵庫県,たつの市,4,2,決算収支の状況,1,令和4年度,39954177,38308178,1645999,226663,1419336,-69072,536790,372930,134736,705912
2022,61,283011,兵庫県,猪名川町,5,2,決算収支の状況,1,令和4年度,12052361,11700859,351502,56632,294870,-99926,202373,0,108806,-6359
2022,61,283657,兵庫県,多可町,5,2,決算収支の状況,1,令和4年度,12367831,12212303,155528,33424,122104,-39425,1570,0,0,-37855
2022,61,283819,兵庫県,稲美町,5,2,決算収支の状況,1,令和4年度,13154931,12284307,870624,115685,754939,-188036,440650,0,0,252614
2022,61,283827,兵庫県,播磨町,5,2,決算収支の状況,1,令和4年度,14116573,13289224,827349,213596,613753,-232952,3269,0,764731,-994414
2022,61,284424,兵庫県,市川町,5,2,決算収支の状況,1,令和4年度,6826853,6579283,247570,0,247570,97157,36034,0,0,133191
2022,61,284432,兵庫県,福崎町,5,2,決算収支の状況,1,令和4年度,9077123,8897239,179884,12979,166905,-85157,1400,0,134100,-217857
2022,61,284467,兵庫県,神河町,5,2,決算収支の状況,1,令和4年度,9012667,8779096,233571,48119,185452,8649,233257,0,35080,206826
2022,61,284645,兵庫県,太子町,5,2,決算収支の状況,1,令和4年度,13037246,12703669,333577,35717,297860,-208993,255759,0,0,46766
2022,61,284815,兵庫県,上郡町,5,2,決算収支の状況,1,令和4年度,8581681,8291682,289999,42003,247996,-105865,100861,98647,0,93643
2022,61,285013,兵庫県,佐用町,5,2,決算収支の状況,1,令和4年度,13168061,13054988,113073,3544,109529,-23227,41819,1079551,123747,974396
2022,61,285854,兵庫県,香美町,5,2,決算収支の状況,1,令和4年度,15633949,14837020,796929,61263,735666,192708,135252,0,328681,-721
2022,61,285862,兵庫県,新温泉町,5,2,決算収支の状況,1,令和4年度,12987878,12207653,780225,113739,666486,-77317,1261,0,60000,-136056
2022,61,288012,兵庫県,兵庫県市町村職員退職手当組合,6,2,決算収支の状況,1,令和4年度,11898981,10875542,1023439,0,1023439,-1304834,0,0,0,-1304834
2022,61,288101,兵庫県,北播衛生事務組合,6,2,決算収支の状況,1,令和4年度,210170,180316,29854,0,29854,-7251,0,0,0,-7251
2022,61,288128,兵庫県,北播磨こども発達支援センター事務組合わかあゆ園,6,2,決算収支の状況,1,令和4年度,121946,109116,12830,0,12830,6646,35,0,0,6681
2022,61,288179,兵庫県,揖龍保健衛生施設事務組合,6,2,決算収支の状況,1,令和4年度,1921260,1876696,44564,0,44564,-9926,29746,0,83452,-63632
2022,61,288195,兵庫県,加古川市外２市共有公会堂事務組合,6,2,決算収支の状況,1,令和4年度,5566,827,4739,0,4739,-811,0,0,0,-811
2022,61,288209,兵庫県,市川町外三ヶ市町共有財産事務組合,6,2,決算収支の状況,1,令和4年度,17144,16036,1108,0,1108,194,3235,0,6852,-3423
2022,61,288268,兵庫県,洲本市・南あわじ市山林事務組合,6,2,決算収支の状況,1,令和4年度,2250,1620,630,0,630,2,0,0,0,2
2022,61,288284,兵庫県,南あわじ市・洲本市小中学校組合,6,2,決算収支の状況,1,令和4年度,143894,141942,1952,293,1659,-4180,0,0,0,-4180
2022,61,288535,兵庫県,中播衛生施設事務組合,6,2,決算収支の状況,1,令和4年度,193856,175629,18227,7080,11147,604,10,0,0,614
2022,61,288691,兵庫県,氷上多可衛生事務組合,6,2,決算収支の状況,1,令和4年度,238296,218532,19764,0,19764,10241,5077,0,14018,1300
2022,61,288811,兵庫県,兵庫県町議会議員公務災害補償組合,6,2,決算収支の状況,1,令和4年度,11838,11287,551,0,551,-560,0,0,0,-560
2022,61,288900,兵庫県,洲本市・南あわじ市衛生事務組合,6,2,決算収支の状況,1,令和4年度,436241,421197,15044,0,15044,5533,0,0,0,5533
2022,61,289027,兵庫県,加古郡衛生事務組合,6,2,決算収支の状況,1,令和4年度,384548,355189,29359,0,29359,-6065,0,0,0,-6065
2022,61,289035,兵庫県,播磨内陸医務事業組合,6,2,決算収支の状況,1,令和4年度,145996,136871,9125,0,9125,2339,16,0,0,2355
2022,61,289043,兵庫県,淡路広域行政事務組合,6,2,決算収支の状況,1,令和4年度,330051,305101,24950,0,24950,-3353,14100,0,9327,1420
2022,61,289051,兵庫県,南但広域行政事務組合,6,2,決算収支の状況,1,令和4年度,2452248,2421482,30766,0,30766,-214,1,0,5107,-5320
2022,61,289060,兵庫県,淡路広域消防事務組合,6,2,決算収支の状況,1,令和4年度,2034293,1999352,34941,2140,32801,6677,264,13140,0,20081
2022,61,289191,兵庫県,丹波少年自然の家事務組合,6,2,決算収支の状況,1,令和4年度,273262,161641,111621,0,111621,101004,0,0,0,101004
2022,61,289205,兵庫県,西脇多可行政事務組合,6,2,決算収支の状況,1,令和4年度,1536897,1407696,129201,74286,54915,10562,62,0,0,10624
2022,61,289221,兵庫県,兵庫県競馬組合,7,2,決算収支の状況,1,令和4年度,0,0,0,0,0,0,0,0,0,0
2022,61,289230,兵庫県,美方郡広域事務組合,6,2,決算収支の状況,1,令和4年度,828063,816428,11635,2550,9085,1964,46,0,2550,-540
2022,61,289256,兵庫県,中播北部行政事務組合,6,2,決算収支の状況,1,令和4年度,632210,624795,7415,62,7353,-17366,0,0,0,-17366
2022,61,289264,兵庫県,姫路福崎斎苑施設事務組合,6,2,決算収支の状況,1,令和4年度,49154,45704,3450,0,3450,5,0,0,0,5
2022,61,289329,兵庫県,小野加東加西環境施設事務組合,6,2,決算収支の状況,1,令和4年度,697449,677298,20151,0,20151,6190,0,0,0,6190
2022,61,289515,兵庫県,くれさか環境事務組合,6,2,決算収支の状況,1,令和4年度,998123,877756,120367,0,120367,67005,52376,0,0,119381
2022,61,289558,兵庫県,北但行政事務組合,6,2,決算収支の状況,1,令和4年度,850833,802609,48224,0,48224,19742,0,0,0,19742
2022,61,289566,兵庫県,但馬広域行政事務組合,6,2,決算収支の状況,1,令和4年度,223959,220836,3123,0,3123,444,1141,0,0,1585
2022,61,289591,兵庫県,小野加東広域事務組合,6,2,決算収支の状況,1,令和4年度,92733,73010,19723,0,19723,-3710,0,0,0,-3710
2022,61,289612,兵庫県,播磨高原広域事務組合（普通会計分）,6,2,決算収支の状況,1,令和4年度,412359,396155,16204,6495,9709,-10113,0,0,0,-10113
2022,61,289671,兵庫県,猪名川上流広域ごみ処理施設組合,6,2,決算収支の状況,1,令和4年度,3041479,2826874,214605,1131,213474,95970,0,0,0,95970
2022,61,289701,兵庫県,にしはりま環境事務組合,6,2,決算収支の状況,1,令和4年度,1381322,1361801,19521,0,19521,-2263,0,0,0,-2263
2022,61,289710,兵庫県,兵庫県後期高齢者医療広域連合（普通会計分）,6,2,決算収支の状況,1,令和4年度,560702,328230,232472,0,232472,106464,0,0,0,106464
2022,61,289728,兵庫県,兵庫県後期高齢者医療広域連合（事業会計分）,7,2,決算収支の状況,1,令和4年度,0,0,0,0,0,0,0,0,0,0
2022,61,289752,兵庫県,北はりま消防組合,6,2,決算収支の状況,1,令和4年度,2394260,2367380,26880,0,26880,-741,2,0,0,-739
2022,61,289761,兵庫県,西はりま消防組合,6,2,決算収支の状況,1,令和4年度,2826005,2750176,75829,0,75829,14077,0,0,0,14077
2022,61,292010,奈良県,奈良市,8,2,決算収支の状況,1,令和4年度,156226595,151061622,5164973,1268338,3896635,-1603361,93,530724,4000000,-5072544
2022,61,292028,奈良県,大和高田市,4,2,決算収支の状況,1,令和4年度,28808725,28462134,346591,49555,297036,-1111895,17,0,100000,-1211878
2022,61,292036,奈良県,大和郡山市,4,2,決算収支の状況,1,令和4年度,39357713,38513552,844161,71276,772885,-27375,1325,1525214,0,1499164
2022,61,292044,奈良県,天理市,4,2,決算収支の状況,1,令和4年度,29441463,27708425,1733038,64372,1668666,-318516,34,0,0,-318482
2022,61,292052,奈良県,橿原市,3,2,決算収支の状況,1,令和4年度,48762664,46692891,2069773,123980,1945793,-577114,1262735,515499,0,1201120
2022,61,292061,奈良県,桜井市,4,2,決算収支の状況,1,令和4年度,25725425,24329055,1396370,74474,1321896,219377,560001,0,400000,379378
2022,61,292079,奈良県,五條市,4,2,決算収支の状況,1,令和4年度,19425021,18667099,757922,5628,752294,83067,96,137413,0,220576
2022,61,292087,奈良県,御所市,4,2,決算収支の状況,1,令和4年度,19265248,18390164,875084,45480,829604,-321026,280149,296429,0,255552
2022,61,292095,奈良県,生駒市,3,2,決算収支の状況,1,令和4年度,44513782,42293947,2219835,245430,1974405,-1205614,639,0,0,-1204975
2022,61,292109,奈良県,香芝市,4,2,決算収支の状況,1,令和4年度,28796051,27972103,823948,153546,670402,-167579,402,9126,4015,-162066
2022,61,292117,奈良県,葛城市,4,2,決算収支の状況,1,令和4年度,17776790,17071978,704812,30149,674663,-43076,656,0,0,-42420
2022,61,292125,奈良県,宇陀市,4,2,決算収支の状況,1,令和4年度,20009006,19480722,528284,62680,465604,71965,335139,0,330000,77104
2022,61,293229,奈良県,山添村,5,2,決算収支の状況,1,令和4年度,3384411,3111291,273120,25,273095,85089,101924,0,0,187013
2022,61,293423,奈良県,平群町,5,2,決算収支の状況,1,令和4年度,7742595,7311753,430842,54365,376477,-35878,50000,287988,0,302110
2022,61,293431,奈良県,三郷町,5,2,決算収支の状況,1,令和4年度,10134871,9392958,741913,74979,666934,-135446,9746,0,0,-125700
2022,61,293440,奈良県,斑鳩町,5,2,決算収支の状況,1,令和4年度,11410343,10655409,754934,27682,727252,-68351,1806,0,0,-66545
2022,61,293458,奈良県,安堵町,5,2,決算収支の状況,1,令和4年度,4108353,3716622,391731,47285,344446,90396,98415,0,0,188811
2022,61,293610,奈良県,川西町,5,2,決算収支の状況,1,令和4年度,5314069,4921778,392291,47166,345125,47974,49,166497,0,214520
2022,61,293628,奈良県,三宅町,5,2,決算収支の状況,1,令和4年度,4288207,4029320,258887,49345,209542,-15104,100420,0,0,85316
2022,61,293636,奈良県,田原本町,5,2,決算収支の状況,1,令和4年度,14427228,13499166,928062,16587,911475,114025,490,0,0,114515
2022,61,293857,奈良県,曽爾村,5,2,決算収支の状況,1,令和4年度,2855279,2763547,91732,23623,68109,-35111,1431,0,0,-33680
2022,61,293865,奈良県,御杖村,5,2,決算収支の状況,1,令和4年度,2717889,2540807,177082,5317,171765,4001,261247,0,0,265248
2022,61,294012,奈良県,高取町,5,2,決算収支の状況,1,令和4年度,4163165,4090990,72175,26896,45279,12224,17001,0,38818,-9593
2022,61,294021,奈良県,明日香村,5,2,決算収支の状況,1,令和4年度,5966321,5592752,373569,4280,369289,-28532,120144,0,100145,-8533
2022,61,294241,奈良県,上牧町,5,2,決算収支の状況,1,令和4年度,9924325,9584959,339366,55114,284252,-70310,305544,92400,219586,108048
2022,61,294250,奈良県,王寺町,5,2,決算収支の状況,1,令和4年度,11710856,11207991,502865,16210,486655,-24235,376726,0,0,352491
2022,61,294268,奈良県,広陵町,5,2,決算収支の状況,1,令和4年度,14587683,13917566,670117,94162,575955,115894,460061,0,110290,465665
2022,61,294276,奈良県,河合町,5,2,決算収支の状況,1,令和4年度,7740875,7380753,360122,20403,339719,-17575,408065,0,0,390490
2022,61,294411,奈良県,吉野町,5,2,決算収支の状況,1,令和4年度,6402587,5921416,481171,5819,475352,-111630,119261,0,0,7631
2022,61,294420,奈良県,大淀町,5,2,決算収支の状況,1,令和4年度,10225630,9939286,286344,82019,204325,141523,16992,0,0,158515
2022,61,294438,奈良県,下市町,5,2,決算収支の状況,1,令和4年度,6211502,5931278,280224,16695,263529,-58531,161044,0,30000,72513
2022,61,294446,奈良県,黒滝村,5,2,決算収支の状況,1,令和4年度,1852968,1743113,109855,6763,103092,13234,70987,0,77251,6970
2022,61,294462,奈良県,天川村,5,2,決算収支の状況,1,令和4年度,2672727,2350226,322501,1096,321405,97368,662,0,0,98030
2022,61,294471,奈良県,野迫川村,5,2,決算収支の状況,1,令和4年度,1586802,1376410,210392,9320,201072,99067,4,0,0,99071
2022,61,294497,奈良県,十津川村,5,2,決算収支の状況,1,令和4年度,6483098,6091499,391599,80531,311068,-105839,300269,0,0,194430
2022,61,294501,奈良県,下北山村,5,2,決算収支の状況,1,令和4年度,2221391,2146784,74607,100,74507,-13575,57745,0,0,44170
2022,61,294519,奈良県,上北山村,5,2,決算収支の状況,1,令和4年度,2212682,1892170,320512,35745,284767,23917,130430,0,100000,54347
2022,61,294527,奈良県,川上村,5,2,決算収支の状況,1,令和4年度,4438587,4101390,337197,42013,295184,-32320,10609,0,80000,-101711
2022,61,294535,奈良県,東吉野村,5,2,決算収支の状況,1,令和4年度,2938192,2496593,441599,3221,438378,146971,18,0,0,146989
2022,61,298026,奈良県,川西町・三宅町式下中学校組合,6,2,決算収支の状況,1,令和4年度,206475,197319,9156,0,9156,-40418,0,0,0,-40418
2022,61,298085,奈良県,老人福祉施設三室園組合,6,2,決算収支の状況,1,令和4年度,303332,264291,39041,0,39041,10762,47,0,0,10809
2022,61,298093,奈良県,奈良県葛城地区清掃事務組合,6,2,決算収支の状況,1,令和4年度,1333503,1333503,0,0,0,0,7397,0,10514,-3117
2022,61,298107,奈良県,宇陀衛生一部事務組合,6,2,決算収支の状況,1,令和4年度,341890,170103,171787,166760,5027,-1148,6182,0,0,5034
2022,61,298131,奈良県,奥山組合,7,2,決算収支の状況,1,令和4年度,0,0,0,0,0,0,0,0,0,0
2022,61,298140,奈良県,青葉山組合,7,2,決算収支の状況,1,令和4年度,0,0,0,0,0,0,0,0,0,0
2022,61,298166,奈良県,神野山組合,7,2,決算収支の状況,1,令和4年度,0,0,0,0,0,0,0,0,0,0
2022,61,298182,奈良県,奈良県市町村総合事務組合,6,2,決算収支の状況,1,令和4年度,4286249,4270458,15791,0,15791,2207,0,0,0,2207
2022,61,298239,奈良県,上・下北山衛生一部事務組合,6,2,決算収支の状況,1,令和4年度,133017,107696,25321,0,25321,4103,0,0,0,4103
2022,61,298280,奈良県,香芝・王寺環境施設組合,6,2,決算収支の状況,1,令和4年度,4806798,4752188,54610,0,54610,21043,0,0,0,21043
2022,61,298310,奈良県,王寺周辺広域休日応急診療施設組合,6,2,決算収支の状況,1,令和4年度,202924,174698,28226,0,28226,6344,14600,0,19205,1739
2022,61,298344,奈良県,吉野広域行政組合,6,2,決算収支の状況,1,令和4年度,427071,365088,61983,0,61983,1135,12003,0,15642,-2504
2022,61,298352,奈良県,山辺環境衛生組合,6,2,決算収支の状況,1,令和4年度,123059,120455,2604,0,2604,-2529,1,0,840,-3368
2022,61,298361,奈良県,曽爾御杖行政一部事務組合,6,2,決算収支の状況,1,令和4年度,31936,30812,1124,0,1124,-380,0,0,0,-380
2022,61,298433,奈良県,南和広域衛生組合,6,2,決算収支の状況,1,令和4年度,397629,381632,15997,0,15997,2177,0,0,0,2177
2022,61,298441,奈良県,東宇陀環境衛生組合,6,2,決算収支の状況,1,令和4年度,194924,188760,6164,0,6164,-5300,1,0,0,-5299
2022,61,298450,奈良県,奈良広域水質検査センター組合,6,2,決算収支の状況,1,令和4年度,119393,112731,6662,0,6662,-420,56,0,20000,-20364
2022,61,298468,奈良県,飛鳥広域行政事務組合,6,2,決算収支の状況,1,令和4年度,12087,7947,4140,0,4140,-6514,0,0,0,-6514
2022,61,298484,奈良県,桜井宇陀広域連合,6,2,決算収支の状況,1,令和4年度,82680,66136,16544,0,16544,3588,0,0,0,3588
2022,61,298492,奈良県,静香苑環境施設組合,6,2,決算収支の状況,1,令和4年度,176024,160873,15151,0,15151,4881,5138,0,8690,1329
2022,61,298506,奈良県,奈良県住宅新築資金等貸付金回収管理組合,6,2,決算収支の状況,1,令和4年度,128004,124253,3751,0,3751,-748,0,0,0,-748
2022,61,298514,奈良県,奈良県後期高齢者医療広域連合,7,2,決算収支の状況,1,令和4年度,401300,375746,25554,0,25554,-19030,270705,0,0,251675
2022,61,298522,奈良県,やまと広域環境衛生事務組合,6,2,決算収支の状況,1,令和4年度,1008286,990149,18137,18137,0,0,104070,0,88104,15966
2022,61,298549,奈良県,奈良県広域消防組合,6,2,決算収支の状況,1,令和4年度,14719274,14003508,715766,8387,707379,-147329,101849,0,135118,-180598
2022,61,298557,奈良県,山辺・県北西部広域環境衛生組合,6,2,決算収支の状況,1,令和4年度,805741,774392,31349,0,31349,2549,1,0,0,2550
2022,61,298565,奈良県,さくら広域環境衛生組合,6,2,決算収支の状況,1,令和4年度,2467012,2401070,65942,0,65942,-62986,0,0,0,-62986
2022,61,298573,奈良県,まほろば環境衛生組合,6,2,決算収支の状況,1,令和4年度,495773,485061,10712,2970,7742,-5481,6975,0,0,1494
2022,61,302015,和歌山県,和歌山市,8,2,決算収支の状況,1,令和4年度,166962820,165044024,1918796,362377,1556419,-862427,3186824,100,0,2324497
2022,61,302023,和歌山県,海南市,4,2,決算収支の状況,1,令和4年度,26918329,26089863,828466,177272,651194,-110903,7715,0,0,-103188
2022,61,302031,和歌山県,橋本市,4,2,決算収支の状況,1,令和4年度,30416414,29394881,1021533,97168,924365,-421580,2815,15376,0,-403389
2022,61,302040,和歌山県,有田市,4,2,決算収支の状況,1,令和4年度,26369033,25652518,716515,17469,699046,241967,191,0,0,242158
2022,61,302058,和歌山県,御坊市,4,2,決算収支の状況,1,令和4年度,17878652,16590903,1287749,24956,1262793,231091,751050,0,0,982141
2022,61,302066,和歌山県,田辺市,4,2,決算収支の状況,1,令和4年度,46825370,44091563,2733807,626859,2106948,-222186,296,8026,0,-213864
2022,61,302074,和歌山県,新宮市,4,2,決算収支の状況,1,令和4年度,20632797,19060712,1572085,33884,1538201,15230,200000,722426,0,937656
2022,61,302082,和歌山県,紀の川市,4,2,決算収支の状況,1,令和4年度,33433239,31893017,1540222,495443,1044779,-71053,557563,0,0,486510
2022,61,302091,和歌山県,岩出市,4,2,決算収支の状況,1,令和4年度,20605830,19908046,697784,194730,503054,976,431112,159047,337222,253913
2022,61,303046,和歌山県,紀美野町,5,2,決算収支の状況,1,令和4年度,8967205,8420769,546436,149402,397034,-317133,357372,320500,386081,-25342
2022,61,303411,和歌山県,かつらぎ町,5,2,決算収支の状況,1,令和4年度,11230273,10589676,640597,309048,331549,-44515,188444,0,117500,26429
2022,61,303437,和歌山県,九度山町,5,2,決算収支の状況,1,令和4年度,4285217,4114561,170656,22833,147823,69317,55,0,0,69372
2022,61,303445,和歌山県,高野町,5,2,決算収支の状況,1,令和4年度,5740564,5523590,216974,25517,191457,64422,12320,0,16365,60377
2022,61,303615,和歌山県,湯浅町,5,2,決算収支の状況,1,令和4年度,11872148,11445509,426639,77755,348884,-112084,242125,0,0,130041
2022,61,303623,和歌山県,広川町,5,2,決算収支の状況,1,令和4年度,5564344,5373275,191069,53838,137231,47113,2628,0,0,49741
2022,61,303666,和歌山県,有田川町,5,2,決算収支の状況,1,令和4年度,17157124,16551124,606000,229010,376990,-95451,4532,3611,0,-87308
2022,61,303810,和歌山県,美浜町,5,2,決算収支の状況,1,令和4年度,5550187,5347508,202679,27133,175546,-160770,482227,0,180000,141457
2022,61,303828,和歌山県,日高町,5,2,決算収支の状況,1,令和4年度,5271788,4882958,388830,15192,373638,-5121,77686,0,174681,-102116
2022,61,303836,和歌山県,由良町,5,2,決算収支の状況,1,令和4年度,4508528,4307190,201338,8519,192819,-99490,82056,0,0,-17434
2022,61,303909,和歌山県,印南町,5,2,決算収支の状況,1,令和4年度,7046240,6823069,223171,39996,183175,-20214,109465,0,0,89251
2022,61,303917,和歌山県,みなべ町,5,2,決算収支の状況,1,令和4年度,9956971,8892605,1064366,196812,867554,-140863,324,0,0,-140539
2022,61,303925,和歌山県,日高川町,5,2,決算収支の状況,1,令和4年度,9911790,9665350,246440,32940,213500,-22574,9898,0,15000,-27676
2022,61,304018,和歌山県,白浜町,5,2,決算収支の状況,1,令和4年度,13841656,13201021,640635,51423,589212,118013,240917,0,0,358930
2022,61,304042,和歌山県,上富田町,5,2,決算収支の状況,1,令和4年度,7740587,7542262,198325,11410,186915,-143720,625,0,0,-143095
2022,61,304069,和歌山県,すさみ町,5,2,決算収支の状況,1,令和4年度,4846226,4744471,101755,2770,98985,-9276,90000,0,0,80724
2022,61,304212,和歌山県,那智勝浦町,5,2,決算収支の状況,1,令和4年度,10302896,10088680,214216,34649,179567,-13085,210113,0,0,197028
2022,61,304221,和歌山県,太地町,5,2,決算収支の状況,1,令和4年度,4232340,4084455,147885,17509,130376,-709,200000,0,200000,-709
2022,61,304247,和歌山県,古座川町,5,2,決算収支の状況,1,令和4年度,3914605,3449890,464715,57815,406900,-143076,473,0,0,-142603
2022,61,304271,和歌山県,北山村,5,2,決算収支の状況,1,令和4年度,2794517,2672820,121697,24765,96932,45373,73007,0,0,118380
2022,61,304280,和歌山県,串本町,5,2,決算収支の状況,1,令和4年度,12220704,11895206,325498,94141,231357,-188037,243120,0,145932,-90849
2022,61,308013,和歌山県,和歌山県市町村総合事務組合,6,2,決算収支の状況,1,令和4年度,5965648,5265683,699965,0,699965,162145,0,0,500,161645
2022,61,308072,和歌山県,那賀児童福祉施設組合,6,2,決算収支の状況,1,令和4年度,72865,71384,1481,0,1481,-308,0,0,0,-308
2022,61,308102,和歌山県,那賀広域事務組合,6,2,決算収支の状況,1,令和4年度,9395,8483,912,0,912,145,0,0,0,145
2022,61,308111,和歌山県,那賀衛生環境整備組合,6,2,決算収支の状況,1,令和4年度,326317,320071,6246,0,6246,1914,0,0,0,1914
2022,61,308137,和歌山県,橋本伊都衛生施設組合,6,2,決算収支の状況,1,令和4年度,183874,183318,556,0,556,-2069,1,0,0,-2068
2022,61,308145,和歌山県,伊都郡町村及び橋本市老人福祉施設事務組合,6,2,決算収支の状況,1,令和4年度,779959,746182,33777,0,33777,4287,15000,0,0,19287
2022,61,308161,和歌山県,有田衛生施設事務組合,6,2,決算収支の状況,1,令和4年度,610867,555957,54910,0,54910,-976,0,0,0,-976
2022,61,308170,和歌山県,有田聖苑事務組合,6,2,決算収支の状況,1,令和4年度,74680,68206,6474,0,6474,-13,0,0,0,-13
2022,61,308251,和歌山県,御坊市日高川町中学校組合,6,2,決算収支の状況,1,令和4年度,82972,77967,5005,375,4630,-3399,0,0,0,-3399
2022,61,308293,和歌山県,御坊日高老人福祉施設事務組合,6,2,決算収支の状況,1,令和4年度,462312,448255,14057,0,14057,-1500,0,0,43918,-45418
2022,61,308412,和歌山県,紀南地方老人福祉施設組合,6,2,決算収支の状況,1,令和4年度,374955,337481,37474,0,37474,15613,365,0,2856,13122
2022,61,308447,和歌山県,富田川治水組合,6,2,決算収支の状況,1,令和4年度,12053,10917,1136,0,1136,-847,0,0,0,-847
2022,61,308455,和歌山県,串本町古座川町衛生施設事務組合,6,2,決算収支の状況,1,令和4年度,495125,487686,7439,0,7439,-865,0,0,0,-865
2022,61,308463,和歌山県,大辺路衛生施設組合,6,2,決算収支の状況,1,令和4年度,101910,99764,2146,0,2146,879,0,0,0,879
2022,61,308480,和歌山県,紀南学園事務組合,6,2,決算収支の状況,1,令和4年度,349863,346685,3178,0,3178,711,27575,0,67395,-39109
2022,61,308501,和歌山県,紀南環境衛生施設事務組合,6,2,決算収支の状況,1,令和4年度,262226,241868,20358,0,20358,6943,32,0,0,6975
2022,61,308510,和歌山県,東牟婁郡町村新宮市老人福祉施設事務組合,6,2,決算収支の状況,1,令和4年度,104228,102790,1438,0,1438,1207,0,0,5000,-3793
2022,61,308561,和歌山県,那智勝浦町太地町環境衛生施設一部事務組合,6,2,決算収支の状況,1,令和4年度,114975,114975,0,0,0,0,0,0,0,0
2022,61,308617,和歌山県,紀南地方児童福祉施設組合,6,2,決算収支の状況,1,令和4年度,49387,42779,6608,0,6608,-2138,7526,0,0,5388
2022,61,308633,和歌山県,新宮周辺広域市町村圏事務組合,6,2,決算収支の状況,1,令和4年度,7254,6516,738,0,738,-260,0,0,0,-260
2022,61,308641,和歌山県,御坊広域行政事務組合,6,2,決算収支の状況,1,令和4年度,2575314,2451828,123486,0,123486,-19307,0,0,0,-19307
2022,61,308668,和歌山県,田辺周辺広域市町村圏組合,6,2,決算収支の状況,1,令和4年度,146417,109316,37101,0,37101,13875,0,0,0,13875
2022,61,308684,和歌山県,上大中清掃施設組合,6,2,決算収支の状況,1,令和4年度,129479,126846,2633,0,2633,-8766,0,0,0,-8766
2022,61,308722,和歌山県,有田郡老人福祉施設事務組合,6,2,決算収支の状況,1,令和4年度,261975,257136,4839,0,4839,-2660,0,0,7800,-10460
2022,61,308773,和歌山県,那賀消防組合,6,2,決算収支の状況,1,令和4年度,1390247,1378412,11835,0,11835,-30137,0,0,0,-30137
2022,61,308781,和歌山県,那賀休日急患診療所経営事務組合,6,2,決算収支の状況,1,令和4年度,30273,29147,1126,0,1126,-1247,0,0,0,-1247
2022,61,308803,和歌山県,有田周辺広域圏事務組合,6,2,決算収支の状況,1,令和4年度,2774031,2728672,45359,0,45359,-32784,62876,0,0,30092
2022,61,308811,和歌山県,田辺市周辺衛生施設組合,6,2,決算収支の状況,1,令和4年度,284659,273287,11372,0,11372,-4127,0,0,0,-4127
2022,61,308838,和歌山県,伊都郡町村及び橋本市児童福祉施設事務組合,6,2,決算収支の状況,1,令和4年度,56062,50189,5873,0,5873,2236,1,0,3000,-763
2022,61,308846,和歌山県,富田川衛生施設組合,6,2,決算収支の状況,1,令和4年度,234831,222827,12004,0,12004,2724,0,0,0,2724
2022,61,308862,和歌山県,海南海草環境衛生施設組合,6,2,決算収支の状況,1,令和4年度,1573036,1538219,34817,0,34817,-33630,0,0,0,-33630
2022,61,308871,和歌山県,伊都消防組合,6,2,決算収支の状況,1,令和4年度,555624,552204,3420,0,3420,-13757,0,0,0,-13757
2022,61,308889,和歌山県,湯浅広川消防組合,6,2,決算収支の状況,1,令和4年度,475694,460041,15653,0,15653,3712,0,0,0,3712
2022,61,308897,和歌山県,五色台広域施設組合,6,2,決算収支の状況,1,令和4年度,207215,197209,10006,0,10006,2774,0,0,0,2774
2022,61,308901,和歌山県,日高広域消防事務組合,6,2,決算収支の状況,1,令和4年度,925243,910892,14351,0,14351,-5715,19664,0,18658,-4709
2022,61,308935,和歌山県,橋本周辺広域市町村圏組合,6,2,決算収支の状況,1,令和4年度,1472923,1328162,144761,0,144761,14931,1086,0,31827,-15810
2022,61,308943,和歌山県,和歌山地方税回収機構,6,2,決算収支の状況,1,令和4年度,123803,113036,10767,0,10767,-4730,0,0,0,-4730
2022,61,308951,和歌山県,和歌山県後期高齢者医療広域連合,7,2,決算収支の状況,1,令和4年度,116294,109845,6449,0,6449,-2824,9276,0,14473,-8021
2022,61,308960,和歌山県,和歌山県住宅新築資金等貸付金回収管理組合,6,2,決算収支の状況,1,令和4年度,219850,207898,11952,0,11952,-6617,13105,0,13832,-7344
2022,61,308978,和歌山県,紀の海広域施設組合,6,2,決算収支の状況,1,令和4年度,848665,830361,18304,0,18304,1120,0,0,0,1120
2022,61,308986,和歌山県,紀南環境広域施設組合,6,2,決算収支の状況,1,令和4年度,186791,175483,11308,2990,8318,90,0,0,0,90
2022,61,312011,鳥取県,鳥取市,8,2,決算収支の状況,1,令和4年度,115319398,112370924,2948474,260485,2687989,-378904,236589,0,0,-142315
2022,61,312029,鳥取県,米子市,3,2,決算収支の状況,1,令和4年度,79703899,78149140,1554759,402944,1151815,-429354,389841,0,30025,-69538
2022,61,312037,鳥取県,倉吉市,4,2,決算収支の状況,1,令和4年度,32257636,31093008,1164628,274367,890261,-69918,480127,0,0,410209
2022,61,312045,鳥取県,境港市,4,2,決算収支の状況,1,令和4年度,20333414,19665830,667584,147075,520509,30027,0,1737,0,31764
2022,61,313025,鳥取県,岩美町,5,2,決算収支の状況,1,令和4年度,7459139,7307720,151419,23005,128414,-26526,42445,0,0,15919
2022,61,313254,鳥取県,若桜町,5,2,決算収支の状況,1,令和4年度,4020880,3717837,303043,29145,273898,49724,58000,40,0,107764
2022,61,313289,鳥取県,智頭町,5,2,決算収支の状況,1,令和4年度,6853984,6640856,213128,79510,133618,1636,171394,0,0,173030
2022,61,313297,鳥取県,八頭町,5,2,決算収支の状況,1,令和4年度,13034405,12031255,1003150,41556,961594,-20831,2510,0,0,-18321
2022,61,313645,鳥取県,三朝町,5,2,決算収支の状況,1,令和4年度,6684884,6559422,125462,17489,107973,55371,58752,0,0,114123
2022,61,313700,鳥取県,湯梨浜町,5,2,決算収支の状況,1,令和4年度,11005142,10622814,382328,59616,322712,15931,82,229141,0,245154
2022,61,313718,鳥取県,琴浦町,5,2,決算収支の状況,1,令和4年度,12744188,12029259,714929,116613,598316,141519,265968,132204,343000,196691
2022,61,313726,鳥取県,北栄町,5,2,決算収支の状況,1,令和4年度,11552111,11124173,427938,140537,287401,-90389,486769,0,0,396380
2022,61,313840,鳥取県,日吉津村,5,2,決算収支の状況,1,令和4年度,3435100,3324022,111078,13329,97749,-18391,3000,0,0,-15391
2022,61,313866,鳥取県,大山町,5,2,決算収支の状況,1,令和4年度,12436753,11727637,709116,209460,499656,49248,64858,0,0,114106
2022,61,313891,鳥取県,南部町,5,2,決算収支の状況,1,令和4年度,8009820,7714321,295499,33168,262331,-103339,601,62400,0,-40338
2022,61,313904,鳥取県,伯耆町,5,2,決算収支の状況,1,令和4年度,8466936,7884099,582837,91784,491053,169653,150,0,0,169803
2022,61,314013,鳥取県,日南町,5,2,決算収支の状況,1,令和4年度,7475042,7156686,318356,49819,268537,47256,91549,0,0,138805
2022,61,314021,鳥取県,日野町,5,2,決算収支の状況,1,令和4年度,4845965,4650517,195448,13543,181905,64022,16482,0,0,80504
2022,61,314030,鳥取県,江府町,5,2,決算収支の状況,1,令和4年度,4856846,4542698,314148,29395,284753,-155895,248,0,0,-155647
2022,61,318051,鳥取県,米子市日吉津村中学校組合,6,2,決算収支の状況,1,令和4年度,104171,103283,888,675,213,-1474,0,0,0,-1474
2022,61,318086,鳥取県,鳥取県町村総合事務組合,6,2,決算収支の状況,1,令和4年度,1681660,1595951,85709,0,85709,65432,1080,0,0,66512
2022,61,318124,鳥取県,日野町江府町日南町衛生施設組合,6,2,決算収支の状況,1,令和4年度,194445,176399,18046,0,18046,2194,0,0,0,2194
2022,61,318213,鳥取県,境港管理組合,6,2,決算収支の状況,1,令和4年度,2860497,2779165,81332,0,81332,-118168,0,0,0,-118168
2022,61,318256,鳥取県,南部町・伯耆町清掃施設管理組合,6,2,決算収支の状況,1,令和4年度,217960,212276,5684,0,5684,-4288,0,0,0,-4288
2022,61,318272,鳥取県,鳥取県東部広域行政管理組合,6,2,決算収支の状況,1,令和4年度,7221633,7112738,108895,0,108895,43006,0,0,0,43006
2022,61,318299,鳥取県,鳥取県西部広域行政管理組合,6,2,決算収支の状況,1,令和4年度,5068885,4997083,71802,4163,67639,31438,18111,0,61789,-12240
2022,61,318337,鳥取県,玉井斎場管理組合,6,2,決算収支の状況,1,令和4年度,121420,108921,12499,0,12499,2795,0,0,0,2795
2022,61,318353,鳥取県,鳥取中部ふるさと広域連合（普通会計分）,6,2,決算収支の状況,1,令和4年度,2814866,2811848,3018,0,3018,-2584,2374,0,0,-210
2022,61,318361,鳥取県,鳥取中部ふるさと広域連合（事業会計分）,7,2,決算収支の状況,1,令和4年度,0,0,0,0,0,0,0,0,0,0
2022,61,318370,鳥取県,南部箕蚊屋広域連合,6,2,決算収支の状況,1,令和4年度,541329,538373,2956,0,2956,-1837,0,0,0,-1837
2022,61,318388,鳥取県,鳥取県後期高齢者医療広域連合,7,2,決算収支の状況,1,令和4年度,103068,102221,847,0,847,-891,0,0,0,-891
2022,61,322016,島根県,松江市,8,2,決算収支の状況,1,令和4年度,115101694,111693641,3408053,583193,2824860,279815,1573549,204590,1000000,1057954
2022,61,322024,島根県,浜田市,4,2,決算収支の状況,1,令和4年度,42103833,40703785,1400048,295044,1105004,19230,555613,832516,0,1407359
2022,61,322032,島根県,出雲市,3,2,決算収支の状況,1,令和4年度,88646252,85922704,2723548,1201522,1522026,-35083,246472,0,249231,-37842
2022,61,322041,島根県,益田市,4,2,決算収支の状況,1,令和4年度,32426671,31133165,1293506,113230,1180276,-580995,541963,47327,0,8295
2022,61,322059,島根県,大田市,4,2,決算収支の状況,1,令和4年度,25806707,25135098,671609,84874,586735,-240728,0,0,0,-240728
2022,61,322067,島根県,安来市,4,2,決算収支の状況,1,令和4年度,27377253,26567505,809748,75668,734080,-187090,300182,237600,0,350692
2022,61,322075,島根県,江津市,4,2,決算収支の状況,1,令和4年度,17991132,17013889,977243,134605,842638,216242,5,33128,0,249375
2022,61,322091,島根県,雲南市,4,2,決算収支の状況,1,令和4年度,32646211,31633169,1013042,395357,617685,162981,5,522350,0,685336
2022,61,323438,島根県,奥出雲町,5,2,決算収支の状況,1,令和4年度,15532862,15187698,345164,196498,148666,26988,30,331877,0,358895
2022,61,323861,島根県,飯南町,5,2,決算収支の状況,1,令和4年度,8560813,8303930,256883,158247,98636,-84789,0,252943,0,168154
2022,61,324418,島根県,川本町,5,2,決算収支の状況,1,令和4年度,4781658,4653779,127879,46824,81055,19080,2244,0,0,21324
2022,61,324485,島根県,美郷町,5,2,決算収支の状況,1,令和4年度,6823074,6626011,197063,14036,183027,-5109,10,0,0,-5099
2022,61,324493,島根県,邑南町,5,2,決算収支の状況,1,令和4年度,14248069,13872841,375228,56834,318394,105984,186525,0,0,292509
2022,61,325015,島根県,津和野町,5,2,決算収支の状況,1,令和4年度,10349418,10169969,179449,87910,91539,-30803,55025,63400,0,87622
2022,61,325058,島根県,吉賀町,5,2,決算収支の状況,1,令和4年度,7489021,7197653,291368,60943,230425,-29667,415,0,0,-29252
2022,61,325252,島根県,海士町,5,2,決算収支の状況,1,令和4年度,6596177,6458137,138040,11279,126761,-244412,3,242606,0,-1803
2022,61,325261,島根県,西ノ島町,5,2,決算収支の状況,1,令和4年度,6047240,5758378,288862,34047,254815,106892,42342,64450,0,213684
2022,61,325279,島根県,知夫村,5,2,決算収支の状況,1,令和4年度,2079065,2005747,73318,8705,64613,-47710,105141,0,17000,40431
2022,61,325287,島根県,隠岐の島町,5,2,決算収支の状況,1,令和4年度,18887286,18559577,327709,149329,178380,-72990,27,0,22071,-95034
2022,61,328413,島根県,鹿足郡事務組合,6,2,決算収支の状況,1,令和4年度,402939,395375,7564,0,7564,-16621,0,0,0,-16621
2022,61,328421,島根県,鹿足郡養護老人ホーム組合,6,2,決算収支の状況,1,令和4年度,182786,182724,62,0,62,15,7,0,2700,-2678
2022,61,328456,島根県,島前町村組合（普通会計分）,6,2,決算収支の状況,1,令和4年度,783287,758993,24294,0,24294,-29,0,0,0,-29
2022,61,328529,島根県,益田地区広域市町村圏事務組合,6,2,決算収支の状況,1,令和4年度,1999420,1937056,62364,0,62364,1866,0,0,0,1866
2022,61,328553,島根県,江津邑智消防組合,6,2,決算収支の状況,1,令和4年度,1284037,1271057,12980,0,12980,-9,12988,0,10000,2979
2022,61,328740,島根県,鹿足郡不燃物処理組合,6,2,決算収支の状況,1,令和4年度,101901,82244,19657,0,19657,5361,0,0,0,5361
2022,61,328766,島根県,雲南市・飯南町事務組合,6,2,決算収支の状況,1,令和4年度,2362101,2250750,111351,0,111351,-7001,0,0,0,-7001
2022,61,328847,島根県,島根県市町村総合事務組合,6,2,決算収支の状況,1,令和4年度,4846071,4807271,38800,22578,16222,-4362,4293,0,0,-69
2022,61,328880,島根県,邑智郡総合事務組合,6,2,決算収支の状況,1,令和4年度,3268871,3207572,61299,25702,35597,2117,0,0,0,2117
2022,61,328910,島根県,浜田地区広域行政組合,6,2,決算収支の状況,1,令和4年度,981528,954098,27430,0,27430,5116,0,0,0,5116
2022,61,328936,島根県,雲南広域連合（普通会計分）,6,2,決算収支の状況,1,令和4年度,1489920,1471632,18288,0,18288,1834,1,0,0,1835
2022,61,328944,島根県,隠岐広域連合（普通会計分）,6,2,決算収支の状況,1,令和4年度,1115891,1092339,23552,10670,12882,1324,3,0,0,1327
2022,61,328961,島根県,島根県後期高齢者医療広域連合,7,2,決算収支の状況,1,令和4年度,310086,279751,30335,0,30335,-2435,0,0,0,-2435
2022,61,331007,岡山県,岡山市,1,2,決算収支の状況,1,令和4年度,391046068,375817774,15228294,5665142,9563152,-3820645,4105,3000000,5000000,-5816540
2022,61,332020,岡山県,倉敷市,8,2,決算収支の状況,1,令和4年度,226445818,215286796,11159022,2228313,8930709,-484822,4805639,750000,5000000,70817
2022,61,332038,岡山県,津山市,4,2,決算収支の状況,1,令和4年度,52247762,50302264,1945498,86978,1858520,-146253,3067,0,1500000,-1643186
2022,61,332046,岡山県,玉野市,4,2,決算収支の状況,1,令和4年度,29080225,26604532,2475693,58187,2417506,423940,1000415,98142,0,1522497
2022,61,332054,岡山県,笠岡市,4,2,決算収支の状況,1,令和4年度,25628587,24860587,768000,122536,645464,-168719,1952,21618,137818,-282967
2022,61,332071,岡山県,井原市,4,2,決算収支の状況,1,令和4年度,25431493,24498896,932597,123811,808786,-378613,1167403,0,0,788790
2022,61,332089,岡山県,総社市,4,2,決算収支の状況,1,令和4年度,34579556,33322405,1257151,108275,1148876,-727499,1380088,0,0,652589
2022,61,332097,岡山県,高梁市,4,2,決算収支の状況,1,令和4年度,26639598,25724396,915202,168438,746764,-112429,372290,0,163000,96861
2022,61,332101,岡山県,新見市,4,2,決算収支の状況,1,令和4年度,28541448,26751957,1789491,291104,1498387,-81289,1743,548104,616935,-148377
2022,61,332119,岡山県,備前市,4,2,決算収支の状況,1,令和4年度,22594262,21217098,1377164,587357,789807,-88631,371825,34478,0,317672
2022,61,332127,岡山県,瀬戸内市,4,2,決算収支の状況,1,令和4年度,25669465,24908517,760948,116401,644547,-1291,331647,609456,430000,509812
2022,61,332135,岡山県,赤磐市,4,2,決算収支の状況,1,令和4年度,21935938,20525812,1410126,155553,1254573,-85121,4583,0,673136,-753674
2022,61,332143,岡山県,真庭市,4,2,決算収支の状況,1,令和4年度,35484986,33516731,1968255,338570,1629685,184727,33525,764782,36000,947034
2022,61,332151,岡山県,美作市,4,2,決算収支の状況,1,令和4年度,24258298,22652676,1605622,50615,1555007,-84991,68231,288438,0,271678
2022,61,332160,岡山県,浅口市,4,2,決算収支の状況,1,令和4年度,16365123,14897142,1467981,61105,1406876,140720,17676,0,708024,-549628
2022,61,333468,岡山県,和気町,5,2,決算収支の状況,1,令和4年度,9485624,8623047,862577,79699,782878,-94348,65977,0,0,-28371
2022,61,334235,岡山県,早島町,5,2,決算収支の状況,1,令和4年度,6216058,5916025,300033,38264,261769,70474,95682,0,0,166156
2022,61,334456,岡山県,里庄町,5,2,決算収支の状況,1,令和4年度,6123746,5607036,516710,50389,466321,83415,247620,0,91801,239234
2022,61,334618,岡山県,矢掛町,5,2,決算収支の状況,1,令和4年度,9849537,9356682,492855,79853,413002,-3884,29096,280000,130000,175212
2022,61,335860,岡山県,新庄村,5,2,決算収支の状況,1,令和4年度,2477787,2307776,170011,873,169138,64709,620,0,0,65329
2022,61,336068,岡山県,鏡野町,5,2,決算収支の状況,1,令和4年度,12618071,12022761,595310,59216,536094,-107655,21401,0,100000,-186254
2022,61,336220,岡山県,勝央町,5,2,決算収支の状況,1,令和4年度,6890988,6395773,495215,67406,427809,11147,125546,0,90000,46693
2022,61,336238,岡山県,奈義町,5,2,決算収支の状況,1,令和4年度,6779794,6240837,538957,27539,511418,92561,3546,285908,134652,247363
2022,61,336432,岡山県,西粟倉村,5,2,決算収支の状況,1,令和4年度,3736487,3483938,252549,83251,169298,-5189,100731,0,0,95542
2022,61,336637,岡山県,久米南町,5,2,決算収支の状況,1,令和4年度,4560137,4295636,264501,4723,259778,-61440,98129,0,0,36689
2022,61,336661,岡山県,美咲町,5,2,決算収支の状況,1,令和4年度,14287977,13876932,411045,391,410654,-74166,103,478300,240000,164237
2022,61,336815,岡山県,吉備中央町,5,2,決算収支の状況,1,令和4年度,11664468,11243575,420893,46941,373952,-377293,529281,0,200000,-48012
2022,61,338028,岡山県,八ヶ郷合同用水組合,6,2,決算収支の状況,1,令和4年度,33884,28633,5251,0,5251,527,0,0,0,527
2022,61,338036,岡山県,高梁川東西用水組合,6,2,決算収支の状況,1,令和4年度,33210,29947,3263,0,3263,1030,6,0,9252,-8216
2022,61,338052,岡山県,旭東用排水組合,6,2,決算収支の状況,1,令和4年度,59708,55348,4360,0,4360,747,0,0,0,747
2022,61,338141,岡山県,湛井十二箇郷組合,6,2,決算収支の状況,1,令和4年度,28651,15795,12856,0,12856,1589,0,0,0,1589
2022,61,338168,岡山県,大正池水利組合,6,2,決算収支の状況,1,令和4年度,6961,1096,5865,4708,1157,-1665,0,0,0,-1665
2022,61,338176,岡山県,田原用水組合,6,2,決算収支の状況,1,令和4年度,22672,13023,9649,0,9649,1561,0,0,0,1561
2022,61,338184,岡山県,六ヶ郷組合,6,2,決算収支の状況,1,令和4年度,9323,5206,4117,0,4117,2191,0,0,0,2191
2022,61,338192,岡山県,四ヶ郷組合,6,2,決算収支の状況,1,令和4年度,1910,912,998,0,998,293,0,0,0,293
2022,61,338206,岡山県,西一郷半組合,6,2,決算収支の状況,1,令和4年度,2097,636,1461,0,1461,140,0,0,0,140
2022,61,338214,岡山県,三ヶ村組合,6,2,決算収支の状況,1,令和4年度,1608,591,1017,0,1017,629,0,0,0,629
2022,61,338290,岡山県,岡山県笠岡市矢掛町中学校組合,6,2,決算収支の状況,1,令和4年度,57015,55770,1245,0,1245,559,0,0,0,559
2022,61,338460,岡山県,神崎衛生施設組合,6,2,決算収支の状況,1,令和4年度,252328,236996,15332,780,14552,606,0,0,0,606
2022,61,338478,岡山県,備南衛生施設組合,6,2,決算収支の状況,1,令和4年度,220109,184068,36041,10063,25978,-19888,0,0,0,-19888
2022,61,338494,岡山県,勝英衛生施設組合,6,2,決算収支の状況,1,令和4年度,110312,88439,21873,0,21873,1581,5000,0,0,6581
2022,61,338508,岡山県,岡山県西部衛生施設組合,6,2,決算収支の状況,1,令和4年度,1099311,1070958,28353,0,28353,12703,0,0,0,12703
2022,61,338516,岡山県,旭川中部衛生施設組合,6,2,決算収支の状況,1,令和4年度,104896,100711,4185,0,4185,-133,0,0,0,-133
2022,61,338524,岡山県,和気・赤磐し尿処理施設一部事務組合,6,2,決算収支の状況,1,令和4年度,221517,209112,12405,0,12405,-15594,0,0,0,-15594
2022,61,338559,岡山県,岡山県西部環境整備施設組合,6,2,決算収支の状況,1,令和4年度,613307,583475,29832,2200,27632,-7337,0,0,0,-7337
2022,61,338567,岡山県,和気北部衛生施設組合,6,2,決算収支の状況,1,令和4年度,39443,35063,4380,0,4380,-4018,0,0,0,-4018
2022,61,338591,岡山県,倉敷西部清掃施設組合,6,2,決算収支の状況,1,令和4年度,753059,660489,92570,0,92570,11664,0,0,0,11664
2022,61,338800,岡山県,和気老人ホーム組合,6,2,決算収支の状況,1,令和4年度,124542,117811,6731,0,6731,-1097,1,0,1601,-2697
2022,61,338869,岡山県,岡山県市町村税整理組合,6,2,決算収支の状況,1,令和4年度,92344,74991,17353,0,17353,-4513,16866,0,19861,-7508
2022,61,338958,岡山県,岡山市久米南町衛生施設組合,6,2,決算収支の状況,1,令和4年度,188651,156388,32263,6820,25443,4877,0,0,0,4877
2022,61,338966,岡山県,岡山県中部環境施設組合,6,2,決算収支の状況,1,令和4年度,325764,287562,38202,0,38202,4655,0,0,0,4655
2022,61,338974,岡山県,岡山県井原地区清掃施設組合,6,2,決算収支の状況,1,令和4年度,467310,452135,15175,0,15175,5216,0,0,0,5216
2022,61,338982,岡山県,津山圏域衛生処理組合,6,2,決算収支の状況,1,令和4年度,604760,557584,47176,1500,45676,-12990,0,0,0,-12990
2022,61,339083,岡山県,笠岡地区消防組合,6,2,決算収支の状況,1,令和4年度,1415671,1408528,7143,0,7143,-509,0,0,0,-509
2022,61,339121,岡山県,久米老人ホーム組合,6,2,決算収支の状況,1,令和4年度,178027,172740,5287,0,5287,59,1965,0,16629,-14605
2022,61,339130,岡山県,総社広域環境施設組合,6,2,決算収支の状況,1,令和4年度,3268576,3167889,100687,0,100687,2869,0,0,0,2869
2022,61,339156,岡山県,井原地区消防組合,6,2,決算収支の状況,1,令和4年度,990498,961381,29117,0,29117,7760,0,0,0,7760
2022,61,339164,岡山県,津山圏域消防組合,6,2,決算収支の状況,1,令和4年度,2635535,2514706,120829,0,120829,1368,0,0,0,1368
2022,61,339172,岡山県,勝田郡老人福祉施設組合,6,2,決算収支の状況,1,令和4年度,33047,27752,5295,0,5295,1020,0,0,0,1020
2022,61,339199,岡山県,東備消防組合,6,2,決算収支の状況,1,令和4年度,1000219,920393,79826,0,79826,-17136,0,0,0,-17136
2022,61,339202,岡山県,岡山県西部地区養護老人ホーム組合,6,2,決算収支の状況,1,令和4年度,119536,116479,3057,0,3057,176,0,0,0,176
2022,61,339253,岡山県,備南競艇事業組合,7,2,決算収支の状況,1,令和4年度,0,0,0,0,0,0,0,0,0,0
2022,61,339270,岡山県,柵原、吉井、英田火葬場施設組合,6,2,決算収支の状況,1,令和4年度,16317,12613,3704,0,3704,1568,0,0,0,1568
2022,61,339326,岡山県,柵原吉井特別養護老人ホーム組合,6,2,決算収支の状況,1,令和4年度,118601,89401,29200,0,29200,-3017,0,0,0,-3017
2022,61,339385,岡山県,津山広域事務組合,6,2,決算収支の状況,1,令和4年度,51271,36520,14751,0,14751,1075,0,0,0,1075
2022,61,339466,岡山県,高梁地域事務組合（普通会計）,6,2,決算収支の状況,1,令和4年度,658194,627969,30225,5390,24835,15593,0,0,0,15593
2022,61,339555,岡山県,岡山県市町村総合事務組合,6,2,決算収支の状況,1,令和4年度,7040018,6465711,574307,0,574307,120260,3338,0,6500,117098
2022,61,339571,岡山県,岡山県後期高齢者医療広域連合,7,2,決算収支の状況,1,令和4年度,318283,315147,3136,0,3136,-386,229268,0,0,228882
2022,61,339598,岡山県,津山圏域資源循環施設組合,6,2,決算収支の状況,1,令和4年度,1846864,1650623,196241,0,196241,136101,0,0,0,136101
2022,61,341002,広島県,広島市,1,2,決算収支の状況,1,令和4年度,710147785,705188318,4959467,2007473,2951994,-3267,946240,0,2567514,-1624541
2022,61,342025,広島県,呉市,8,2,決算収支の状況,1,令和4年度,112300779,108836845,3463934,827823,2636111,-1834525,2238418,0,0,403893
2022,61,342033,広島県,竹原市,4,2,決算収支の状況,1,令和4年度,14335968,13733453,602515,88480,514035,-298222,225751,0,0,-72471
2022,61,342041,広島県,三原市,4,2,決算収支の状況,1,令和4年度,54241529,52500075,1741454,489895,1251559,-1210441,803870,669339,0,262768
2022,61,342050,広島県,尾道市,3,2,決算収支の状況,1,令和4年度,65523362,64487530,1035832,630990,404842,-527759,470117,0,400000,-457642
2022,61,342076,広島県,福山市,8,2,決算収支の状況,1,令和4年度,222295714,213823764,8471950,3950260,4521690,-657655,2762040,1017220,2995332,126273
2022,61,342084,広島県,府中市,4,2,決算収支の状況,1,令和4年度,22652618,21738146,914472,313361,601111,-184535,1060,0,600000,-783475
2022,61,342092,広島県,三次市,4,2,決算収支の状況,1,令和4年度,40990555,39400236,1590319,521462,1068857,-241664,122975,788111,0,669422
2022,61,342106,広島県,庄原市,4,2,決算収支の状況,1,令和4年度,34370671,33358062,1012609,178479,834130,-410203,55,4410,0,-405738
2022,61,342114,広島県,大竹市,4,2,決算収支の状況,1,令和4年度,17396171,16635373,760798,641830,118968,-300743,2445,0,0,-298298
2022,61,342122,広島県,東広島市,3,2,決算収支の状況,1,令和4年度,104379466,101481145,2898321,2536803,361518,-2080735,508819,0,0,-1571916
2022,61,342131,広島県,廿日市市,3,2,決算収支の状況,1,令和4年度,60728906,59798756,930150,727917,202233,-717577,9401,0,200000,-908176
2022,61,342149,広島県,安芸高田市,4,2,決算収支の状況,1,令和4年度,21371425,20438072,933353,204056,729297,-199737,122,11081,254404,-442938
2022,61,342157,広島県,江田島市,4,2,決算収支の状況,1,令和4年度,15882960,15349764,533196,192095,341101,13015,170246,0,0,183261
2022,61,343021,広島県,府中町,5,2,決算収支の状況,1,令和4年度,18780049,18383624,396425,45758,350667,56688,150700,0,0,207388
2022,61,343048,広島県,海田町,5,2,決算収支の状況,1,令和4年度,14799654,13957021,842633,228205,614428,96574,1159,253033,277887,72879
2022,61,343072,広島県,熊野町,5,2,決算収支の状況,1,令和4年度,10473748,10131923,341825,37451,304374,-155548,229976,0,0,74428
2022,61,343099,広島県,坂町,5,2,決算収支の状況,1,令和4年度,8376465,7689987,686478,317437,369041,139241,115058,0,0,254299
2022,61,343684,広島県,安芸太田町,5,2,決算収支の状況,1,令和4年度,8523765,8175168,348597,55520,293077,-66084,181500,0,0,115416
2022,61,343692,広島県,北広島町,5,2,決算収支の状況,1,令和4年度,16233700,15919098,314602,96177,218425,-209889,215891,0,0,6002
2022,61,344311,広島県,大崎上島町,5,2,決算収支の状況,1,令和4年度,8222612,7806580,416032,24152,391880,171668,297642,0,0,469310
2022,61,344621,広島県,世羅町,5,2,決算収支の状況,1,令和4年度,12301378,11663796,637582,185000,452582,84414,10454,0,74000,20868
2022,61,345458,広島県,神石高原町,5,2,決算収支の状況,1,令和4年度,12943526,12298688,644838,287311,357527,-347136,16440,7200,0,-323496
2022,61,348392,広島県,安芸地区衛生施設管理組合,6,2,決算収支の状況,1,令和4年度,1731351,1662930,68421,0,68421,4829,18289,0,72822,-49704
2022,61,348546,広島県,広島県海田高等学校財産組合,6,2,決算収支の状況,1,令和4年度,116,0,116,0,116,0,0,0,0,0
2022,61,348562,広島県,広島県市町総合事務組合,6,2,決算収支の状況,1,令和4年度,4170837,4029178,141659,0,141659,-146402,0,0,0,-146402
2022,61,348597,広島県,宮島ボートレース企業団,7,2,決算収支の状況,1,令和4年度,0,0,0,0,0,0,0,0,0,0
2022,61,348660,広島県,備北地区消防組合,6,2,決算収支の状況,1,令和4年度,1887799,1872055,15744,0,15744,-3514,0,0,0,-3514
2022,61,348767,広島県,三原広域市町村圏事務組合,6,2,決算収支の状況,1,令和4年度,252448,224771,27677,0,27677,-30547,29113,0,0,-1434
2022,61,349054,広島県,福山地区消防組合,6,2,決算収支の状況,1,令和4年度,6546759,6378582,168177,40996,127181,1720,0,0,0,1720
2022,61,349089,広島県,芸北広域環境施設組合,6,2,決算収支の状況,1,令和4年度,721668,692287,29381,0,29381,12419,4000,0,0,16419
2022,61,349135,広島県,広島中部台地土地改良施設管理組合,6,2,決算収支の状況,1,令和4年度,78662,72748,5914,3396,2518,1302,0,0,0,1302
2022,61,349178,広島県,広島県後期高齢者医療広域連合,7,2,決算収支の状況,1,令和4年度,578546,345132,233414,0,233414,79525,153899,0,0,233424
2022,61,349186,広島県,広島中央環境衛生組合,6,2,決算収支の状況,1,令和4年度,2383514,2383514,0,0,0,0,0,0,0,0
2022,61,352012,山口県,下関市,8,2,決算収支の状況,1,令和4年度,150241559,144925985,5315574,1021202,4294372,-99967,1831928,0,1500000,231961
2022,61,352021,山口県,宇部市,3,2,決算収支の状況,1,令和4年度,75518343,72856043,2662300,718450,1943850,-325121,1464892,239109,1475960,-97080
2022,61,352039,山口県,山口市,3,2,決算収支の状況,1,令和4年度,91202219,89937702,1264517,437349,827168,106914,927123,0,1385258,-351221
2022,61,352047,山口県,萩市,4,2,決算収支の状況,1,令和4年度,31398821,30592832,805989,184689,621300,-676099,650060,0,300000,-326039
2022,61,352063,山口県,防府市,3,2,決算収支の状況,1,令和4年度,50864507,48433150,2431357,333462,2097895,449025,1286300,0,1000000,735325
2022,61,352071,山口県,下松市,4,2,決算収支の状況,1,令和4年度,25126816,23981427,1145389,283752,861637,-194927,530611,0,250000,85684
2022,61,352080,山口県,岩国市,3,2,決算収支の状況,1,令和4年度,71886053,69077962,2808091,434598,2373493,-6757,1210145,0,0,1203388
2022,61,352101,山口県,光市,4,2,決算収支の状況,1,令和4年度,24275563,23183022,1092541,54299,1038242,94960,191000,0,79800,206160
2022,61,352110,山口県,長門市,4,2,決算収支の状況,1,令和4年度,23301596,21569963,1731633,190646,1540987,-5651,698000,0,0,692349
2022,61,352128,山口県,柳井市,4,2,決算収支の状況,1,令和4年度,19515991,19112661,403330,31002,372328,-256656,316124,0,0,59468
2022,61,352136,山口県,美祢市,4,2,決算収支の状況,1,令和4年度,19107476,18503634,603842,115786,488056,-156587,499,0,0,-156088
2022,61,352152,山口県,周南市,3,2,決算収支の状況,1,令和4年度,78461344,74670369,3790975,381867,3409108,-516362,3376732,0,1914425,945945
2022,61,352161,山口県,山陽小野田市,4,2,決算収支の状況,1,令和4年度,32678427,31789972,888455,241882,646573,-542692,201293,0,0,-341399
2022,61,353051,山口県,周防大島町,5,2,決算収支の状況,1,令和4年度,17999671,17082506,917165,80247,836918,28593,2943741,0,0,2972334
2022,61,353213,山口県,和木町,5,2,決算収支の状況,1,令和4年度,4686240,4415173,271067,2210,268857,-8656,353093,0,0,344437
2022,61,353418,山口県,上関町,5,2,決算収支の状況,1,令和4年度,3682534,3512917,169617,28468,141149,-146901,220029,0,0,73128
2022,61,353434,山口県,田布施町,5,2,決算収支の状況,1,令和4年度,7552976,7337680,215296,41937,173359,-38271,236833,0,268125,-69563
2022,61,353442,山口県,平生町,5,2,決算収支の状況,1,令和4年度,6446580,6177549,269031,52899,216132,7901,159844,0,93134,74611
2022,61,355020,山口県,阿武町,5,2,決算収支の状況,1,令和4年度,4209829,3297368,912461,53599,858862,158878,100000,0,0,258878
2022,61,358045,山口県,周南地区福祉施設組合,6,2,決算収支の状況,1,令和4年度,467094,457900,9194,0,9194,-16558,0,0,0,-16558
2022,61,358126,山口県,玖珂地方老人福祉施設組合,6,2,決算収支の状況,1,令和4年度,409672,387970,21702,0,21702,700,0,0,0,700
2022,61,358304,山口県,周東環境衛生組合,6,2,決算収支の状況,1,令和4年度,738103,727662,10441,0,10441,1062,25062,0,34000,-7876
2022,61,358347,山口県,熊南総合事務組合,6,2,決算収支の状況,1,令和4年度,289930,242048,47882,0,47882,15609,0,0,0,15609
2022,61,358371,山口県,周南地区衛生施設組合,6,2,決算収支の状況,1,令和4年度,2612312,2351016,261296,25294,236002,-45570,0,0,0,-45570
2022,61,358436,山口県,柳井地区広域消防組合,6,2,決算収支の状況,1,令和4年度,1552379,1532206,20173,0,20173,-18517,0,0,0,-18517
2022,61,358461,山口県,光地区消防組合,6,2,決算収支の状況,1,令和4年度,1349776,1311306,38470,0,38470,-641,0,0,0,-641
2022,61,358487,山口県,岩国地区消防組合,6,2,決算収支の状況,1,令和4年度,2436714,2421621,15093,0,15093,-14158,20834,0,40000,-33324
2022,61,358517,山口県,周陽環境整備組合,6,2,決算収支の状況,1,令和4年度,356832,90763,266069,0,266069,264629,0,0,0,264629
2022,61,358592,山口県,周南東部環境施設組合,6,2,決算収支の状況,1,令和4年度,749669,663952,85717,12945,72772,18288,0,0,0,18288
2022,61,358690,山口県,山口県市町総合事務組合,6,2,決算収支の状況,1,令和4年度,1354176,1328035,26141,0,26141,-23030,0,0,60,-23090
2022,61,358703,山口県,山口県後期高齢者医療広域連合,7,2,決算収支の状況,1,令和4年度,72603,68546,4057,0,4057,-1545,2803,0,5500,-4242
2022,61,358738,山口県,萩・長門清掃一部事務組合,6,2,決算収支の状況,1,令和4年度,422948,408031,14917,0,14917,3912,0,0,0,3912
2022,61,358746,山口県,宇部・山陽小野田消防組合,6,2,決算収支の状況,1,令和4年度,3144504,3118964,25540,0,25540,1708,0,0,0,1708
2022,61,362018,徳島県,徳島市,3,2,決算収支の状況,1,令和4年度,113807262,110004708,3802554,787456,3015098,-1087327,2741,0,0,-1084586
2022,61,362026,徳島県,鳴門市,4,2,決算収支の状況,1,令和4年度,30631172,29454028,1177144,300662,876482,-6650,1610745,0,925295,678800
2022,61,362034,徳島県,小松島市,4,2,決算収支の状況,1,令和4年度,17884023,17198769,685254,104612,580642,-8897,305416,20000,0,316519
2022,61,362042,徳島県,阿南市,4,2,決算収支の状況,1,令和4年度,37014203,36228756,785447,337894,447553,-849856,907002,0,0,57146
2022,61,362051,徳島県,吉野川市,4,2,決算収支の状況,1,令和4年度,21389432,20523238,866194,37130,829064,9017,420000,0,0,429017
2022,61,362069,徳島県,阿波市,4,2,決算収支の状況,1,令和4年度,21147835,20195422,952413,142849,809564,-83048,2561,0,499,-80986
2022,61,362077,徳島県,美馬市,4,2,決算収支の状況,1,令和4年度,20178373,19456954,721419,104222,617197,121382,186,5600,0,127168
2022,61,362085,徳島県,三好市,4,2,決算収支の状況,1,令和4年度,25293957,23980369,1313588,288133,1025455,-107510,197593,182324,0,272407
2022,61,363014,徳島県,勝浦町,5,2,決算収支の状況,1,令和4年度,4422095,4006322,415773,88194,327579,6697,150579,0,0,157276
2022,61,363022,徳島県,上勝町,5,2,決算収支の状況,1,令和4年度,3422740,3043297,379443,199322,180121,2236,95000,0,90000,7236
2022,61,363219,徳島県,佐那河内村,5,2,決算収支の状況,1,令和4年度,3877363,3651720,225643,50238,175405,7669,703,692400,0,700772
2022,61,363413,徳島県,石井町,5,2,決算収支の状況,1,令和4年度,10326043,9786259,539784,118966,420818,-41375,232000,0,159000,31625
2022,61,363421,徳島県,神山町,5,2,決算収支の状況,1,令和4年度,8530111,8097102,433009,208710,224299,-44092,9540,0,0,-34552
2022,61,363685,徳島県,那賀町,5,2,決算収支の状況,1,令和4年度,12724222,11998797,725425,141795,583630,-273700,2648,0,0,-271052
2022,61,363839,徳島県,牟岐町,5,2,決算収支の状況,1,令和4年度,3778435,3301035,477400,86559,390841,32963,100000,0,0,132963
2022,61,363871,徳島県,美波町,5,2,決算収支の状況,1,令和4年度,6789166,6588711,200455,27911,172544,-112064,1000,0,0,-111064
2022,61,363880,徳島県,海陽町,5,2,決算収支の状況,1,令和4年度,8794581,8309995,484586,13381,471205,-61740,124955,142162,0,205377
2022,61,364011,徳島県,松茂町,5,2,決算収支の状況,1,令和4年度,6962849,6726493,236356,11081,225275,84886,294788,0,350000,29674
2022,61,364029,徳島県,北島町,5,2,決算収支の状況,1,令和4年度,9402977,8901040,501937,68233,433704,-75286,254495,0,50000,129209
2022,61,364037,徳島県,藍住町,5,2,決算収支の状況,1,令和4年度,14498139,13538757,959382,59847,899535,-35237,848,0,0,-34389
2022,61,364045,徳島県,板野町,5,2,決算収支の状況,1,令和4年度,6558920,6227302,331618,58766,272852,-4559,100200,118747,326,214062
2022,61,364053,徳島県,上板町,5,2,決算収支の状況,1,令和4年度,5631381,5221009,410372,43472,366900,70579,187715,0,0,258294
2022,61,364681,徳島県,つるぎ町,5,2,決算収支の状況,1,令和4年度,8359650,8183530,176120,6256,169864,-69929,2906,0,0,-67023
2022,61,364894,徳島県,東みよし町,5,2,決算収支の状況,1,令和4年度,10059852,9564774,495078,44157,450921,-328297,402476,0,400000,-325821
2022,61,368032,徳島県,西阿老人ホーム組合,6,2,決算収支の状況,1,令和4年度,270179,246549,23630,0,23630,3805,0,0,0,3805
2022,61,368121,徳島県,海部老人ホーム町村組合,6,2,決算収支の状況,1,令和4年度,154749,138543,16206,0,16206,-6402,0,0,0,-6402
2022,61,368148,徳島県,老人ホーム福寿荘組合,6,2,決算収支の状況,1,令和4年度,187361,159544,27817,20000,7817,-1270,4796,0,30506,-26980
2022,61,368156,徳島県,美馬西部共立火葬場組合,6,2,決算収支の状況,1,令和4年度,38764,33917,4847,0,4847,191,0,0,0,191
2022,61,368181,徳島県,吉野川環境整備組合,6,2,決算収支の状況,1,令和4年度,324127,310700,13427,0,13427,-2053,0,0,0,-2053
2022,61,368199,徳島県,海部郡衛生処理事務組合,6,2,決算収支の状況,1,令和4年度,648004,578793,69211,0,69211,11873,7000,0,59970,-41097
2022,61,368229,徳島県,阿北火葬場管理組合,6,2,決算収支の状況,1,令和4年度,81653,66501,15152,0,15152,3809,0,0,0,3809
2022,61,368245,徳島県,阿北環境整備組合,6,2,決算収支の状況,1,令和4年度,251270,220889,30381,0,30381,9825,2,0,0,9827
2022,61,368261,徳島県,美馬環境整備組合,6,2,決算収支の状況,1,令和4年度,954099,887130,66969,0,66969,-16432,0,0,0,-16432
2022,61,368270,徳島県,三好東部火葬場管理組合,6,2,決算収支の状況,1,令和4年度,268521,267582,939,0,939,-425,0,0,0,-425
2022,61,368296,徳島県,徳島県市町村議会議員公務災害補償等組合,6,2,決算収支の状況,1,令和4年度,3717,2784,933,0,933,-810,1,0,0,-809
2022,61,368318,徳島県,美馬西部消防組合,6,2,決算収支の状況,1,令和4年度,493261,445978,47283,0,47283,-35348,0,0,0,-35348
2022,61,368334,徳島県,松茂町ほか二町競艇事業組合,7,2,決算収支の状況,1,令和4年度,0,0,0,0,0,0,0,0,0,0
2022,61,368415,徳島県,板野東部消防組合,6,2,決算収支の状況,1,令和4年度,1184762,1133466,51296,0,51296,15122,0,0,0,15122
2022,61,368423,徳島県,板野東部青少年育成センター組合,6,2,決算収支の状況,1,令和4年度,27195,22777,4418,0,4418,-110,0,0,0,-110
2022,61,368466,徳島県,美馬地区広域行政組合,6,2,決算収支の状況,1,令和4年度,60313,42359,17954,0,17954,12323,0,0,0,12323
2022,61,368512,徳島県,板野西部消防組合,6,2,決算収支の状況,1,令和4年度,371754,360581,11173,0,11173,-3982,0,0,0,-3982
2022,61,368571,徳島県,小松島市外三町村衛生組合,6,2,決算収支の状況,1,令和4年度,349582,321594,27988,0,27988,-22444,33020,0,0,10576
2022,61,368601,徳島県,中央広域環境施設組合,6,2,決算収支の状況,1,令和4年度,1950056,1832363,117693,0,117693,44448,343,0,68289,-23498
2022,61,368636,徳島県,名西消防組合,6,2,決算収支の状況,1,令和4年度,434186,423962,10224,0,10224,-2056,0,0,0,-2056
2022,61,368644,徳島県,徳島県市町村総合事務組合,6,2,決算収支の状況,1,令和4年度,4810433,3854010,956423,0,956423,453472,505752,0,1200,958024
2022,61,369055,徳島県,那賀川北岸地域湛水防除施設組合,6,2,決算収支の状況,1,令和4年度,41320,19902,21418,19314,2104,-1155,3357,0,20175,-17973
2022,61,369063,徳島県,海部消防組合,6,2,決算収支の状況,1,令和4年度,600195,542242,57953,0,57953,11889,0,0,0,11889
2022,61,369080,徳島県,徳島中央広域連合,6,2,決算収支の状況,1,令和4年度,1266871,1227370,39501,0,39501,-1617,3211,0,0,1594
2022,61,369101,徳島県,みよし広域連合,6,2,決算収支の状況,1,令和4年度,3216781,2961130,255651,99689,155962,35555,0,0,0,35555
2022,61,369110,徳島県,徳島県後期高齢者医療広域連合,7,2,決算収支の状況,1,令和4年度,80954,72949,8005,0,8005,3764,1,0,14919,-11154
2022,61,372013,香川県,高松市,8,2,決算収支の状況,1,令和4年度,178322945,173425179,4897766,997186,3900580,103213,5050,605783,1161167,-447121
2022,61,372021,香川県,丸亀市,3,2,決算収支の状況,1,令和4年度,61387119,60793567,593552,381580,211972,-596443,408355,0,800000,-988088
2022,61,372030,香川県,坂出市,4,2,決算収支の状況,1,令和4年度,27436071,26835424,600647,127082,473565,-298295,388995,0,0,90700
2022,61,372048,香川県,善通寺市,4,2,決算収支の状況,1,令和4年度,18451964,17584785,867179,30129,837050,-134314,300758,0,500000,-333556
2022,61,372056,香川県,観音寺市,4,2,決算収支の状況,1,令和4年度,31233500,30120508,1112992,218422,894570,-625363,1704,0,400000,-1023659
2022,61,372064,香川県,さぬき市,4,2,決算収支の状況,1,令和4年度,28593244,27217573,1375671,629294,746377,-475135,520768,0,600000,-554367
2022,61,372072,香川県,東かがわ市,4,2,決算収支の状況,1,令和4年度,20780065,19279227,1500838,185339,1315499,77227,624086,213750,100000,815063
2022,61,372081,香川県,三豊市,4,2,決算収支の状況,1,令和4年度,36230781,35658819,571962,222548,349414,-573683,477709,0,1157369,-1253343
2022,61,373222,香川県,土庄町,5,2,決算収支の状況,1,令和4年度,10662058,9755626,906432,57744,848688,-373300,2243,0,0,-371057
2022,61,373249,香川県,小豆島町,5,2,決算収支の状況,1,令和4年度,12018904,10942502,1076402,73714,1002688,154348,2384,0,0,156732
2022,61,373419,香川県,三木町,5,2,決算収支の状況,1,令和4年度,13665391,13111161,554230,46393,507837,-316989,1644171,0,1617093,-289911
2022,61,373648,香川県,直島町,5,2,決算収支の状況,1,令和4年度,3964863,3759666,205197,500,204697,15485,310700,0,336600,-10415
2022,61,373869,香川県,宇多津町,5,2,決算収支の状況,1,令和4年度,7789539,7289531,500008,17920,482088,-110017,340077,0,0,230060
2022,61,373877,香川県,綾川町,5,2,決算収支の状況,1,令和4年度,12574308,12118864,455444,48600,406844,-255959,28352,0,1000000,-1227607
2022,61,374032,香川県,琴平町,5,2,決算収支の状況,1,令和4年度,4814259,4591120,223139,660,222479,-104007,17830,0,0,-86177
2022,61,374041,香川県,多度津町,5,2,決算収支の状況,1,令和4年度,10840327,10266205,574122,53595,520527,-114651,29,0,300000,-414622
2022,61,374067,香川県,まんのう町,5,2,決算収支の状況,1,令和4年度,13031543,12554603,476940,93827,383113,46102,236908,0,523000,-239990
2022,61,378046,香川県,まんのう町外二ヶ市町（十郷地区）山林組合,6,2,決算収支の状況,1,令和4年度,11610,8788,2822,0,2822,606,0,0,3000,-2394
2022,61,378054,香川県,まんのう町外三ヶ市町山林組合,6,2,決算収支の状況,1,令和4年度,482,267,215,0,215,60,200,0,0,260
2022,61,378062,香川県,まんのう町外三ヶ市町（七箇地区）山林組合,6,2,決算収支の状況,1,令和4年度,8792,5676,3116,0,3116,-351,500,0,0,149
2022,61,378097,香川県,伝法川防災溜池事業組合,6,2,決算収支の状況,1,令和4年度,2139,1999,140,0,140,-43,0,0,0,-43
2022,61,378381,香川県,香川県三豊市観音寺市学校組合,6,2,決算収支の状況,1,令和4年度,193406,179368,14038,0,14038,5801,0,0,0,5801
2022,61,378488,香川県,香川県市町総合事務組合,6,2,決算収支の状況,1,令和4年度,3946802,3887121,59681,0,59681,-345863,0,0,0,-345863
2022,61,378526,香川県,香川県中部広域競艇事業組合,7,2,決算収支の状況,1,令和4年度,0,0,0,0,0,0,0,0,0,0
2022,61,378542,香川県,仲多度南部消防組合,6,2,決算収支の状況,1,令和4年度,681367,676515,4852,0,4852,-1190,3713,0,2697,-174
2022,61,378585,香川県,大川広域行政組合,6,2,決算収支の状況,1,令和4年度,2067869,2051137,16732,0,16732,2475,8752,0,30252,-19025
2022,61,378607,香川県,さぬき市・三木町山林組合,6,2,決算収支の状況,1,令和4年度,6001,5133,868,0,868,703,3201,0,2635,1269
2022,61,378615,香川県,東かがわ市外一市一町組合,6,2,決算収支の状況,1,令和4年度,777,386,391,0,391,14,0,0,0,14
2022,61,378640,香川県,三観広域行政組合,6,2,決算収支の状況,1,令和4年度,2665372,2598640,66732,0,66732,-2705,0,0,0,-2705
2022,61,378666,香川県,小豆地区広域行政事務組合,6,2,決算収支の状況,1,令和4年度,1493646,1471705,21941,0,21941,3258,9700,0,0,12958
2022,61,378674,香川県,中讃広域行政事務組合,6,2,決算収支の状況,1,令和4年度,3319791,3256591,63200,0,63200,10226,101597,0,133045,-21222
2022,61,378691,香川県,坂出、宇多津広域行政事務組合,6,2,決算収支の状況,1,令和4年度,1704166,1684212,19954,19950,4,0,0,0,0,0
2022,61,378828,香川県,香川県東部清掃施設組合,6,2,決算収支の状況,1,令和4年度,1047619,996177,51442,0,51442,13824,36620,0,45076,5368
2022,61,378836,香川県,三木・長尾葬斎組合,6,2,決算収支の状況,1,令和4年度,72541,69285,3256,0,3256,508,0,0,0,508
2022,61,378861,香川県,香川県後期高齢者医療広域連合,7,2,決算収支の状況,1,令和4年度,212036,175303,36733,0,36733,48,0,0,0,48
2022,61,382019,愛媛県,松山市,8,2,決算収支の状況,1,令和4年度,215552463,209891805,5660658,1512061,4148597,598324,100000,0,2000000,-1301676
2022,61,382027,愛媛県,今治市,3,2,決算収支の状況,1,令和4年度,82705586,77619506,5086080,403396,4682684,-921436,1361538,0,0,440102
2022,61,382035,愛媛県,宇和島市,4,2,決算収支の状況,1,令和4年度,52268017,49459066,2808951,877056,1931895,-236010,2200,0,0,-233810
2022,61,382043,愛媛県,八幡浜市,4,2,決算収支の状況,1,令和4年度,24383193,23328799,1054394,245961,808433,-346429,580380,0,0,233951
2022,61,382051,愛媛県,新居浜市,3,2,決算収支の状況,1,令和4年度,53409897,52168573,1241324,170654,1070670,86752,100905,0,460000,-272343
2022,61,382060,愛媛県,西条市,3,2,決算収支の状況,1,令和4年度,59447456,55253057,4194399,197750,3996649,198259,2101567,0,2100000,199826
2022,61,382078,愛媛県,大洲市,4,2,決算収支の状況,1,令和4年度,33487811,30197926,3289885,213414,3076471,-646666,500252,0,0,-146414
2022,61,382108,愛媛県,伊予市,4,2,決算収支の状況,1,令和4年度,19555209,18385100,1170109,205841,964268,-676111,162696,0,0,-513415
2022,61,382132,愛媛県,四国中央市,4,2,決算収支の状況,1,令和4年度,45352869,41768726,3584143,255351,3328792,-849262,277,0,0,-848985
2022,61,382141,愛媛県,西予市,4,2,決算収支の状況,1,令和4年度,35617090,33878011,1739079,400556,1338523,-209976,784657,0,1121515,-546834
2022,61,382159,愛媛県,東温市,4,2,決算収支の状況,1,令和4年度,18686213,17461279,1224934,134084,1090850,-57710,762164,0,482000,222454
2022,61,383562,愛媛県,上島町,5,2,決算収支の状況,1,令和4年度,6614693,6469444,145249,73260,71989,-61912,66542,0,13000,-8370
2022,61,383864,愛媛県,久万高原町,5,2,決算収支の状況,1,令和4年度,10970509,9802485,1168024,390906,777118,-49882,24428,0,801819,-827273
2022,61,384011,愛媛県,松前町,5,2,決算収支の状況,1,令和4年度,12385985,11732777,653208,24651,628557,-109427,369005,0,64098,195480
2022,61,384020,愛媛県,砥部町,5,2,決算収支の状況,1,令和4年度,10099902,9114035,985867,106129,879738,-279837,266,0,200000,-479571
2022,61,384224,愛媛県,内子町,5,2,決算収支の状況,1,令和4年度,11236922,10764758,472164,149364,322800,33885,2309,0,0,36194
2022,61,384429,愛媛県,伊方町,5,2,決算収支の状況,1,令和4年度,11273888,10803798,470090,207133,262957,-944620,800345,0,0,-144275
2022,61,384844,愛媛県,松野町,5,2,決算収支の状況,1,令和4年度,4446239,4291810,154429,14842,139587,-86460,650,0,0,-85810
2022,61,384887,愛媛県,鬼北町,5,2,決算収支の状況,1,令和4年度,10935944,10678906,257038,67996,189042,-143152,1111,0,0,-142041
2022,61,385069,愛媛県,愛南町,5,2,決算収支の状況,1,令和4年度,16828985,16023287,805698,105245,700453,-69084,7843,0,0,-61241
2022,61,388262,愛媛県,松山衛生事務組合,6,2,決算収支の状況,1,令和4年度,868986,747285,121701,0,121701,44406,0,0,0,44406
2022,61,388289,愛媛県,愛媛県市町総合事務組合,6,2,決算収支の状況,1,令和4年度,9029752,8483805,545947,0,545947,225933,21000,0,0,246933
2022,61,388327,愛媛県,松山市、東温市共有山林組合,6,2,決算収支の状況,1,令和4年度,74225,8731,65494,0,65494,1512,0,0,0,1512
2022,61,388343,愛媛県,松山養護老人ホーム事務組合,6,2,決算収支の状況,1,令和4年度,508604,441493,67111,0,67111,-1755,0,0,0,-1755
2022,61,388408,愛媛県,伊予市・松前町共立衛生組合,6,2,決算収支の状況,1,令和4年度,212333,202794,9539,3913,5626,316,0,0,0,316
2022,61,388416,愛媛県,伊予市・伊予郡養護老人ホーム組合,6,2,決算収支の状況,1,令和4年度,295687,278022,17665,0,17665,5226,0,0,0,5226
2022,61,388424,愛媛県,大洲・喜多衛生事務組合,6,2,決算収支の状況,1,令和4年度,203237,185708,17529,0,17529,-15361,0,0,0,-15361
2022,61,388599,愛媛県,高知県宿毛市愛媛県南宇和郡愛南町篠山小中学校組合,6,2,決算収支の状況,1,令和4年度,33505,31869,1636,0,1636,-279,0,0,0,-279
2022,61,388629,愛媛県,八幡浜地区施設事務組合,6,2,決算収支の状況,1,令和4年度,1356472,1311462,45010,4180,40830,-9080,0,0,0,-9080
2022,61,388653,愛媛県,伊予地区ごみ処理施設管理組合,6,2,決算収支の状況,1,令和4年度,433227,332939,100288,9587,90701,29503,0,0,0,29503
2022,61,388696,愛媛県,大洲喜多特別養護老人ホーム事務組合,6,2,決算収支の状況,1,令和4年度,312494,271339,41155,0,41155,-57726,0,0,0,-57726
2022,61,388858,愛媛県,伊予消防等事務組合,6,2,決算収支の状況,1,令和4年度,2123509,2062649,60860,34621,26239,-7918,0,0,0,-7918
2022,61,388882,愛媛県,宇和島地区広域事務組合,6,2,決算収支の状況,1,令和4年度,3839914,3403255,436659,0,436659,-18055,0,0,0,-18055
2022,61,388891,愛媛県,伊予市外二町共有物組合,6,2,決算収支の状況,1,令和4年度,10013,8154,1859,0,1859,-2236,3550,0,0,1314
2022,61,388963,愛媛県,大洲地区広域消防事務組合,6,2,決算収支の状況,1,令和4年度,1015123,997466,17657,0,17657,-3104,0,0,0,-3104
2022,61,388980,愛媛県,松山広域福祉施設事務組合,6,2,決算収支の状況,1,令和4年度,457426,400657,56769,0,56769,-26322,0,0,0,-26322
2022,61,389048,愛媛県,八幡浜・大洲地区広域市町村圏組合（普通会計分）,6,2,決算収支の状況,1,令和4年度,67992,60630,7362,0,7362,-1433,0,0,0,-1433
2022,61,389111,愛媛県,愛媛地方税滞納整理機構,6,2,決算収支の状況,1,令和4年度,160867,98870,61997,0,61997,-5581,0,0,0,-5581
2022,61,389129,愛媛県,愛媛県後期高齢者医療広域連合,7,2,決算収支の状況,1,令和4年度,86086,68053,18033,0,18033,4038,0,0,0,4038
2022,61,392014,高知県,高知市,8,2,決算収支の状況,1,令和4年度,165510132,162979477,2530655,1131384,1399271,-3487512,111,2247,0,-3485154
2022,61,392022,高知県,室戸市,4,2,決算収支の状況,1,令和4年度,16071284,15583645,487639,25433,462206,-105660,331109,0,0,225449
2022,61,392031,高知県,安芸市,4,2,決算収支の状況,1,令和4年度,20081912,19000505,1081407,653269,428138,-36405,45598,402208,0,411401
2022,61,392049,高知県,南国市,4,2,決算収支の状況,1,令和4年度,25370467,24409992,960475,294891,665584,-352860,1946,0,350000,-700914
2022,61,392057,高知県,土佐市,4,2,決算収支の状況,1,令和4年度,16194577,15997911,196666,100400,96266,-416655,867,0,0,-415788
2022,61,392065,高知県,須崎市,4,2,決算収支の状況,1,令和4年度,17603694,17190733,412961,23973,388988,-531864,313,0,0,-531551
2022,61,392081,高知県,宿毛市,4,2,決算収支の状況,1,令和4年度,15728925,14814542,914383,143282,771101,-12055,774,0,185000,-196281
2022,61,392090,高知県,土佐清水市,4,2,決算収支の状況,1,令和4年度,10656500,10383246,273254,24977,248277,-62418,160019,0,0,97601
2022,61,392103,高知県,四万十市,4,2,決算収支の状況,1,令和4年度,24758556,24178668,579888,473035,106853,-274922,972,0,0,-273950
2022,61,392111,高知県,香南市,4,2,決算収支の状況,1,令和4年度,20511806,19980811,530995,155404,375591,-35021,206901,0,0,171880
2022,61,392120,高知県,香美市,4,2,決算収支の状況,1,令和4年度,19868767,19482974,385793,119781,266012,-286841,5403,0,0,-281438
2022,61,393011,高知県,東洋町,5,2,決算収支の状況,1,令和4年度,3235952,3173906,62046,2396,59650,43333,45100,0,0,88433
2022,61,393029,高知県,奈半利町,5,2,決算収支の状況,1,令和4年度,3434808,3365978,68830,39297,29533,-13623,194460,0,0,180837
2022,61,393037,高知県,田野町,5,2,決算収支の状況,1,令和4年度,3453549,3368060,85489,19519,65970,20520,831,0,0,21351
2022,61,393045,高知県,安田町,5,2,決算収支の状況,1,令和4年度,3075034,2960736,114298,20962,93336,11347,41442,0,0,52789
2022,61,393053,高知県,北川村,5,2,決算収支の状況,1,令和4年度,2714245,2624103,90142,8620,81522,-93458,3260,46400,0,-43798
2022,61,393061,高知県,馬路村,5,2,決算収支の状況,1,令和4年度,2647120,2426575,220545,32832,187713,104919,5,0,20000,84924
2022,61,393070,高知県,芸西村,5,2,決算収支の状況,1,令和4年度,5861343,5322587,538756,174769,363987,187165,403,0,0,187568
2022,61,393410,高知県,本山町,5,2,決算収支の状況,1,令和4年度,5595882,5349290,246592,76064,170528,101107,100,135647,0,236854
2022,61,393444,高知県,大豊町,5,2,決算収支の状況,1,令和4年度,6381933,6042434,339499,234119,105380,6587,2955,304132,0,313674
2022,61,393631,高知県,土佐町,5,2,決算収支の状況,1,令和4年度,4867808,4791330,76478,44453,32025,-6790,200000,0,200000,-6790
2022,61,393649,高知県,大川村,5,2,決算収支の状況,1,令和4年度,1526261,1474976,51285,3058,48227,-4208,63852,0,22228,37416
2022,61,393860,高知県,いの町,5,2,決算収支の状況,1,令和4年度,14708769,14300723,408046,77580,330466,93967,1605,0,0,95572
2022,61,393878,高知県,仁淀川町,5,2,決算収支の状況,1,令和4年度,7279521,6787780,491741,89729,402012,-37110,735,0,3458,-39833
2022,61,394017,高知県,中土佐町,5,2,決算収支の状況,1,令和4年度,7490196,7045701,444495,292557,151938,-321322,1813,0,0,-319509
2022,61,394025,高知県,佐川町,5,2,決算収支の状況,1,令和4年度,9373218,8995326,377892,172035,205857,95134,2995,0,0,98129
2022,61,394033,高知県,越知町,5,2,決算収支の状況,1,令和4年度,5383262,5234514,148748,12738,136010,50213,88194,0,0,138407
2022,61,394050,高知県,梼原町,5,2,決算収支の状況,1,令和4年度,6806512,6690058,116454,74505,41949,-1308,22266,4253,0,25211
2022,61,394106,高知県,日高村,5,2,決算収支の状況,1,令和4年度,5027281,4755541,271740,132477,139263,106117,92565,200000,0,398682
2022,61,394114,高知県,津野町,5,2,決算収支の状況,1,令和4年度,6666358,6479268,187090,41903,145187,-26213,3972,790345,0,768104
2022,61,394122,高知県,四万十町,5,2,決算収支の状況,1,令和4年度,19666654,18891716,774938,223235,551703,-25557,7065,0,406000,-424492
2022,61,394246,高知県,大月町,5,2,決算収支の状況,1,令和4年度,5561699,5120157,441542,32119,409423,168198,121421,0,0,289619
2022,61,394271,高知県,三原村,5,2,決算収支の状況,1,令和4年度,2290660,2165270,125390,9186,116204,67121,78803,0,0,145924
2022,61,394289,高知県,黒潮町,5,2,決算収支の状況,1,令和4年度,11340618,10905809,434809,122359,312450,-16634,774,0,0,-15860
2022,61,398055,高知県,香美郡殖林組合,6,2,決算収支の状況,1,令和4年度,565,455,110,0,110,-455,0,0,0,-455
2022,61,398209,高知県,香南香美衛生組合,6,2,決算収支の状況,1,令和4年度,159500,150499,9001,0,9001,1180,0,0,12955,-11775
2022,61,398225,高知県,仁淀川下流衛生事務組合,6,2,決算収支の状況,1,令和4年度,242789,217894,24895,0,24895,-2987,0,0,0,-2987
2022,61,398233,高知県,高吾北広域町村事務組合,6,2,決算収支の状況,1,令和4年度,1483717,1185733,297984,4359,293625,-25402,33,0,14985,-40354
2022,61,398250,高知県,香南斎場組合,6,2,決算収支の状況,1,令和4年度,289440,283197,6243,0,6243,75,3123,0,0,3198
2022,61,398284,高知県,香南香美老人ホーム組合,6,2,決算収支の状況,1,令和4年度,249683,249278,405,0,405,-1650,1029,0,20000,-20621
2022,61,398331,高知県,日高村佐川町学校組合,6,2,決算収支の状況,1,令和4年度,147445,141173,6272,0,6272,-2803,6575,0,0,3772
2022,61,398357,高知県,高知県競馬組合,7,2,決算収支の状況,1,令和4年度,0,0,0,0,0,0,0,0,0,0
2022,61,398403,高知県,香南清掃組合,6,2,決算収支の状況,1,令和4年度,1037105,989386,47719,0,47719,5318,0,0,0,5318
2022,61,398446,高知県,幡多広域市町村圏事務組合,6,2,決算収支の状況,1,令和4年度,1142723,1134640,8083,0,8083,436,0,0,0,436
2022,61,398462,高知県,高幡消防組合,6,2,決算収支の状況,1,令和4年度,1384808,1384808,0,0,0,0,0,0,0,0
2022,61,398489,高知県,幡多中央環境施設組合,6,2,決算収支の状況,1,令和4年度,90230,90230,0,0,0,0,0,0,0,0
2022,61,398501,高知県,津野山養護老人ホーム組合,6,2,決算収支の状況,1,令和4年度,125221,124927,294,0,294,5,0,0,100,-95
2022,61,398519,高知県,高陵特別養護老人ホーム組合,6,2,決算収支の状況,1,令和4年度,17409,17409,0,0,0,0,0,0,0,0
2022,61,398535,高知県,津野山広域事務組合,6,2,決算収支の状況,1,令和4年度,148831,67607,81224,81001,223,-12847,0,0,0,-12847
2022,61,398543,高知県,高幡東部清掃組合,6,2,決算収支の状況,1,令和4年度,609363,589669,19694,0,19694,3847,30,0,0,3877
2022,61,398608,高知県,仁淀消防組合,6,2,決算収支の状況,1,令和4年度,524159,514284,9875,0,9875,-4407,0,0,0,-4407
2022,61,398624,高知県,幡多中央消防組合,6,2,決算収支の状況,1,令和4年度,893818,893818,0,0,0,0,0,0,0,0
2022,61,398675,高知県,幡多西部消防組合,6,2,決算収支の状況,1,令和4年度,626990,626660,330,330,0,0,0,0,0,0
2022,61,398705,高知県,高知県広域食肉センター事務組合,6,2,決算収支の状況,1,令和4年度,109830,17862,91968,83000,8968,8488,0,0,0,8488
2022,61,398713,高知県,嶺北広域行政事務組合,6,2,決算収支の状況,1,令和4年度,845119,799519,45600,4554,41046,16455,0,0,0,16455
2022,61,398721,高知県,高幡障害者支援施設組合,6,2,決算収支の状況,1,令和4年度,25696,25638,58,0,58,-32,0,0,0,-32
2022,61,398730,高知県,安芸広域市町村圏事務組合,6,2,決算収支の状況,1,令和4年度,2911573,2842384,69189,0,69189,32089,7156,0,927,38318
2022,61,398748,高知県,高幡広域市町村圏事務組合,6,2,決算収支の状況,1,令和4年度,140564,140564,0,0,0,0,0,0,0,0
2022,61,398764,高知県,仁淀川広域市町村圏事務組合,6,2,決算収支の状況,1,令和4年度,14442,7112,7330,0,7330,-1282,0,0,0,-1282
2022,61,398781,高知県,中芸広域連合,6,2,決算収支の状況,1,令和4年度,1380299,1270005,110294,0,110294,33758,0,0,0,33758
2022,61,398802,高知県,高知中央西部焼却処理事務組合,6,2,決算収支の状況,1,令和4年度,585656,509696,75960,10945,65015,23804,0,0,0,23804
2022,61,398811,高知県,こうち人づくり広域連合,6,2,決算収支の状況,1,令和4年度,134582,125587,8995,0,8995,151,0,0,0,151
2022,61,398829,高知県,高知県市町村総合事務組合,6,2,決算収支の状況,1,令和4年度,3291414,2906966,384448,0,384448,-3567,2,0,1245,-4810
2022,61,398845,高知県,高知県後期高齢者医療広域連合,7,2,決算収支の状況,1,令和4年度,66821,48863,17958,0,17958,7796,5081,0,5081,7796
2022,61,398853,高知県,南国・香南・香美租税債権管理機構,6,2,決算収支の状況,1,令和4年度,57156,57156,0,0,0,0,0,0,0,0
2022,61,401005,福岡県,北九州市,1,2,決算収支の状況,1,令和4年度,605369946,601494524,3875422,2127474,1747948,-3348140,2459400,0,1500000,-2388740
2022,61,401307,福岡県,福岡市,1,2,決算収支の状況,1,令和4年度,1142879419,1124508359,18371060,8503521,9867539,-1039311,4934866,0,3700000,195555
2022,61,402028,福岡県,大牟田市,3,2,決算収支の状況,1,令和4年度,63366198,62557520,808678,149501,659177,110028,275034,0,500000,-114938
2022,61,402036,福岡県,久留米市,8,2,決算収支の状況,1,令和4年度,146847731,145417176,1430555,397171,1033384,37738,8272,0,0,46010
2022,61,402044,福岡県,直方市,4,2,決算収支の状況,1,令和4年度,32509836,31225745,1284091,106204,1177887,-823764,1552167,0,0,728403
2022,61,402052,福岡県,飯塚市,3,2,決算収支の状況,1,令和4年度,90321568,88659474,1662094,256453,1405641,-1972395,58742,0,1000000,-2913653
2022,61,402061,福岡県,田川市,4,2,決算収支の状況,1,令和4年度,36615892,36019390,596502,157213,439289,-557121,23,0,200000,-757098
2022,61,402079,福岡県,柳川市,4,2,決算収支の状況,1,令和4年度,34895896,33662470,1233426,134873,1098553,-579863,6575,0,0,-573288
2022,61,402109,福岡県,八女市,4,2,決算収支の状況,1,令和4年度,44989293,42974958,2014335,444075,1570260,235174,202011,397534,0,834719
2022,61,402117,福岡県,筑後市,4,2,決算収支の状況,1,令和4年度,24129492,22639104,1490388,167947,1322441,-440963,207987,0,0,-232976
2022,61,402125,福岡県,大川市,4,2,決算収支の状況,1,令和4年度,18784363,18275261,509102,53203,455899,-536691,101326,0,0,-435365
2022,61,402133,福岡県,行橋市,4,2,決算収支の状況,1,令和4年度,32492234,31528146,964088,112453,851635,297042,15518,0,0,312560
2022,61,402141,福岡県,豊前市,4,2,決算収支の状況,1,令和4年度,13540233,13153406,386827,5737,381090,-61668,9447,0,340000,-392221
2022,61,402150,福岡県,中間市,4,2,決算収支の状況,1,令和4年度,20522620,19689833,832787,52825,779962,-238832,1558894,0,0,1320062
2022,61,402168,福岡県,小郡市,4,2,決算収支の状況,1,令和4年度,23578809,22772192,806617,122003,684614,363073,497860,1989,0,862922
2022,61,402176,福岡県,筑紫野市,3,2,決算収支の状況,1,令和4年度,39118599,37883543,1235056,50487,1184569,-287922,1162260,0,0,874338
2022,61,402184,福岡県,春日市,3,2,決算収支の状況,1,令和4年度,41027331,39544538,1482793,198216,1284577,-955382,154000,0,152000,-953382
2022,61,402192,福岡県,大野城市,3,2,決算収支の状況,1,令和4年度,42463610,41007295,1456315,21739,1434576,-330636,979772,199887,103799,745224
2022,61,402206,福岡県,宗像市,4,2,決算収支の状況,1,令和4年度,44164553,41960083,2204470,195724,2008746,-109449,17179,822379,0,730109
2022,61,402214,福岡県,太宰府市,4,2,決算収支の状況,1,令和4年度,31757792,29487382,2270410,429310,1841100,-295021,58784,0,167765,-404002
2022,61,402231,福岡県,古賀市,4,2,決算収支の状況,1,令和4年度,29722882,28132855,1590027,167335,1422692,-689412,1082309,0,1160383,-767486
2022,61,402249,福岡県,福津市,4,2,決算収支の状況,1,令和4年度,29786982,28735395,1051587,218900,832687,317113,275718,0,0,592831
2022,61,402257,福岡県,うきは市,4,2,決算収支の状況,1,令和4年度,18351157,17538049,813108,116240,696868,-192768,101693,359145,13831,254239
2022,61,402265,福岡県,宮若市,4,2,決算収支の状況,1,令和4年度,18970939,17894285,1076654,84651,992003,-262924,1581,0,0,-261343
2022,61,402273,福岡県,嘉麻市,4,2,決算収支の状況,1,令和4年度,36352524,35373024,979500,190569,788931,194540,5592,0,0,200132
2022,61,402281,福岡県,朝倉市,4,2,決算収支の状況,1,令和4年度,38660000,37319467,1340533,304186,1036347,77720,23205,1421147,0,1522072
2022,61,402290,福岡県,みやま市,4,2,決算収支の状況,1,令和4年度,24629045,23800896,828149,148129,680020,-123780,456255,0,300000,32475
2022,61,402303,福岡県,糸島市,4,2,決算収支の状況,1,令和4年度,49984272,48193971,1790301,27348,1762953,346765,1705383,0,0,2052148
2022,61,402311,福岡県,那珂川市,4,2,決算収支の状況,1,令和4年度,20903030,20258051,644979,66710,578269,-80308,281300,0,50000,150992
2022,61,403415,福岡県,宇美町,5,2,決算収支の状況,1,令和4年度,15048643,14233378,815265,196011,619254,-18052,621146,0,333730,269364
2022,61,403423,福岡県,篠栗町,5,2,決算収支の状況,1,令和4年度,12624182,12061133,563049,31120,531929,-1062829,804214,0,0,-258615
2022,61,403431,福岡県,志免町,5,2,決算収支の状況,1,令和4年度,21357480,20150183,1207297,17534,1189763,-124839,1777388,0,2977387,-1324838
2022,61,403440,福岡県,須恵町,5,2,決算収支の状況,1,令和4年度,12223485,11792859,430626,61879,368747,-13353,50625,0,600000,-562728
2022,61,403458,福岡県,新宮町,5,2,決算収支の状況,1,令和4年度,18508126,17965256,542870,18329,524541,-87438,551635,0,0,464197
2022,61,403482,福岡県,久山町,5,2,決算収支の状況,1,令和4年度,6513388,5869680,643708,54853,588855,59380,100388,0,0,159768
2022,61,403491,福岡県,粕屋町,5,2,決算収支の状況,1,令和4年度,22363238,21540838,822400,152147,670253,-206754,791518,0,788045,-203281
2022,61,403814,福岡県,芦屋町,5,2,決算収支の状況,1,令和4年度,10050233,9618386,431847,71662,360185,30825,400119,0,806322,-375378
2022,61,403822,福岡県,水巻町,5,2,決算収支の状況,1,令和4年度,12429922,11785586,644336,38858,605478,-13470,745,0,300000,-312725
2022,61,403831,福岡県,岡垣町,5,2,決算収支の状況,1,令和4年度,12995487,12254824,740663,86180,654483,-15519,2738,0,0,-12781
2022,61,403849,福岡県,遠賀町,5,2,決算収支の状況,1,令和4年度,10172161,9599791,572370,15876,556494,194446,136,0,79199,115383
2022,61,404012,福岡県,小竹町,5,2,決算収支の状況,1,令和4年度,5872754,5572350,300404,213,300191,69889,0,0,0,69889
2022,61,404021,福岡県,鞍手町,5,2,決算収支の状況,1,令和4年度,9424226,8690759,733467,18444,715023,139528,1066,0,0,140594
2022,61,404217,福岡県,桂川町,5,2,決算収支の状況,1,令和4年度,6981210,6689322,291888,0,291888,-89836,51025,0,0,-38811
2022,61,404471,福岡県,筑前町,5,2,決算収支の状況,1,令和4年度,14126742,13501224,625518,20832,604686,-564,123962,172416,0,295814
2022,61,404489,福岡県,東峰村,5,2,決算収支の状況,1,令和4年度,4573782,4349699,224083,110666,113417,-4520,1860,9300,50000,-43360
2022,61,405035,福岡県,大刀洗町,5,2,決算収支の状況,1,令和4年度,9824270,9135833,688437,42904,645533,6949,1577,0,0,8526
2022,61,405221,福岡県,大木町,5,2,決算収支の状況,1,令和4年度,7636487,7029834,606653,130329,476324,-37785,17283,0,0,-20502
2022,61,405442,福岡県,広川町,5,2,決算収支の状況,1,令和4年度,10020924,9626239,394685,5379,389306,-87420,110166,0,0,22746
2022,61,406015,福岡県,香春町,5,2,決算収支の状況,1,令和4年度,7698316,7230380,467936,51628,416308,-137390,201,143826,0,6637
2022,61,406023,福岡県,添田町,5,2,決算収支の状況,1,令和4年度,7793674,7381107,412567,26829,385738,-117168,76413,0,0,-40755
2022,61,406040,福岡県,糸田町,5,2,決算収支の状況,1,令和4年度,6833855,6254044,579811,141577,438234,15291,17923,56379,0,89593
2022,61,406058,福岡県,川崎町,5,2,決算収支の状況,1,令和4年度,13590023,13440902,149121,34724,114397,-53059,6563,385523,0,339027
2022,61,406082,福岡県,大任町,5,2,決算収支の状況,1,令和4年度,11321029,11060892,260137,40406,219731,-367789,242196,491982,0,366389
2022,61,406091,福岡県,赤村,5,2,決算収支の状況,1,令和4年度,4015764,3920129,95635,10186,85449,44824,634,167793,3608,209643
2022,61,406104,福岡県,福智町,5,2,決算収支の状況,1,令和4年度,25059488,23649327,1410161,371637,1038524,-616818,21323,0,0,-595495
2022,61,406210,福岡県,苅田町,5,2,決算収支の状況,1,令和4年度,17057863,16359658,698205,155278,542927,-294617,3656,0,56415,-347376
2022,61,406252,福岡県,みやこ町,5,2,決算収支の状況,1,令和4年度,14002735,12742885,1259850,165290,1094560,56442,944,0,0,57386
2022,61,406422,福岡県,吉富町,5,2,決算収支の状況,1,令和4年度,4183425,3871985,311440,27685,283755,57013,2477,0,0,59490
2022,61,406465,福岡県,上毛町,5,2,決算収支の状況,1,令和4年度,6877342,6424147,453195,43470,409725,-11703,216851,0,0,205148
2022,61,406473,福岡県,築上町,5,2,決算収支の状況,1,令和4年度,12444929,11675567,769362,241984,527378,-148926,1619,0,0,-147307
2022,61,408026,福岡県,粕屋郡粕屋町外１市水利組合,6,2,決算収支の状況,1,令和4年度,11008,8870,2138,0,2138,-666,0,0,0,-666
2022,61,408034,福岡県,直方市・北九州市岡森用水組合,6,2,決算収支の状況,1,令和4年度,37384,34311,3073,0,3073,1027,2047,0,0,3074
2022,61,408042,福岡県,柳川みやま土木組合,6,2,決算収支の状況,1,令和4年度,307321,290698,16623,0,16623,-54,8502,0,7718,730
2022,61,408051,福岡県,花宗太田土木組合,6,2,決算収支の状況,1,令和4年度,151793,139337,12456,0,12456,4471,9,0,0,4480
2022,61,408069,福岡県,花宗用水組合,6,2,決算収支の状況,1,令和4年度,87154,81501,5653,0,5653,4140,16550,0,117,20573
2022,61,408077,福岡県,山の井用水組合,6,2,決算収支の状況,1,令和4年度,7436,5977,1459,0,1459,424,0,0,0,424
2022,61,408085,福岡県,福岡県中間市外二ケ町山田川水利組合,6,2,決算収支の状況,1,令和4年度,66462,38283,28179,0,28179,-3644,65,0,0,-3579
2022,61,408107,福岡県,堀川水利組合,6,2,決算収支の状況,1,令和4年度,1744,794,950,0,950,30,0,0,0,30
2022,61,408123,福岡県,上毛町外一市一町矢方池土木組合,6,2,決算収支の状況,1,令和4年度,3602,2587,1015,0,1015,-79,827,0,0,748
2022,61,408247,福岡県,吉富町外１町環境衛生事務組合,6,2,決算収支の状況,1,令和4年度,85013,78914,6099,0,6099,2228,0,0,0,2228
2022,61,408379,福岡県,玄界環境組合,6,2,決算収支の状況,1,令和4年度,3229512,3167557,61955,0,61955,7939,7230,0,98016,-82847
2022,61,408395,福岡県,大川柳川衛生組合,6,2,決算収支の状況,1,令和4年度,226562,207453,19109,0,19109,-7546,5001,0,0,-2545
2022,61,408409,福岡県,うきは久留米環境施設組合,6,2,決算収支の状況,1,令和4年度,965943,839225,126718,8668,118050,-25133,0,0,0,-25133
2022,61,408468,福岡県,両筑衛生施設組合,6,2,決算収支の状況,1,令和4年度,167956,138989,28967,0,28967,-14611,0,0,0,-14611
2022,61,408573,福岡県,吉富町外一市中学校組合,6,2,決算収支の状況,1,令和4年度,125735,118370,7365,0,7365,-945,1,0,0,-944
2022,61,408620,福岡県,久留米市外三市町高等学校組合,6,2,決算収支の状況,1,令和4年度,330455,322477,7978,0,7978,-821,0,0,7300,-8121
2022,61,408638,福岡県,古賀高等学校組合,6,2,決算収支の状況,1,令和4年度,596357,587150,9207,0,9207,1759,4000,0,10714,-4955
2022,61,408697,福岡県,福岡県市町村消防団員等公務災害補償組合,6,2,決算収支の状況,1,令和4年度,88371,85584,2787,0,2787,-267,0,0,0,-267
2022,61,408719,福岡県,福岡県市町村職員退職手当組合,6,2,決算収支の状況,1,令和4年度,7641539,7631186,10353,0,10353,-6603,0,0,0,-6603
2022,61,408727,福岡県,福岡県自治会館管理組合,6,2,決算収支の状況,1,令和4年度,203212,192618,10594,0,10594,3120,38706,0,0,41826
2022,61,408735,福岡県,糟屋郡自治会館組合,6,2,決算収支の状況,1,令和4年度,21564,20836,728,0,728,-551,0,0,0,-551
2022,61,408751,福岡県,筑紫自治振興組合,6,2,決算収支の状況,1,令和4年度,47185,44530,2655,0,2655,-1202,0,0,0,-1202
2022,61,408778,福岡県,糟屋郡篠栗町外一市五町財産組合,6,2,決算収支の状況,1,令和4年度,103845,78186,25659,0,25659,-3850,57,0,0,-3793
2022,61,408808,福岡県,豊前市外二町財産組合,6,2,決算収支の状況,1,令和4年度,6856,4462,2394,0,2394,-2462,3000,0,0,538
2022,61,408891,福岡県,八女地区消防組合,6,2,決算収支の状況,1,令和4年度,1427061,1388176,38885,0,38885,10931,0,0,0,10931
2022,61,408913,福岡県,中間市行橋市競艇組合,7,2,決算収支の状況,1,令和4年度,0,0,0,0,0,0,0,0,0,0
2022,61,408921,福岡県,筑紫野太宰府消防組合,6,2,決算収支の状況,1,令和4年度,1790652,1784017,6635,0,6635,-5722,129,0,0,-5593
2022,61,408930,福岡県,飯塚地区消防組合,6,2,決算収支の状況,1,令和4年度,2662042,2616006,46036,0,46036,4815,306290,0,0,311105
2022,61,408956,福岡県,春日・大野城・那珂川消防組合,6,2,決算収支の状況,1,令和4年度,2666236,2643525,22711,0,22711,-22184,0,0,0,-22184
2022,61,408964,福岡県,福岡県田川地区消防組合,6,2,決算収支の状況,1,令和4年度,1873402,1843525,29877,0,29877,9225,14854,0,22144,1935
2022,61,408972,福岡県,北筑昇華苑組合,6,2,決算収支の状況,1,令和4年度,401476,337030,64446,0,64446,16550,25000,0,0,41550
2022,61,408981,福岡県,久留米広域市町村圏事務組合,6,2,決算収支の状況,1,令和4年度,5546360,4980954,565406,35647,529759,-200760,300000,0,85000,14240
2022,61,408999,福岡県,京築広域市町村圏事務組合,6,2,決算収支の状況,1,令和4年度,1374151,1354921,19230,5592,13638,-33205,25665,0,22901,-30441
2022,61,409006,福岡県,宮若市外二町じん芥処理施設組合,6,2,決算収支の状況,1,令和4年度,1036406,1010155,26251,0,26251,-8311,465,0,556293,-564139
2022,61,409022,福岡県,八女西部広域事務組合,6,2,決算収支の状況,1,令和4年度,1608563,1519309,89254,0,89254,18248,10,0,0,18258
2022,61,409031,福岡県,築上郡自治会館等資産管理組合,6,2,決算収支の状況,1,令和4年度,3059,1993,1066,0,1066,-63,0,0,0,-63
2022,61,409111,福岡県,直方・鞍手広域市町村圏事務組合,6,2,決算収支の状況,1,令和4年度,895925,856481,39444,0,39444,-6730,981,0,0,-5749
2022,61,409120,福岡県,甘木・朝倉広域市町村圏事務組合,6,2,決算収支の状況,1,令和4年度,1328099,1290113,37986,0,37986,-4224,0,0,0,-4224
2022,61,409146,福岡県,田川郡東部環境衛生施設組合,6,2,決算収支の状況,1,令和4年度,285834,243072,42762,16000,26762,-619,27381,0,0,26762
2022,61,409154,福岡県,粕屋南部消防組合,6,2,決算収支の状況,1,令和4年度,2235142,2156465,78677,36708,41969,12022,0,0,0,12022
2022,61,409227,福岡県,田川地区斎場組合,6,2,決算収支の状況,1,令和4年度,200065,183413,16652,0,16652,7211,0,0,0,7211
2022,61,409251,福岡県,宗像地区事務組合,6,2,決算収支の状況,1,令和4年度,2538963,2413369,125594,23911,101683,46899,5,9778,22480,34202
2022,61,409278,福岡県,豊前市外二町清掃施設組合,6,2,決算収支の状況,1,令和4年度,517301,496122,21179,0,21179,7272,1000,0,0,8272
2022,61,409294,福岡県,行橋市・みやこ町清掃施設組合,6,2,決算収支の状況,1,令和4年度,905594,838689,66905,0,66905,7226,0,0,0,7226
2022,61,409308,福岡県,大野城太宰府環境施設組合,6,2,決算収支の状況,1,令和4年度,287065,258462,28603,0,28603,738,0,0,0,738
2022,61,409324,福岡県,甘木・朝倉・三井環境施設組合,6,2,決算収支の状況,1,令和4年度,1694185,1577164,117021,0,117021,18020,0,0,0,18020
2022,61,409332,福岡県,粕屋北部消防組合,6,2,決算収支の状況,1,令和4年度,1253364,1225912,27452,0,27452,4997,8878,0,4487,9388
2022,61,409341,福岡県,有明生活環境施設組合,6,2,決算収支の状況,1,令和4年度,853132,687300,165832,0,165832,64010,0,0,20011,43999
2022,61,409359,福岡県,須恵町外二ヶ町清掃施設組合,6,2,決算収支の状況,1,令和4年度,2088907,1785612,303295,55641,247654,-17752,3,0,0,-17749
2022,61,409367,福岡県,遠賀・中間地域広域行政事務組合,6,2,決算収支の状況,1,令和4年度,4131510,4090174,41336,0,41336,-2680,0,0,0,-2680
2022,61,409375,福岡県,筑紫野・小郡・基山清掃施設組合,6,2,決算収支の状況,1,令和4年度,1950875,1912156,38719,0,38719,-7752,0,0,0,-7752
2022,61,409391,福岡県,福岡県自治振興組合,6,2,決算収支の状況,1,令和4年度,562983,561569,1414,0,1414,-6918,0,0,0,-6918
2022,61,409405,福岡県,春日大野城衛生施設組合,6,2,決算収支の状況,1,令和4年度,620542,527200,93342,0,93342,42063,0,0,0,42063
2022,61,409413,福岡県,田川地区清掃施設組合,6,2,決算収支の状況,1,令和4年度,738671,715240,23431,0,23431,5730,0,0,0,5730
2022,61,409448,福岡県,大牟田・荒尾清掃施設組合,6,2,決算収支の状況,1,令和4年度,1050459,1027717,22742,0,22742,10346,3,0,0,10349
2022,61,409456,福岡県,筑慈苑施設組合,6,2,決算収支の状況,1,令和4年度,278678,272507,6171,0,6171,-2222,0,0,0,-2222
2022,61,409464,福岡県,八女中部衛生施設事務組合,6,2,決算収支の状況,1,令和4年度,404739,387599,17140,0,17140,-18915,0,0,0,-18915
2022,61,409511,福岡県,福岡都市圏広域行政事業組合（普通会計分）,6,2,決算収支の状況,1,令和4年度,312024,229866,82158,0,82158,9504,4657,0,0,14161
2022,61,409537,福岡県,宇美町・志免町衛生施設組合,6,2,決算収支の状況,1,令和4年度,443324,423026,20298,0,20298,13596,0,0,0,13596
2022,61,409545,福岡県,福岡県介護保険広域連合,6,2,決算収支の状況,1,令和4年度,1850689,1810797,39892,0,39892,-4430,0,0,0,-4430
2022,61,409553,福岡県,福岡都市圏南部環境事業組合,6,2,決算収支の状況,1,令和4年度,2842667,2770275,72392,0,72392,-202420,274920,0,357630,-285130
2022,61,409561,福岡県,福岡県後期高齢者医療広域連合,7,2,決算収支の状況,1,令和4年度,216534,191379,25155,0,25155,-7495,0,0,0,-7495
2022,61,409570,福岡県,福岡都市圏広域行政事業組合（事業会計分）,7,2,決算収支の状況,1,令和4年度,0,0,0,0,0,0,0,0,0,0
2022,61,409588,福岡県,下田川清掃施設組合,6,2,決算収支の状況,1,令和4年度,649510,577312,72198,0,72198,-24964,247554,0,14190,208400
2022,61,409596,福岡県,ふくおか県央環境広域施設組合,6,2,決算収支の状況,1,令和4年度,4709637,4462415,247222,13230,233992,50427,493238,0,953707,-410042
2022,61,409600,福岡県,田川地区広域環境衛生施設組合,6,2,決算収支の状況,1,令和4年度,528932,432755,96177,22000,74177,-31373,105550,0,0,74177
2022,61,409618,福岡県,行橋京都メディカルセンター組合,6,2,決算収支の状況,1,令和4年度,508700,370795,137905,0,137905,137905,129855,0,7084,260676
2022,61,412015,佐賀県,佐賀市,9,2,決算収支の状況,1,令和4年度,113882747,110932324,2950423,848984,2101439,-1038521,1608624,0,663214,-93111
2022,61,412023,佐賀県,唐津市,3,2,決算収支の状況,1,令和4年度,86127243,83358413,2768830,577672,2191158,664735,117,0,607744,57108
2022,61,412031,佐賀県,鳥栖市,4,2,決算収支の状況,1,令和4年度,37631099,36140100,1490999,317558,1173441,-104490,440000,0,128196,207314
2022,61,412040,佐賀県,多久市,4,2,決算収支の状況,1,令和4年度,16001124,15179036,822088,113513,708575,150783,454182,0,0,604965
2022,61,412058,佐賀県,伊万里市,4,2,決算収支の状況,1,令和4年度,34869763,33601363,1268400,28505,1239895,518183,487126,0,0,1005309
2022,61,412066,佐賀県,武雄市,4,2,決算収支の状況,1,令和4年度,31524654,29881910,1642744,243021,1399723,-198709,367393,0,30000,138684
2022,61,412074,佐賀県,鹿島市,4,2,決算収支の状況,1,令和4年度,17065466,16424645,640821,185832,454989,148263,241000,0,208300,180963
2022,61,412082,佐賀県,小城市,4,2,決算収支の状況,1,令和4年度,24472101,23608488,863613,290034,573579,180126,114457,0,0,294583
2022,61,412091,佐賀県,嬉野市,4,2,決算収支の状況,1,令和4年度,21572074,20603033,969041,172678,796363,-83703,451823,0,63888,304232
2022,61,412104,佐賀県,神埼市,4,2,決算収支の状況,1,令和4年度,20619415,19874421,744994,182306,562688,-273328,418123,0,206726,-61931
2022,61,413275,佐賀県,吉野ヶ里町,5,2,決算収支の状況,1,令和4年度,10530965,10203119,327846,131676,196170,-191386,8232,0,0,-183154
2022,61,413411,佐賀県,基山町,5,2,決算収支の状況,1,令和4年度,8996932,8710018,286914,5446,281468,7048,140033,0,0,147081
2022,61,413453,佐賀県,上峰町,5,2,決算収支の状況,1,令和4年度,23340963,22847150,493813,149797,344016,163682,119735,0,180911,102506
2022,61,413461,佐賀県,みやき町,5,2,決算収支の状況,1,令和4年度,20921011,20080888,840123,75693,764430,132587,246915,0,288084,91418
2022,61,413879,佐賀県,玄海町,5,2,決算収支の状況,1,令和4年度,9777290,9325518,451772,179395,272377,-112675,522236,0,0,409561
2022,61,414018,佐賀県,有田町,5,2,決算収支の状況,1,令和4年度,13113621,12585617,528004,57753,470251,-13587,246479,223532,147157,309267
2022,61,414239,佐賀県,大町町,5,2,決算収支の状況,1,令和4年度,6150673,5946642,204031,20165,183866,7009,825,0,0,7834
2022,61,414247,佐賀県,江北町,5,2,決算収支の状況,1,令和4年度,7239617,6854520,385097,62512,322585,56961,3352,0,100000,-39687
2022,61,414255,佐賀県,白石町,5,2,決算収支の状況,1,令和4年度,17439054,16755644,683410,98616,584794,24154,383959,0,0,408113
2022,61,414417,佐賀県,太良町,5,2,決算収支の状況,1,令和4年度,7733305,7557575,175730,14618,161112,-124856,722,0,0,-124134
2022,61,418129,佐賀県,天山地区共同衛生処理場組合,6,2,決算収支の状況,1,令和4年度,352554,333015,19539,0,19539,2392,0,0,0,2392
2022,61,418137,佐賀県,杵島地区衛生処理組合,6,2,決算収支の状況,1,令和4年度,1004841,990156,14685,0,14685,-8851,7229,0,0,-1622
2022,61,418145,佐賀県,鹿島・藤津地区衛生施設組合,6,2,決算収支の状況,1,令和4年度,391737,374928,16809,0,16809,3684,0,0,0,3684
2022,61,418277,佐賀県,佐賀県競馬組合,7,2,決算収支の状況,1,令和4年度,0,0,0,0,0,0,0,0,0,0
2022,61,418293,佐賀県,有田磁石場組合,6,2,決算収支の状況,1,令和4年度,6237,4957,1280,0,1280,-210,203,0,1000,-1007
2022,61,418307,佐賀県,杵藤地区広域市町村圏組合,6,2,決算収支の状況,1,令和4年度,4199666,4092788,106878,0,106878,28823,229,0,0,29052
2022,61,418315,佐賀県,鳥栖・三養基地区消防事務組合,6,2,決算収支の状況,1,令和4年度,1705786,1688543,17243,0,17243,912,57091,0,0,58003
2022,61,418331,佐賀県,天山地区共同斎場組合,6,2,決算収支の状況,1,令和4年度,72752,66067,6685,0,6685,764,0,0,0,764
2022,61,418340,佐賀県,伊万里・有田地区医療福祉組合,6,2,決算収支の状況,1,令和4年度,782,695,87,0,87,-325,0,0,0,-325
2022,61,418404,佐賀県,脊振共同塵芥処理組合,6,2,決算収支の状況,1,令和4年度,802159,775500,26659,0,26659,19917,25,0,0,19942
2022,61,418412,佐賀県,鳥栖地区広域市町村圏組合,6,2,決算収支の状況,1,令和4年度,100854,100197,657,0,657,233,0,0,0,233
2022,61,418510,佐賀県,伊万里・有田地区衛生組合,6,2,決算収支の状況,1,令和4年度,339032,313121,25911,0,25911,1161,0,0,0,1161
2022,61,418536,佐賀県,三養基西部葬祭組合,6,2,決算収支の状況,1,令和4年度,50185,47130,3055,0,3055,-1918,2488,0,0,570
2022,61,418561,佐賀県,佐賀中部広域連合,6,2,決算収支の状況,1,令和4年度,5364879,5276879,88000,5574,82426,-34642,59229,0,98567,-73980
2022,61,418579,佐賀県,三神地区環境事務組合,6,2,決算収支の状況,1,令和4年度,413716,386826,26890,4670,22220,-2227,12242,0,12000,-1985
2022,61,418587,佐賀県,鳥栖・三養基西部環境施設組合,6,2,決算収支の状況,1,令和4年度,1616341,1584468,31873,0,31873,2140,0,0,0,2140
2022,61,418595,佐賀県,佐賀県後期高齢者医療広域連合,7,2,決算収支の状況,1,令和4年度,120275,117142,3133,0,3133,-232,0,0,0,-232
2022,61,418609,佐賀県,佐賀県市町総合事務組合,6,2,決算収支の状況,1,令和4年度,2842823,2687826,154997,0,154997,-68289,985379,0,8000,909090
2022,61,418617,佐賀県,佐賀県西部広域環境組合,6,2,決算収支の状況,1,令和4年度,2800998,2695929,105069,0,105069,78898,0,0,0,78898
2022,61,418625,佐賀県,伊万里・有田消防組合,6,2,決算収支の状況,1,令和4年度,1461946,1427970,33976,0,33976,-26916,0,0,0,-26916
2022,61,418633,佐賀県,天山地区共同環境組合,6,2,決算収支の状況,1,令和4年度,436943,424456,12487,0,12487,19844,0,0,0,19844
2022,61,418641,佐賀県,神埼市・吉野ヶ里町葬祭組合,6,2,決算収支の状況,1,令和4年度,57633,47806,9827,0,9827,4948,0,0,0,4948
2022,61,418650,佐賀県,佐賀県東部環境施設組合,6,2,決算収支の状況,1,令和4年度,4882000,4841872,40128,22000,18128,8911,0,0,0,8911
2022,61,418668,佐賀県,多久小城医療組合,6,2,決算収支の状況,1,令和4年度,442127,438385,3742,0,3742,2644,0,0,0,2644
2022,61,422011,長崎県,長崎市,8,2,決算収支の状況,1,令和4年度,240493330,231943383,8549947,1690914,6859033,3954058,2143026,0,3456054,2641030
2022,61,422029,長崎県,佐世保市,8,2,決算収支の状況,1,令和4年度,138889941,133196467,5693474,1183117,4510357,-115726,2296283,0,2691362,-510805
2022,61,422037,長崎県,島原市,4,2,決算収支の状況,1,令和4年度,25725052,24939369,785683,175380,610303,168398,243325,79212,83396,407539
2022,61,422045,長崎県,諫早市,3,2,決算収支の状況,1,令和4年度,74368983,72488224,1880759,343933,1536826,-80354,1308933,0,1970000,-741421
2022,61,422053,長崎県,大村市,4,2,決算収支の状況,1,令和4年度,64873231,61940725,2932506,794505,2138001,-329873,575828,1462228,0,1708183
2022,61,422070,長崎県,平戸市,4,2,決算収支の状況,1,令和4年度,26893705,25991965,901740,315566,586174,-47814,326239,0,0,278425
2022,61,422088,長崎県,松浦市,4,2,決算収支の状況,1,令和4年度,20958327,20174730,783597,116601,666996,-17263,640652,358371,122688,859072
2022,61,422096,長崎県,対馬市,4,2,決算収支の状況,1,令和4年度,34117546,32960900,1156646,440984,715662,-98868,100,0,0,-98768
2022,61,422100,長崎県,壱岐市,4,2,決算収支の状況,1,令和4年度,24139487,23444825,694662,171525,523137,-222759,403632,0,0,180873
2022,61,422118,長崎県,五島市,4,2,決算収支の状況,1,令和4年度,34702522,33469529,1232993,390855,842138,135222,36864,322039,0,494125
2022,61,422126,長崎県,西海市,4,2,決算収支の状況,1,令和4年度,24417795,23056090,1361705,308506,1053199,-129203,591245,0,337402,124640
2022,61,422134,長崎県,雲仙市,4,2,決算収支の状況,1,令和4年度,33445761,31991507,1454254,172786,1281468,163303,437,567530,0,731270
2022,61,422142,長崎県,南島原市,4,2,決算収支の状況,1,令和4年度,35778547,33712601,2065946,229703,1836243,148560,521,1495240,0,1644321
2022,61,423076,長崎県,長与町,5,2,決算収支の状況,1,令和4年度,15847973,14699621,1148352,18536,1129816,-27952,133,0,275840,-303659
2022,61,423084,長崎県,時津町,5,2,決算収支の状況,1,令和4年度,14877067,14192317,684750,241645,443105,-133846,16,0,403430,-537260
2022,61,423211,長崎県,東彼杵町,5,2,決算収支の状況,1,令和4年度,6597927,6296099,301828,88087,213741,82297,724,0,0,83021
2022,61,423220,長崎県,川棚町,5,2,決算収支の状況,1,令和4年度,7445938,7116201,329737,37025,292712,32012,100211,0,0,132223
2022,61,423238,長崎県,波佐見町,5,2,決算収支の状況,1,令和4年度,10823950,10577203,246747,210458,36289,-11225,204854,5380,0,199009
2022,61,423831,長崎県,小値賀町,5,2,決算収支の状況,1,令和4年度,4292152,4118211,173941,24378,149563,-976,20378,0,0,19402
2022,61,423912,長崎県,佐々町,5,2,決算収支の状況,1,令和4年度,8022614,7548355,474259,142244,332015,-7766,247379,0,126924,112689
2022,61,424111,長崎県,新上五島町,5,2,決算収支の状況,1,令和4年度,18654631,18144851,509780,166212,343568,-79721,220044,1099840,220000,1020163
2022,61,428175,長崎県,東彼地区保健福祉組合,6,2,決算収支の状況,1,令和4年度,1241998,1198767,43231,0,43231,2312,0,0,0,2312
2022,61,428426,長崎県,県央地域広域市町村圏組合,6,2,決算収支の状況,1,令和4年度,3959865,3526837,433028,195650,237378,33505,1,0,0,33506
2022,61,428434,長崎県,島原地域広域市町村圏組合,6,2,決算収支の状況,1,令和4年度,2421474,2346439,75035,46982,28053,5519,2,0,0,5521
2022,61,428639,長崎県,雲仙・南島原保健組合（普通会計分）,6,2,決算収支の状況,1,令和4年度,736218,733403,2815,0,2815,1,0,0,0,1
2022,61,428663,長崎県,長崎県市町村総合事務組合,6,2,決算収支の状況,1,令和4年度,6844005,6079205,764800,0,764800,198346,0,0,0,198346
2022,61,428671,長崎県,県央県南広域環境組合,6,2,決算収支の状況,1,令和4年度,5481071,5089408,391663,87145,304518,95503,3329,0,190476,-91644
2022,61,428728,長崎県,北松北部環境組合,6,2,決算収支の状況,1,令和4年度,1446989,1430078,16911,0,16911,-5025,0,0,0,-5025
2022,61,428752,長崎県,長崎県後期高齢者医療広域連合,7,2,決算収支の状況,1,令和4年度,283765,268581,15184,0,15184,2567,100342,0,67265,35644
2022,61,428761,長崎県,長与・時津環境施設組合,6,2,決算収支の状況,1,令和4年度,828693,750095,78598,0,78598,39243,0,0,39355,-112
2022,61,431001,熊本県,熊本市,1,2,決算収支の状況,1,令和4年度,412805953,403175196,9630757,2054272,7576485,903877,2794520,0,2194520,1503877
2022,61,432024,熊本県,八代市,3,2,決算収支の状況,1,令和4年度,69643644,67748733,1894911,362545,1532366,3509,4420,0,0,7929
2022,61,432032,熊本県,人吉市,4,2,決算収支の状況,1,令和4年度,22917545,21780216,1137329,177830,959499,646464,140011,0,0,786475
2022,61,432041,熊本県,荒尾市,4,2,決算収支の状況,1,令和4年度,28029880,27730411,299469,120953,178516,-332168,257337,0,0,-74831
2022,61,432059,熊本県,水俣市,4,2,決算収支の状況,1,令和4年度,16811436,15680100,1131336,36642,1094694,-2132,809,69913,0,68590
2022,61,432067,熊本県,玉名市,4,2,決算収支の状況,1,令和4年度,36722389,35252136,1470253,53731,1416522,-426715,999761,0,1000800,-427754
2022,61,432083,熊本県,山鹿市,4,2,決算収支の状況,1,令和4年度,33745796,31480583,2265213,31014,2234199,-107434,213947,0,600000,-493487
2022,61,432105,熊本県,菊池市,4,2,決算収支の状況,1,令和4年度,29760912,28981977,778935,51848,727087,28324,621265,0,1268,648321
2022,61,432113,熊本県,宇土市,4,2,決算収支の状況,1,令和4年度,23381770,21922240,1459530,177114,1282416,166776,9687,0,0,176463
2022,61,432121,熊本県,上天草市,4,2,決算収支の状況,1,令和4年度,21861161,20487805,1373356,358857,1014499,57913,481756,0,0,539669
2022,61,432130,熊本県,宇城市,4,2,決算収支の状況,1,令和4年度,35905918,34225716,1680202,646792,1033410,155367,3555,0,0,158922
2022,61,432148,熊本県,阿蘇市,4,2,決算収支の状況,1,令和4年度,20213072,18616441,1596631,173589,1423042,88558,200133,0,0,288691
2022,61,432156,熊本県,天草市,4,2,決算収支の状況,1,令和4年度,64702661,60566638,4136023,344519,3791504,326398,1769087,0,331413,1764072
2022,61,432164,熊本県,合志市,4,2,決算収支の状況,1,令和4年度,29030890,27411117,1619773,324816,1294957,9033,654135,0,45291,617877
2022,61,433489,熊本県,美里町,5,2,決算収支の状況,1,令和4年度,8543193,7925204,617989,380043,237946,-44518,148066,0,15308,88240
2022,61,433641,熊本県,玉東町,5,2,決算収支の状況,1,令和4年度,5202462,4893899,308563,43829,264734,214068,18,0,30000,184086
2022,61,433675,熊本県,南関町,5,2,決算収支の状況,1,令和4年度,7284676,7078829,205847,7116,198731,-8460,61012,0,0,52552
2022,61,433683,熊本県,長洲町,5,2,決算収支の状況,1,令和4年度,8920174,8624591,295583,117570,178013,-101365,183700,0,280000,-197665
2022,61,433691,熊本県,和水町,5,2,決算収支の状況,1,令和4年度,9094680,8494913,599767,40328,559439,-696021,60776,0,0,-635245
2022,61,434035,熊本県,大津町,5,2,決算収支の状況,1,令和4年度,18126945,16911249,1215696,113551,1102145,-42008,553138,0,0,511130
2022,61,434043,熊本県,菊陽町,5,2,決算収支の状況,1,令和4年度,21579564,20563879,1015685,309365,706320,22734,350065,362765,330000,405564
2022,61,434230,熊本県,南小国町,5,2,決算収支の状況,1,令和4年度,6396080,5755105,640975,197110,443865,-13401,229290,0,48481,167408
2022,61,434248,熊本県,小国町,5,2,決算収支の状況,1,令和4年度,8553790,7183188,1370602,594184,776418,451264,172017,0,80000,543281
2022,61,434256,熊本県,産山村,5,2,決算収支の状況,1,令和4年度,2706599,2581348,125251,9009,116242,-16817,181465,0,0,164648
2022,61,434281,熊本県,高森町,5,2,決算収支の状況,1,令和4年度,10447248,10040028,407220,327722,79498,-91892,269060,0,111000,66168
2022,61,434329,熊本県,西原村,5,2,決算収支の状況,1,令和4年度,7011576,6563284,448292,104161,344131,-266105,305430,0,227100,-187775
2022,61,434337,熊本県,南阿蘇村,5,2,決算収支の状況,1,令和4年度,14663693,13760399,903294,59771,843523,139610,2144,92112,352000,-118134
2022,61,434418,熊本県,御船町,5,2,決算収支の状況,1,令和4年度,14071351,13284490,786861,119528,667333,-147465,646507,0,101375,397667
2022,61,434426,熊本県,嘉島町,5,2,決算収支の状況,1,令和4年度,7648650,7371582,277068,72877,204191,169844,150026,0,0,319870
2022,61,434434,熊本県,益城町,5,2,決算収支の状況,1,令和4年度,24415387,21896018,2519369,235269,2284100,1351894,600,0,0,1352494
2022,61,434442,熊本県,甲佐町,5,2,決算収支の状況,1,令和4年度,9753455,8797854,955601,7200,948401,225826,105,0,426106,-200175
2022,61,434477,熊本県,山都町,5,2,決算収支の状況,1,令和4年度,16446662,15058874,1387788,388290,999498,111223,114,0,100090,11247
2022,61,434680,熊本県,氷川町,5,2,決算収支の状況,1,令和4年度,8845247,8326499,518748,15815,502933,-167746,340238,0,420000,-247508
2022,61,434825,熊本県,芦北町,5,2,決算収支の状況,1,令和4年度,14918273,14097790,820483,47038,773445,-309377,100445,0,0,-208932
2022,61,434841,熊本県,津奈木町,5,2,決算収支の状況,1,令和4年度,4580735,4333879,246856,109022,137834,30775,1966,0,0,32741
2022,61,435015,熊本県,錦町,5,2,決算収支の状況,1,令和4年度,8841191,8467662,373529,126725,246804,47447,101018,0,200000,-51535
2022,61,435058,熊本県,多良木町,5,2,決算収支の状況,1,令和4年度,9129539,8129585,999954,541426,458528,-9197,5188,15425,0,11416
2022,61,435066,熊本県,湯前町,5,2,決算収支の状況,1,令和4年度,5217065,4651055,566010,266356,299654,-51101,1458,0,0,-49643
2022,61,435074,熊本県,水上村,5,2,決算収支の状況,1,令和4年度,6429700,5737164,692536,157609,534927,-170119,4953,0,340000,-505166
2022,61,435104,熊本県,相良村,5,2,決算収支の状況,1,令和4年度,5847424,5358298,489126,207693,281433,278823,2050,0,20636,260237
2022,61,435112,熊本県,五木村,5,2,決算収支の状況,1,令和4年度,3751835,3515413,236422,32688,203734,-135653,10476,0,0,-125177
2022,61,435121,熊本県,山江村,5,2,決算収支の状況,1,令和4年度,5343308,4666383,676925,14300,662625,-2770,161619,0,65000,93849
2022,61,435139,熊本県,球磨村,5,2,決算収支の状況,1,令和4年度,8186652,6870824,1315828,509431,806397,-70599,314525,0,263000,-19074
2022,61,435147,熊本県,あさぎり町,5,2,決算収支の状況,1,令和4年度,14403450,13435971,967479,241858,725621,53268,346686,0,0,399954
2022,61,435317,熊本県,苓北町,5,2,決算収支の状況,1,令和4年度,5874180,5556929,317251,39796,277455,123869,161538,0,0,285407
2022,61,438022,熊本県,熊本県市町村総合事務組合,6,2,決算収支の状況,1,令和4年度,6953879,6032299,921580,0,921580,-210277,0,0,0,-210277
2022,61,438120,熊本県,玉名市玉東町病院設立組合,6,2,決算収支の状況,1,令和4年度,1332200,1328790,3410,0,3410,1904,0,0,0,1904
2022,61,438162,熊本県,菊池養生園保健組合,6,2,決算収支の状況,1,令和4年度,524451,493383,31068,0,31068,-16646,24002,0,0,7356
2022,61,438545,熊本県,菊池環境保全組合,6,2,決算収支の状況,1,令和4年度,1720511,1536247,184264,0,184264,11853,3,0,300000,-288144
2022,61,438570,熊本県,御船地区衛生施設組合,6,2,決算収支の状況,1,令和4年度,191652,173342,18310,0,18310,-8591,0,0,15000,-23591
2022,61,439142,熊本県,大津町・西原村原野組合,6,2,決算収支の状況,1,令和4年度,2285,1530,755,0,755,174,0,0,0,174
2022,61,439291,熊本県,氷川町及び八代市中学校組合,6,2,決算収支の状況,1,令和4年度,105770,100838,4932,0,4932,2049,0,0,0,2049
2022,61,439355,熊本県,上天草衛生施設組合,6,2,決算収支の状況,1,令和4年度,176610,165440,11170,0,11170,-4428,1,0,0,-4427
2022,61,439371,熊本県,御船町甲佐町衛生施設組合,6,2,決算収支の状況,1,令和4年度,317503,270944,46559,0,46559,9428,5,0,30000,-20567
2022,61,439495,熊本県,益城、嘉島、西原環境衛生施設組合,6,2,決算収支の状況,1,令和4年度,562110,515529,46581,0,46581,12517,21790,0,40000,-5693
2022,61,439541,熊本県,山鹿植木広域行政事務組合,6,2,決算収支の状況,1,令和4年度,302100,267604,34496,0,34496,-46787,0,0,0,-46787
2022,61,439649,熊本県,人吉下球磨消防組合,6,2,決算収支の状況,1,令和4年度,1287097,1267347,19750,203,19547,2182,25006,0,0,27188
2022,61,439657,熊本県,上益城消防組合,6,2,決算収支の状況,1,令和4年度,977780,961483,16297,0,16297,-263,12,0,7309,-7560
2022,61,439665,熊本県,上球磨消防組合,6,2,決算収支の状況,1,令和4年度,642910,627594,15316,0,15316,-1588,1,0,0,-1587
2022,61,439738,熊本県,八代広域行政事務組合,6,2,決算収支の状況,1,令和4年度,2501455,2420959,80496,0,80496,955,0,0,0,955
2022,61,439746,熊本県,八代生活環境事務組合（普通会計分）,6,2,決算収支の状況,1,令和4年度,461504,397242,64262,0,64262,-1682,0,0,0,-1682
2022,61,439851,熊本県,阿蘇広域行政事務組合,6,2,決算収支の状況,1,令和4年度,3508222,3440245,67977,737,67240,18420,0,0,0,18420
2022,61,439860,熊本県,人吉球磨広域行政組合,6,2,決算収支の状況,1,令和4年度,1898819,1535651,363168,2970,360198,178767,0,0,0,178767
2022,61,439916,熊本県,有明広域行政事務組合,6,2,決算収支の状況,1,令和4年度,4679687,4534049,145638,19985,125653,-11890,3,0,125046,-136933
2022,61,439932,熊本県,水俣芦北広域行政事務組合,6,2,決算収支の状況,1,令和4年度,1980929,1895745,85184,43890,41294,-19205,0,0,0,-19205
2022,61,439959,熊本県,宇城広域連合,6,2,決算収支の状況,1,令和4年度,8587723,8034457,553266,426944,126322,-44614,0,0,0,-44614
2022,61,439967,熊本県,菊池広域連合,6,2,決算収支の状況,1,令和4年度,2593007,2460265,132742,82710,50032,-56707,87,0,60456,-117076
2022,61,439975,熊本県,上益城広域連合,6,2,決算収支の状況,1,令和4年度,117749,98741,19008,5111,13897,2001,1,0,3000,-998
2022,61,439983,熊本県,天草広域連合,6,2,決算収支の状況,1,令和4年度,3927249,3505673,421576,213306,208270,22543,92887,0,0,115430
2022,61,439991,熊本県,熊本県後期高齢者医療広域連合,7,2,決算収支の状況,1,令和4年度,117818,108202,9616,0,9616,-1597,0,0,0,-1597
2022,61,442011,大分県,大分市,8,2,決算収支の状況,1,令和4年度,217804907,211823325,5981582,853613,5127969,-1474927,1004831,0,0,-470096
2022,61,442020,大分県,別府市,3,2,決算収支の状況,1,令和4年度,61454324,60358621,1095703,400151,695552,-348802,726628,0,200000,177826
2022,61,442038,大分県,中津市,4,2,決算収支の状況,1,令和4年度,47242914,45247569,1995345,224111,1771234,-792818,10071,0,375575,-1158322
2022,61,442046,大分県,日田市,4,2,決算収支の状況,1,令和4年度,41432774,39929818,1502956,172789,1330167,-210677,12189,0,0,-198488
2022,61,442054,大分県,佐伯市,4,2,決算収支の状況,1,令和4年度,46938645,45928670,1009975,182219,827756,-56073,447567,0,487270,-95776
2022,61,442062,大分県,臼杵市,4,2,決算収支の状況,1,令和4年度,23916544,23420097,496447,24496,471951,93359,221942,0,150000,165301
2022,61,442071,大分県,津久見市,4,2,決算収支の状況,1,令和4年度,11257569,10832271,425298,24448,400850,76796,170000,0,134668,112128
2022,61,442089,大分県,竹田市,4,2,決算収支の状況,1,令和4年度,20895305,19950353,944952,120367,824585,-322101,8178,0,0,-313923
2022,61,442097,大分県,豊後高田市,4,2,決算収支の状況,1,令和4年度,17925424,17428691,496733,30158,466575,-231450,19292,91537,0,-120621
2022,61,442101,大分県,杵築市,4,2,決算収支の状況,1,令和4年度,20933538,20090671,842867,360543,482324,-88375,282768,820018,0,1014411
2022,61,442119,大分県,宇佐市,4,2,決算収支の状況,1,令和4年度,34824617,32772574,2052043,410180,1641863,256570,13410,7734,860208,-582494
2022,61,442127,大分県,豊後大野市,4,2,決算収支の状況,1,令和4年度,29026017,27059075,1966942,285291,1681651,287521,13554,0,1166384,-865309
2022,61,442135,大分県,由布市,4,2,決算収支の状況,1,令和4年度,23522408,22677689,844719,392857,451862,349456,2068,0,353189,-1665
2022,61,442143,大分県,国東市,4,2,決算収支の状況,1,令和4年度,25097011,24464697,632314,87279,545035,-147806,174477,382544,0,409215
2022,61,443221,大分県,姫島村,5,2,決算収支の状況,1,令和4年度,3425986,3018500,407486,7908,399578,53740,159187,0,159187,53740
2022,61,443417,大分県,日出町,5,2,決算収支の状況,1,令和4年度,12874532,12349580,524952,109588,415364,-126168,83,0,0,-126085
2022,61,444618,大分県,九重町,5,2,決算収支の状況,1,令和4年度,9529065,8648472,880593,192124,688469,57783,1465,971,270000,-209781
2022,61,444626,大分県,玖珠町,5,2,決算収支の状況,1,令和4年度,11214540,10636428,578112,104684,473428,183535,972,0,263372,-78865
2022,61,448125,大分県,大分県退職手当組合,6,2,決算収支の状況,1,令和4年度,1799087,1375613,423474,0,423474,338283,8868,0,0,347151
2022,61,448133,大分県,大分県消防補償等組合,6,2,決算収支の状況,1,令和4年度,340971,340302,669,0,669,-116,9,0,1500,-1607
2022,61,448222,大分県,大分県交通災害共済組合,7,2,決算収支の状況,1,令和4年度,0,0,0,0,0,0,0,0,0,0
2022,61,448354,大分県,杵築速見環境浄化組合,6,2,決算収支の状況,1,令和4年度,274071,269196,4875,0,4875,-1364,0,0,0,-1364
2022,61,448362,大分県,別杵速見地域広域市町村圏事務組合,6,2,決算収支の状況,1,令和4年度,1410393,1410393,0,0,0,0,41,0,2694,-2653
2022,61,448389,大分県,杵築速見消防組合,6,2,決算収支の状況,1,令和4年度,955426,936491,18935,0,18935,-12727,15850,0,189,2934
2022,61,448451,大分県,大分県市町村会館管理組合,6,2,決算収支の状況,1,令和4年度,62306,57402,4904,0,4904,-3588,6204,0,0,2616
2022,61,448575,大分県,臼津広域連合,6,2,決算収支の状況,1,令和4年度,105290,98088,7202,0,7202,3266,0,0,0,3266
2022,61,448591,大分県,大分県後期高齢者医療広域連合,7,2,決算収支の状況,1,令和4年度,342781,228663,114118,0,114118,-18681,132995,0,133269,-18955
2022,61,448605,大分県,日田玖珠広域消防組合,6,2,決算収支の状況,1,令和4年度,1061012,1049432,11580,1529,10051,-593,5708,0,0,5115
2022,61,448613,大分県,玖珠九重行政事務組合,6,2,決算収支の状況,1,令和4年度,651573,626372,25201,0,25201,-3542,0,0,0,-3542
2022,61,448621,大分県,宇佐・高田・国東広域事務組合,6,2,決算収支の状況,1,令和4年度,315559,257395,58164,46780,11384,-2208,0,0,0,-2208
2022,61,452017,宮崎県,宮崎市,8,2,決算収支の状況,1,令和4年度,193271715,188663443,4608272,749013,3859259,-1009410,62236,0,0,-947174
2022,61,452025,宮崎県,都城市,3,2,決算収支の状況,1,令和4年度,128340867,124649700,3691167,2170144,1521023,26758,1449101,0,643562,832297
2022,61,452033,宮崎県,延岡市,3,2,決算収支の状況,1,令和4年度,73095850,69471701,3624149,1519999,2104150,-439835,1062188,0,1062188,-439835
2022,61,452041,宮崎県,日南市,4,2,決算収支の状況,1,令和4年度,37362336,35973505,1388831,825238,563593,-440457,507426,0,507426,-440457
2022,61,452050,宮崎県,小林市,4,2,決算収支の状況,1,令和4年度,30631839,29673201,958638,599095,359543,-563956,104328,0,0,-459628
2022,61,452068,宮崎県,日向市,4,2,決算収支の状況,1,令和4年度,34054545,33161395,893150,160646,732504,17628,959,0,200000,-181413
2022,61,452076,宮崎県,串間市,4,2,決算収支の状況,1,令和4年度,15800239,15147200,653039,21262,631777,91605,300000,0,1114036,-722431
2022,61,452084,宮崎県,西都市,4,2,決算収支の状況,1,令和4年度,24037074,23095065,942009,205809,736200,11427,356621,0,342255,25793
2022,61,452092,宮崎県,えびの市,4,2,決算収支の状況,1,令和4年度,14998313,14221431,776882,113116,663766,-32451,348131,0,0,315680
2022,61,453412,宮崎県,三股町,5,2,決算収支の状況,1,令和4年度,12884152,12159849,724303,239315,484988,-2533,244146,0,170248,71365
2022,61,453617,宮崎県,高原町,5,2,決算収支の状況,1,令和4年度,7193438,7099301,94137,4158,89979,-67697,151075,0,150000,-66622
2022,61,453820,宮崎県,国富町,5,2,決算収支の状況,1,令和4年度,10341703,9941967,399736,34317,365419,-57069,121337,0,280000,-215732
2022,61,453838,宮崎県,綾町,5,2,決算収支の状況,1,令和4年度,6581813,6306243,275570,59964,215606,-9715,112687,28891,60727,71136
2022,61,454010,宮崎県,高鍋町,5,2,決算収支の状況,1,令和4年度,11527255,10920436,606819,71248,535571,41324,135,0,17672,23787
2022,61,454028,宮崎県,新富町,5,2,決算収支の状況,1,令和4年度,14484607,13891583,593024,196513,396511,115769,198705,0,0,314474
2022,61,454036,宮崎県,西米良村,5,2,決算収支の状況,1,令和4年度,2955794,2560348,395446,199089,196357,102211,47083,0,69855,79439
2022,61,454044,宮崎県,木城町,5,2,決算収支の状況,1,令和4年度,7756500,7528490,228010,38338,189672,-18739,0,0,387940,-406679
2022,61,454052,宮崎県,川南町,5,2,決算収支の状況,1,令和4年度,14243733,13768859,474874,123587,351287,61188,778744,0,778744,61188
2022,61,454061,宮崎県,都農町,5,2,決算収支の状況,1,令和4年度,11175617,10394556,781061,313572,467489,-28627,40,0,264057,-292644
2022,61,454214,宮崎県,門川町,5,2,決算収支の状況,1,令和4年度,11585195,11134139,451056,19119,431937,-104915,630029,0,881000,-355886
2022,61,454290,宮崎県,諸塚村,5,2,決算収支の状況,1,令和4年度,4239928,3975254,264674,189653,75021,-4999,100650,0,200000,-104349
2022,61,454303,宮崎県,椎葉村,5,2,決算収支の状況,1,令和4年度,7525886,6700745,825141,662012,163129,284,180,0,123737,-123273
2022,61,454311,宮崎県,美郷町,5,2,決算収支の状況,1,令和4年度,9507103,8901239,605864,525714,80150,-167231,229,0,200000,-367002
2022,61,454419,宮崎県,高千穂町,5,2,決算収支の状況,1,令和4年度,9821287,9404266,417021,155699,261322,-62677,3382,0,382466,-441761
2022,61,454427,宮崎県,日之影町,5,2,決算収支の状況,1,令和4年度,5921324,5619921,301403,247954,53449,1493,40,0,0,1533
2022,61,454435,宮崎県,五ケ瀬町,5,2,決算収支の状況,1,令和4年度,5171114,4902329,268785,234734,34051,-14717,3356,0,200000,-211361
2022,61,458112,宮崎県,高鍋・木城衛生組合,6,2,決算収支の状況,1,令和4年度,123394,111967,11427,0,11427,4358,3540,0,7000,898
2022,61,458121,宮崎県,川南都農衛生組合,6,2,決算収支の状況,1,令和4年度,109902,106907,2995,0,2995,-2951,5946,0,10000,-7005
2022,61,458155,宮崎県,宮崎県北部広域行政事務組合,6,2,決算収支の状況,1,令和4年度,29464,24942,4522,0,4522,-73,0,0,0,-73
2022,61,458252,宮崎県,西臼杵広域行政事務組合,6,2,決算収支の状況,1,令和4年度,1060190,1048859,11331,0,11331,545,21860,0,27377,-4972
2022,61,458279,宮崎県,宮崎県東児湯消防組合,6,2,決算収支の状況,1,令和4年度,1069632,1054270,15362,0,15362,3172,0,0,18883,-15711
2022,61,458309,宮崎県,西諸広域行政事務組合,6,2,決算収支の状況,1,令和4年度,1278569,1242710,35859,0,35859,-13536,0,0,0,-13536
2022,61,458325,宮崎県,入郷地区衛生組合,6,2,決算収支の状況,1,令和4年度,148908,143480,5428,0,5428,-3481,5000,0,43118,-41599
2022,61,458333,宮崎県,日南串間広域不燃物処理組合,6,2,決算収支の状況,1,令和4年度,321613,260867,60746,16907,43839,13777,0,0,0,13777
2022,61,458368,宮崎県,西都児湯環境整備事務組合,6,2,決算収支の状況,1,令和4年度,1075995,974854,101141,0,101141,29406,41877,0,7500,63783
2022,61,458414,宮崎県,宮崎県市町村総合事務組合（普通会計分）,6,2,決算収支の状況,1,令和4年度,1995569,1779067,216502,0,216502,64172,3000,0,12500,54672
2022,61,458422,宮崎県,宮崎県市町村総合事務組合（事業会計分）,7,2,決算収支の状況,1,令和4年度,0,0,0,0,0,0,0,0,0,0
2022,61,458449,宮崎県,日向東臼杵広域連合,6,2,決算収支の状況,1,令和4年度,624332,609752,14580,0,14580,550,0,0,0,550
2022,61,458457,宮崎県,宮崎県後期高齢者医療広域連合,7,2,決算収支の状況,1,令和4年度,111608,106858,4750,0,4750,-1242,5994,0,5994,-1242
2022,61,462012,鹿児島県,鹿児島市,8,2,決算収支の状況,1,令和4年度,293890590,284550019,9340571,2485611,6854960,-2324863,939,0,1728811,-4052735
2022,61,462039,鹿児島県,鹿屋市,3,2,決算収支の状況,1,令和4年度,63327482,61697756,1629726,77021,1552705,-937823,1254867,0,358488,-41444
2022,61,462047,鹿児島県,枕崎市,4,2,決算収支の状況,1,令和4年度,15819938,15028076,791862,9804,782058,72066,675450,0,2600,744916
2022,61,462063,鹿児島県,阿久根市,4,2,決算収支の状況,1,令和4年度,14060930,13526604,534326,3679,530647,-203636,372352,236200,372335,32581
2022,61,462080,鹿児島県,出水市,4,2,決算収支の状況,1,令和4年度,31389517,29632397,1757120,313197,1443923,77024,300,0,200000,-122676
2022,61,462101,鹿児島県,指宿市,4,2,決算収支の状況,1,令和4年度,28123852,26673393,1450459,55248,1395211,84438,6591,0,662692,-571663
2022,61,462136,鹿児島県,西之表市,4,2,決算収支の状況,1,令和4年度,12721912,12198617,523295,22234,501061,258045,317359,0,364680,210724
2022,61,462144,鹿児島県,垂水市,4,2,決算収支の状況,1,令和4年度,13288858,12852128,436730,34581,402149,-31159,368414,0,138535,198720
2022,61,462152,鹿児島県,薩摩川内市,4,2,決算収支の状況,1,令和4年度,61284112,57530609,3753503,444881,3308622,437632,1427838,9577,1539602,335445
2022,61,462161,鹿児島県,日置市,4,2,決算収支の状況,1,令和4年度,30767142,29501128,1266014,124591,1141423,-62720,8583,0,0,-54137
2022,61,462179,鹿児島県,曽於市,4,2,決算収支の状況,1,令和4年度,30724110,29443108,1281002,489653,791349,8806,453947,361568,407616,416705
2022,61,462187,鹿児島県,霧島市,3,2,決算収支の状況,1,令和4年度,73033295,68281919,4751376,1230452,3520924,383653,1400996,0,1519368,265281
2022,61,462195,鹿児島県,いちき串木野市,4,2,決算収支の状況,1,令和4年度,18167343,17441519,725824,63225,662599,-123830,1041,0,0,-122789
2022,61,462209,鹿児島県,南さつま市,4,2,決算収支の状況,1,令和4年度,33059157,31932370,1126787,39361,1087426,-49717,112495,400000,122441,340337
2022,61,462217,鹿児島県,志布志市,4,2,決算収支の状況,1,令和4年度,33173482,32271128,902354,12555,889799,219583,3530,0,0,223113
2022,61,462225,鹿児島県,奄美市,4,2,決算収支の状況,1,令和4年度,35603725,34472453,1131272,151581,979691,29004,811,0,108072,-78257
2022,61,462233,鹿児島県,南九州市,4,2,決算収支の状況,1,令和4年度,26122173,25270138,852035,197037,654998,38750,7052,0,0,45802
2022,61,462241,鹿児島県,伊佐市,4,2,決算収支の状況,1,令和4年度,20629500,19110766,1518734,418381,1100353,-159324,639200,0,827500,-347624
2022,61,462250,鹿児島県,姶良市,4,2,決算収支の状況,1,令和4年度,36202968,35097130,1105838,189148,916690,-489740,277,0,130000,-619463
2022,61,463035,鹿児島県,三島村,5,2,決算収支の状況,1,令和4年度,2365281,2175859,189422,36749,152673,-144440,134031,435974,326600,98965
2022,61,463043,鹿児島県,十島村,5,2,決算収支の状況,1,令和4年度,5487331,5359217,128114,52615,75499,9606,92651,148824,128200,122881
2022,61,463922,鹿児島県,さつま町,5,2,決算収支の状況,1,令和4年度,16796792,15520616,1276176,232641,1043535,-110731,6238,0,700000,-804493
2022,61,464040,鹿児島県,長島町,5,2,決算収支の状況,1,令和4年度,12462968,11648105,814863,93778,721085,12756,0,0,0,12756
2022,61,464520,鹿児島県,湧水町,5,2,決算収支の状況,1,令和4年度,8605031,8148551,456480,94854,361626,-66932,130346,0,170000,-106586
2022,61,464686,鹿児島県,大崎町,5,2,決算収支の状況,1,令和4年度,13243497,12743584,499913,9664,490249,-42662,6278,0,300000,-336384
2022,61,464821,鹿児島県,東串良町,5,2,決算収支の状況,1,令和4年度,7581195,7384376,196819,13225,183594,-110351,2629,0,220480,-328202
2022,61,464902,鹿児島県,錦江町,5,2,決算収支の状況,1,令和4年度,7352674,7210188,142486,6386,136100,19733,60476,0,291752,-211543
2022,61,464911,鹿児島県,南大隅町,5,2,決算収支の状況,1,令和4年度,7572991,7268878,304113,13393,290720,4192,1784,0,5810,166
2022,61,464929,鹿児島県,肝付町,5,2,決算収支の状況,1,令和4年度,11689829,11115008,574821,4694,570127,25139,296476,0,272494,49121
2022,61,465011,鹿児島県,中種子町,5,2,決算収支の状況,1,令和4年度,8078563,7983963,94600,54437,40163,-5734,192,0,40576,-46118
2022,61,465020,鹿児島県,南種子町,5,2,決算収支の状況,1,令和4年度,6352648,6243661,108987,59699,49288,-2843,18,0,0,-2825
2022,61,465054,鹿児島県,屋久島町,5,2,決算収支の状況,1,令和4年度,14621625,13953846,667779,321481,346298,116082,178104,0,209736,84450
2022,61,465232,鹿児島県,大和村,5,2,決算収支の状況,1,令和4年度,3783009,3608561,174448,49148,125300,45603,367300,0,280000,132903
2022,61,465241,鹿児島県,宇検村,5,2,決算収支の状況,1,令和4年度,3725670,3553743,171927,5490,166437,-69123,100104,0,0,30981
2022,61,465259,鹿児島県,瀬戸内町,5,2,決算収支の状況,1,令和4年度,11787863,11111287,676576,106990,569586,-153578,361583,0,348926,-140921
2022,61,465275,鹿児島県,龍郷町,5,2,決算収支の状況,1,令和4年度,7517201,7364039,153162,40186,112976,21417,375,0,420000,-398208
2022,61,465291,鹿児島県,喜界町,5,2,決算収支の状況,1,令和4年度,7141610,6963918,177692,74709,102983,9066,297,0,150000,-140637
2022,61,465305,鹿児島県,徳之島町,5,2,決算収支の状況,1,令和4年度,10059536,9469321,590215,224244,365971,-117326,472,0,0,-116854
2022,61,465313,鹿児島県,天城町,5,2,決算収支の状況,1,令和4年度,7978612,7577715,400897,24239,376658,79912,167783,0,402565,-154870
2022,61,465321,鹿児島県,伊仙町,5,2,決算収支の状況,1,令和4年度,7842572,7629054,213518,197480,16038,-42975,0,0,54463,-97438
2022,61,465330,鹿児島県,和泊町,5,2,決算収支の状況,1,令和4年度,7190783,7047006,143777,15836,127941,73956,110091,0,0,184047
2022,61,465348,鹿児島県,知名町,5,2,決算収支の状況,1,令和4年度,7657873,7274439,383434,237330,146104,-68180,110209,0,107000,-64971
2022,61,465356,鹿児島県,与論町,5,2,決算収支の状況,1,令和4年度,6128544,5893042,235502,115277,120225,-85386,21,0,5,-85370
2022,61,468045,鹿児島県,鹿児島県市町村総合事務組合,6,2,決算収支の状況,1,令和4年度,11750887,11426097,324790,0,324790,-19693,1,0,0,-19692
2022,61,468088,鹿児島県,いちき串木野市・日置市衛生処理組合,6,2,決算収支の状況,1,令和4年度,370366,351028,19338,7601,11737,-6358,7009,0,0,651
2022,61,468118,鹿児島県,南薩地区衛生管理組合,6,2,決算収支の状況,1,令和4年度,2629267,2410533,218734,0,218734,140212,0,0,0,140212
2022,61,468487,鹿児島県,指宿南九州消防組合,6,2,決算収支の状況,1,令和4年度,1775172,1751818,23354,0,23354,-5429,2,0,0,-5427
2022,61,468541,鹿児島県,指宿広域市町村圏組合,6,2,決算収支の状況,1,令和4年度,1121272,1107167,14105,0,14105,-2266,0,0,4809,-7075
2022,61,468550,鹿児島県,曽於北部衛生処理組合,6,2,決算収支の状況,1,令和4年度,126168,120357,5811,0,5811,391,0,0,0,391
2022,61,468614,鹿児島県,南大隅衛生管理組合,6,2,決算収支の状況,1,令和4年度,119431,111824,7607,0,7607,4755,64,0,15000,-10181
2022,61,468703,鹿児島県,中南衛生管理組合,6,2,決算収支の状況,1,令和4年度,123033,114276,8757,0,8757,1211,0,0,0,1211
2022,61,468720,鹿児島県,大島地区衛生組合,6,2,決算収支の状況,1,令和4年度,901575,849819,51756,0,51756,11401,0,0,0,11401
2022,61,468797,鹿児島県,阿久根地区消防組合,6,2,決算収支の状況,1,令和4年度,618504,606101,12403,7194,5209,-1819,0,0,0,-1819
2022,61,468801,鹿児島県,伊佐湧水消防組合,6,2,決算収支の状況,1,令和4年度,888411,874427,13984,0,13984,419,7504,0,500,7423
2022,61,468878,鹿児島県,沖永良部衛生管理組合,6,2,決算収支の状況,1,令和4年度,229162,229162,0,0,0,-30,4967,0,0,4937
2022,61,468908,鹿児島県,伊佐北姶良環境管理組合,6,2,決算収支の状況,1,令和4年度,680129,639403,40726,0,40726,2687,0,0,0,2687
2022,61,468916,鹿児島県,大隅曽於地区消防組合,6,2,決算収支の状況,1,令和4年度,1138994,1129130,9864,0,9864,-3981,27,0,15760,-19714
2022,61,468924,鹿児島県,大隅肝属地区消防組合,6,2,決算収支の状況,1,令和4年度,2055163,2042010,13153,0,13153,-4343,9144,0,0,4801
2022,61,468941,鹿児島県,伊佐北姶良火葬場管理組合,6,2,決算収支の状況,1,令和4年度,45331,43291,2040,0,2040,-442,0,0,0,-442
2022,61,469033,鹿児島県,沖永良部与論地区広域事務組合,6,2,決算収支の状況,1,令和4年度,423204,423132,72,0,72,-3093,20,0,0,-3073
2022,61,469041,鹿児島県,北薩広域行政事務組合,6,2,決算収支の状況,1,令和4年度,871315,833939,37376,0,37376,13500,0,0,0,13500
2022,61,469068,鹿児島県,徳之島地区消防組合,6,2,決算収支の状況,1,令和4年度,459571,455775,3796,0,3796,-135,1966,0,6000,-4169
2022,61,469084,鹿児島県,曽於南部厚生事務組合,6,2,決算収支の状況,1,令和4年度,429471,384221,45250,0,45250,-6873,13501,0,0,6628
2022,61,469114,鹿児島県,熊毛地区消防組合,6,2,決算収支の状況,1,令和4年度,955541,918944,36597,7944,28653,1770,5000,0,0,6770
2022,61,469122,鹿児島県,大島地区消防組合,6,2,決算収支の状況,1,令和4年度,1462070,1445982,16088,0,16088,-3874,1573,0,1324,-3625
2022,61,469157,鹿児島県,奄美群島広域事務組合,6,2,決算収支の状況,1,令和4年度,598907,575960,22947,0,22947,-10212,10351,0,0,139
2022,61,469190,鹿児島県,南薩介護保険事務組合,6,2,決算収支の状況,1,令和4年度,224077,209422,14655,0,14655,-1866,0,0,0,-1866
2022,61,469211,鹿児島県,姶良・伊佐地区介護保険組合,6,2,決算収支の状況,1,令和4年度,120144,89984,30160,0,30160,-10085,0,0,0,-10085
2022,61,469220,鹿児島県,曽於地区介護保険組合,6,2,決算収支の状況,1,令和4年度,154226,140456,13770,0,13770,-2985,8700,0,0,5715
2022,61,469246,鹿児島県,種子島地区広域事務組合,6,2,決算収支の状況,1,令和4年度,719663,704007,15656,0,15656,2029,0,0,0,2029
2022,61,469254,鹿児島県,徳之島地区介護保険組合,6,2,決算収支の状況,1,令和4年度,53732,47774,5958,0,5958,-2644,0,0,0,-2644
2022,61,469262,鹿児島県,奄美大島地区介護保険一部事務組合,6,2,決算収支の状況,1,令和4年度,46745,43343,3402,0,3402,-1685,0,0,0,-1685
2022,61,469289,鹿児島県,大隅肝属広域事務組合,6,2,決算収支の状況,1,令和4年度,1702708,1621098,81610,3143,78467,26575,52154,0,27716,51013
2022,61,469297,鹿児島県,徳之島愛ランド広域連合,6,2,決算収支の状況,1,令和4年度,575455,528068,47387,22000,25387,-24994,0,0,0,-24994
2022,61,469319,鹿児島県,鹿児島県後期高齢者医療広域連合,7,2,決算収支の状況,1,令和4年度,83505,78713,4792,0,4792,168,0,0,0,168
2022,61,472018,沖縄県,那覇市,8,2,決算収支の状況,1,令和4年度,187068826,178547046,8521780,996709,7525071,1046815,3239258,0,3240672,1045401
2022,61,472051,沖縄県,宜野湾市,3,2,決算収支の状況,1,令和4年度,57839228,55696291,2142937,407225,1735712,312363,744001,0,0,1056364
2022,61,472077,沖縄県,石垣市,4,2,決算収支の状況,1,令和4年度,35583348,34273640,1309708,304543,1005165,211926,380001,11633,0,603560
2022,61,472085,沖縄県,浦添市,3,2,決算収支の状況,1,令和4年度,59815018,58210963,1604055,561398,1042657,-1167596,1552234,28172,0,412810
2022,61,472093,沖縄県,名護市,4,2,決算収支の状況,1,令和4年度,48871056,46989602,1881454,279976,1601478,-352342,1809736,0,1702016,-244622
2022,61,472107,沖縄県,糸満市,4,2,決算収支の状況,1,令和4年度,32009119,31350937,658182,220512,437670,-383700,0,0,250000,-633700
2022,61,472115,沖縄県,沖縄市,3,2,決算収支の状況,1,令和4年度,81293466,78574481,2718985,1089855,1629130,578083,526001,0,475577,628507
2022,61,472123,沖縄県,豊見城市,4,2,決算収支の状況,1,令和4年度,33668647,33310694,357953,114004,243949,-965817,545,0,0,-965272
2022,61,472131,沖縄県,うるま市,3,2,決算収支の状況,1,令和4年度,76045763,72086687,3959076,507865,3451211,444087,1958878,0,2438773,-35808
2022,61,472140,沖縄県,宮古島市,4,2,決算収支の状況,1,令和4年度,42954051,41822296,1131755,395086,736669,-1341796,1623724,198224,1000000,-519848
2022,61,472158,沖縄県,南城市,4,2,決算収支の状況,1,令和4年度,29479903,27245760,2234143,272207,1961936,682403,1321345,0,1443533,560215
2022,61,473014,沖縄県,国頭村,5,2,決算収支の状況,1,令和4年度,6414236,5992168,422068,96660,325408,-265515,200005,0,0,-65510
2022,61,473022,沖縄県,大宜味村,5,2,決算収支の状況,1,令和4年度,5707047,5092005,615042,226306,388736,31035,199916,0,378589,-147638
2022,61,473031,沖縄県,東村,5,2,決算収支の状況,1,令和4年度,3559609,3383388,176221,12685,163536,-23965,93751,0,0,69786
2022,61,473065,沖縄県,今帰仁村,5,2,決算収支の状況,1,令和4年度,9262442,8239015,1023427,208788,814639,142347,498254,0,394336,246265
2022,61,473081,沖縄県,本部町,5,2,決算収支の状況,1,令和4年度,9554154,9177077,377077,13964,363113,-87047,203000,0,0,115953
2022,61,473111,沖縄県,恩納村,5,2,決算収支の状況,1,令和4年度,13004882,12167893,836989,214257,622732,81364,527937,0,383255,226046
2022,61,473138,沖縄県,宜野座村,5,2,決算収支の状況,1,令和4年度,9361658,8867766,493892,306218,187674,135568,354952,0,349746,140774
2022,61,473146,沖縄県,金武町,5,2,決算収支の状況,1,令和4年度,13226175,12943897,282278,161207,121071,37454,4,0,6058,31400
2022,61,473154,沖縄県,伊江村,5,2,決算収支の状況,1,令和4年度,7154372,6759509,394863,155276,239587,195696,50526,0,100000,146222
2022,61,473243,沖縄県,読谷村,5,2,決算収支の状況,1,令和4年度,21396603,20667484,729119,135075,594044,131312,574000,0,728000,-22688
2022,61,473251,沖縄県,嘉手納町,5,2,決算収支の状況,1,令和4年度,12253850,11811141,442709,157052,285657,39007,18422,0,40001,17428
2022,61,473260,沖縄県,北谷町,5,2,決算収支の状況,1,令和4年度,19331659,18015766,1315893,342989,972904,-13709,934268,0,242467,678092
2022,61,473278,沖縄県,北中城村,5,2,決算収支の状況,1,令和4年度,9256284,8819650,436634,18878,417756,98135,168811,0,95495,171451
2022,61,473286,沖縄県,中城村,5,2,決算収支の状況,1,令和4年度,10775283,10212248,563035,118948,444087,110285,241875,0,240046,112114
2022,61,473294,沖縄県,西原町,5,2,決算収支の状況,1,令和4年度,15212827,14666496,546331,128441,417890,-162918,436464,0,314864,-41318
2022,61,473481,沖縄県,与那原町,5,2,決算収支の状況,1,令和4年度,8993421,8637922,355499,18137,337362,-96678,23716,0,0,-72962
2022,61,473502,沖縄県,南風原町,5,2,決算収支の状況,1,令和4年度,18014526,17524321,490205,229627,260578,-14053,950987,0,152019,784915
2022,61,473537,沖縄県,渡嘉敷村,5,2,決算収支の状況,1,令和4年度,1716691,1605400,111291,3062,108229,-28743,100012,0,0,71269
2022,61,473545,沖縄県,座間味村,5,2,決算収支の状況,1,令和4年度,2597951,2413192,184759,31266,153493,1785,250962,0,77500,175247
2022,61,473553,沖縄県,粟国村,5,2,決算収支の状況,1,令和4年度,2473871,2153483,320388,30300,290088,105020,238645,0,186112,157553
2022,61,473561,沖縄県,渡名喜村,5,2,決算収支の状況,1,令和4年度,1184562,1080374,104188,13045,91143,10254,61191,0,70000,1445
2022,61,473570,沖縄県,南大東村,5,2,決算収支の状況,1,令和4年度,3328164,3043418,284746,71516,213230,-93087,255970,0,0,162883
2022,61,473588,沖縄県,北大東村,5,2,決算収支の状況,1,令和4年度,2538801,2393055,145746,37239,108507,52498,194917,0,149702,97713
2022,61,473596,沖縄県,伊平屋村,5,2,決算収支の状況,1,令和4年度,4337706,4051390,286316,40420,245896,-49940,147919,0,127230,-29251
2022,61,473600,沖縄県,伊是名村,5,2,決算収支の状況,1,令和4年度,3738906,3515352,223554,71055,152499,19324,208826,0,0,228150
2022,61,473618,沖縄県,久米島町,5,2,決算収支の状況,1,令和4年度,9134366,8664485,469881,115495,354386,-92466,461024,0,271321,97237
2022,61,473626,沖縄県,八重瀬町,5,2,決算収支の状況,1,令和4年度,17957962,17075261,882701,57024,825677,-16211,422470,0,454790,-48531
2022,61,473758,沖縄県,多良間村,5,2,決算収支の状況,1,令和4年度,3857218,3656552,200666,12833,187833,16963,359814,0,1207614,-830837
2022,61,473812,沖縄県,竹富町,5,2,決算収支の状況,1,令和4年度,10270235,9468254,801981,445959,356022,-161614,323617,32176,0,194179
2022,61,473821,沖縄県,与那国町,5,2,決算収支の状況,1,令和4年度,3796170,3466584,329586,35460,294126,-123380,403942,0,100000,180562
2022,61,478032,沖縄県,倉浜衛生施設組合,6,2,決算収支の状況,1,令和4年度,3433223,3277228,155995,45563,110432,31946,291362,0,0,323308
2022,61,478075,沖縄県,沖縄県市町村自治会館管理組合,6,2,決算収支の状況,1,令和4年度,184087,166827,17260,0,17260,-2610,17370,0,0,14760
2022,61,478091,沖縄県,本部町今帰仁村清掃施設組合,6,2,決算収支の状況,1,令和4年度,833839,763716,70123,61650,8473,2331,0,0,9200,-6869
2022,61,478113,沖縄県,本部町・今帰仁村消防組合,6,2,決算収支の状況,1,令和4年度,461523,450143,11380,6217,5163,-3943,1000,0,0,-2943
2022,61,478156,沖縄県,沖縄県市町村総合事務組合,6,2,決算収支の状況,1,令和4年度,7915917,7507371,408546,0,408546,-102626,0,0,0,-102626
2022,61,478181,沖縄県,島尻消防組合,6,2,決算収支の状況,1,令和4年度,1664917,1302665,362252,351615,10637,3367,32716,0,25444,10639
2022,61,478199,沖縄県,東部消防組合,6,2,決算収支の状況,1,令和4年度,1745239,1701568,43671,0,43671,40913,16150,0,17491,39572
2022,61,478229,沖縄県,中城村北中城村清掃事務組合,6,2,決算収支の状況,1,令和4年度,470233,449333,20900,0,20900,11013,5001,0,0,16014
2022,61,478237,沖縄県,中部衛生施設組合,6,2,決算収支の状況,1,令和4年度,248721,237194,11527,0,11527,1677,21934,0,0,23611
2022,61,478245,沖縄県,中城北中城消防組合,6,2,決算収支の状況,1,令和4年度,605968,587415,18553,220,18333,-2231,15000,0,1322,11447
2022,61,478253,沖縄県,金武地区消防衛生組合,6,2,決算収支の状況,1,令和4年度,1007594,977712,29882,7086,22796,-12921,0,0,0,-12921
2022,61,478296,沖縄県,国頭地区行政事務組合,6,2,決算収支の状況,1,令和4年度,681893,667921,13972,0,13972,6747,0,0,0,6747
2022,61,478300,沖縄県,南部広域行政組合,6,2,決算収支の状況,1,令和4年度,3838587,3546178,292409,137405,155004,59309,144482,0,105892,97899
2022,61,478351,沖縄県,中部広域市町村圏事務組合,6,2,決算収支の状況,1,令和4年度,262849,206626,56223,0,56223,14762,2112,0,2538,14336
2022,61,478369,沖縄県,八重山広域市町村圏事務組合,6,2,決算収支の状況,1,令和4年度,465797,448899,16898,0,16898,4276,6218,0,0,10494
2022,61,478377,沖縄県,南部広域市町村圏事務組合,6,2,決算収支の状況,1,令和4年度,634949,571708,63241,5483,57758,4514,560,0,1000,4074
2022,61,478385,沖縄県,北部広域市町村圏事務組合,6,2,決算収支の状況,1,令和4年度,5231144,5208098,23046,0,23046,14495,32318,0,7137,39676
2022,61,478393,沖縄県,比謝川行政事務組合,6,2,決算収支の状況,1,令和4年度,2607331,2575048,32283,0,32283,-15582,47399,0,103132,-71315
2022,61,478407,沖縄県,中部北環境施設組合,6,2,決算収支の状況,1,令和4年度,1502702,1429981,72721,0,72721,13429,59978,0,0,73407
2022,61,478423,沖縄県,那覇市・南風原町環境施設組合,6,2,決算収支の状況,1,令和4年度,3277840,3151449,126391,42047,84344,-81255,82800,0,81695,-80150
2022,61,478431,沖縄県,那覇港管理組合,6,2,決算収支の状況,1,令和4年度,3784616,3506647,277969,90878,187091,-9845,153833,0,192842,-48854
2022,61,478440,沖縄県,沖縄県介護保険広域連合,6,2,決算収支の状況,1,令和4年度,1241225,1185432,55793,0,55793,12400,21697,0,29658,4439
2022,61,478458,沖縄県,沖縄県後期高齢者医療広域連合,7,2,決算収支の状況,1,令和4年度,152592,133156,19436,0,19436,-15138,17527,0,0,2389
2022,61,合計(全国),,,,2,決算収支の状況,1,令和4年度,70407575400,67814240812,2593334588,523525440,2069809148,-260175542,833239575,88585710,679658550,-18008807
決算年度,業務コード,団体コード ,県名,団体名,団体区分,表番号,表名称,行番号,行名称,001:歳入総額,002:歳出総額,003:歳入歳出差引,004:翌年度に繰り越すべき財源,005:実質収支,006:単年度収支,007:積立金,008:繰上償還金,009:積立金取崩し額,010:実質単年度収支
2022,61,11002,北海道,札幌市,1,2,決算収支の状況,2,令和3年度,1295698111,1281258738,14439373,4477705,9961668,-2267558,645,0,5700000,-7966913
2022,61,12025,北海道,函館市,8,2,決算収支の状況,2,令和3年度,146534785,142484781,4050004,905386,3144618,1089926,1018039,58897,0,2166862
2022,61,12033,北海道,小樽市,3,2,決算収支の状況,2,令和3年度,68157351,66291831,1865520,140670,1724850,1512722,82835,0,0,1595557
2022,61,12041,北海道,旭川市,8,2,決算収支の状況,2,令和3年度,193121176,185661269,7459907,950295,6509612,4113224,6682,0,0,4119906
2022,61,12050,北海道,室蘭市,4,2,決算収支の状況,2,令和3年度,50411719,49517149,894570,15792,878778,23635,7,0,0,23642
2022,61,12068,北海道,釧路市,3,2,決算収支の状況,2,令和3年度,107647417,102901683,4745734,477891,4267843,3641721,269,0,0,3641990
2022,61,12076,北海道,帯広市,3,2,決算収支の状況,2,令和3年度,95602576,93255674,2346902,90591,2256311,982667,637643,0,0,1620310
2022,61,12084,北海道,北見市,3,2,決算収支の状況,2,令和3年度,76823809,75436352,1387457,378458,1008999,756223,19,0,0,756242
2022,61,12092,北海道,夕張市,4,2,決算収支の状況,2,令和3年度,11727241,10924802,802439,156856,645583,401351,229271,0,0,630622
2022,61,12106,北海道,岩見沢市,4,2,決算収支の状況,2,令和3年度,56692520,56215712,476808,78328,398480,260632,68724,2251,700000,-368393
2022,61,12114,北海道,網走市,4,2,決算収支の状況,2,令和3年度,32675692,32322288,353404,230293,123111,10896,56274,0,0,67170
2022,61,12122,北海道,留萌市,4,2,決算収支の状況,2,令和3年度,16335107,15750173,584934,12465,572469,282567,144969,0,0,427536
2022,61,12131,北海道,苫小牧市,3,2,決算収支の状況,2,令和3年度,89921181,87727276,2193905,253962,1939943,774867,2018927,0,1609221,1184573
2022,61,12149,北海道,稚内市,4,2,決算収支の状況,2,令和3年度,31477615,31073988,403627,155488,248139,-25152,333251,0,0,308099
2022,61,12157,北海道,美唄市,4,2,決算収支の状況,2,令和3年度,19134481,18767277,367204,31380,335824,6784,450223,0,0,457007
2022,61,12165,北海道,芦別市,4,2,決算収支の状況,2,令和3年度,12332531,11845807,486724,164745,321979,215123,257120,0,0,472243
2022,61,12173,北海道,江別市,3,2,決算収支の状況,2,令和3年度,56610753,55077207,1533546,13514,1520032,524748,1145937,0,400,1670285
2022,61,12181,北海道,赤平市,4,2,決算収支の状況,2,令和3年度,13262442,12699564,562878,900,561978,78613,90857,0,0,169470
2022,61,12190,北海道,紋別市,4,2,決算収支の状況,2,令和3年度,42580832,41863459,717373,81402,635971,-39303,445796,0,0,406493
2022,61,12203,北海道,士別市,4,2,決算収支の状況,2,令和3年度,17963960,17262267,701693,3075,698618,658126,112201,0,0,770327
2022,61,12211,北海道,名寄市,4,2,決算収支の状況,2,令和3年度,24203040,23739090,463950,1895,462055,81852,526,0,48099,34279
2022,61,12220,北海道,三笠市,4,2,決算収支の状況,2,令和3年度,11435792,11249951,185841,2868,182973,50017,1030190,0,587762,492445
2022,61,12238,北海道,根室市,4,2,決算収支の状況,2,令和3年度,46024885,44894752,1130133,727,1129406,503769,648021,0,0,1151790
2022,61,12246,北海道,千歳市,4,2,決算収支の状況,2,令和3年度,61210462,59938776,1271686,820487,451199,-20040,10076,0,300000,-309964
2022,61,12254,北海道,滝川市,4,2,決算収支の状況,2,令和3年度,26092199,24979676,1112523,118,1112405,82402,217628,0,0,300030
2022,61,12262,北海道,砂川市,4,2,決算収支の状況,2,令和3年度,15386710,14561837,824873,12317,812556,386486,173784,0,0,560270
2022,61,12271,北海道,歌志内市,4,2,決算収支の状況,2,令和3年度,4742744,4422568,320176,0,320176,109549,0,0,0,109549
2022,61,12289,北海道,深川市,4,2,決算収支の状況,2,令和3年度,18372998,17907745,465253,20709,444544,185849,156005,0,0,341854
2022,61,12297,北海道,富良野市,4,2,決算収支の状況,2,令和3年度,20978219,20283171,695048,402263,292785,159450,589,0,0,160039
2022,61,12301,北海道,登別市,4,2,決算収支の状況,2,令和3年度,25122097,24266487,855610,1712,853898,100660,600011,0,0,700671
2022,61,12319,北海道,恵庭市,4,2,決算収支の状況,2,令和3年度,37633841,35991324,1642517,23864,1618653,875053,142269,0,140496,876826
2022,61,12335,北海道,伊達市,4,2,決算収支の状況,2,令和3年度,21423030,20139566,1283464,138123,1145341,496127,501,0,0,496628
2022,61,12343,北海道,北広島市,4,2,決算収支の状況,2,令和3年度,32396963,31611263,785700,163145,622555,457258,626174,0,0,1083432
2022,61,12351,北海道,石狩市,4,2,決算収支の状況,2,令和3年度,35365904,34730013,635891,12598,623293,66380,10,0,0,66390
2022,61,12360,北海道,北斗市,4,2,決算収支の状況,2,令和3年度,24901326,24336574,564752,14897,549855,-38899,119,0,490785,-529565
2022,61,13030,北海道,当別町,5,2,決算収支の状況,2,令和3年度,20128728,19699813,428915,18300,410615,148353,213298,0,12677,348974
2022,61,13048,北海道,新篠津村,5,2,決算収支の状況,2,令和3年度,3780609,3702670,77939,20,77919,20279,29085,0,0,49364
2022,61,13315,北海道,松前町,5,2,決算収支の状況,2,令和3年度,6534693,5978017,556676,95,556581,249123,21,0,0,249144
2022,61,13323,北海道,福島町,5,2,決算収支の状況,2,令和3年度,4769849,4653494,116355,19281,97074,-4991,55121,0,0,50130
2022,61,13331,北海道,知内町,5,2,決算収支の状況,2,令和3年度,5564222,5373431,190791,559,190232,85684,232568,0,0,318252
2022,61,13340,北海道,木古内町,5,2,決算収支の状況,2,令和3年度,5229491,4941050,288441,7874,280567,172594,43297,0,0,215891
2022,61,13374,北海道,七飯町,5,2,決算収支の状況,2,令和3年度,13954538,13549094,405444,26474,378970,325582,398000,139480,0,863062
2022,61,13439,北海道,鹿部町,5,2,決算収支の状況,2,令和3年度,3986322,3911499,74823,24011,50812,26898,1096,0,0,27994
2022,61,13455,北海道,森町,5,2,決算収支の状況,2,令和3年度,14232368,14107528,124840,42477,82363,1479,134905,0,0,136384
2022,61,13463,北海道,八雲町,5,2,決算収支の状況,2,令和3年度,17686459,17346183,340276,73218,267058,-137632,1,0,250000,-387631
2022,61,13471,北海道,長万部町,5,2,決算収支の状況,2,令和3年度,6499481,6340891,158590,327,158263,1108,561645,0,487550,75203
2022,61,13617,北海道,江差町,5,2,決算収支の状況,2,令和3年度,6403989,6096635,307354,132407,174947,-2271,84,0,0,-2187
2022,61,13625,北海道,上ノ国町,5,2,決算収支の状況,2,令和3年度,7111372,6934402,176970,71046,105924,33415,2610,0,430000,-393975
2022,61,13633,北海道,厚沢部町,5,2,決算収支の状況,2,令和3年度,5520328,5401610,118718,39625,79093,1602,196299,0,243900,-45999
2022,61,13641,北海道,乙部町,5,2,決算収支の状況,2,令和3年度,4624885,4476391,148494,44824,103670,15117,48274,52581,44193,71779
2022,61,13676,北海道,奥尻町,5,2,決算収支の状況,2,令和3年度,4558828,4410570,148258,0,148258,56168,104190,0,1000,159358
2022,61,13706,北海道,今金町,5,2,決算収支の状況,2,令和3年度,6998166,6957682,40484,1,40483,18740,172752,0,0,191492
2022,61,13714,北海道,せたな町,5,2,決算収支の状況,2,令和3年度,9303554,8940884,362670,202,362468,86150,1213,0,245495,-158132
2022,61,13919,北海道,島牧村,5,2,決算収支の状況,2,令和3年度,3073832,2979290,94542,1579,92963,-8151,8,0,12134,-20277
2022,61,13927,北海道,寿都町,5,2,決算収支の状況,2,令和3年度,6274717,6223524,51193,0,51193,-6380,1,0,0,-6379
2022,61,13935,北海道,黒松内町,5,2,決算収支の状況,2,令和3年度,5159455,5005907,153548,8928,144620,-125984,135411,0,71307,-61880
2022,61,13943,北海道,蘭越町,5,2,決算収支の状況,2,令和3年度,7484079,7117357,366722,18790,347932,-2395,251003,0,100000,148608
2022,61,13951,北海道,ニセコ町,5,2,決算収支の状況,2,令和3年度,5885511,5697379,188132,3535,184597,15236,42,0,0,15278
2022,61,13960,北海道,真狩村,5,2,決算収支の状況,2,令和3年度,3190184,3116949,73235,0,73235,-38134,152242,0,0,114108
2022,61,13978,北海道,留寿都村,5,2,決算収支の状況,2,令和3年度,4308296,4196992,111304,2043,109261,97969,27929,0,0,125898
2022,61,13986,北海道,喜茂別町,5,2,決算収支の状況,2,令和3年度,3217497,3156966,60531,0,60531,23562,85450,0,0,109012
2022,61,13994,北海道,京極町,5,2,決算収支の状況,2,令和3年度,4352618,3995150,357468,165000,192468,125516,230,0,0,125746
2022,61,14001,北海道,倶知安町,5,2,決算収支の状況,2,令和3年度,11812793,11410578,402215,38909,363306,114843,383128,0,200000,297971
2022,61,14010,北海道,共和町,5,2,決算収支の状況,2,令和3年度,7616386,7483541,132845,13219,119626,34697,103228,0,0,137925
2022,61,14028,北海道,岩内町,5,2,決算収支の状況,2,令和3年度,9065508,8452378,613130,1842,611288,364469,170086,0,0,534555
2022,61,14036,北海道,泊村,5,2,決算収支の状況,2,令和3年度,5203853,5167060,36793,1112,35681,847,184812,0,0,185659
2022,61,14044,北海道,神恵内村,5,2,決算収支の状況,2,令和3年度,3337997,3172339,165658,7413,158245,-12501,52964,0,80024,-39561
2022,61,14052,北海道,積丹町,5,2,決算収支の状況,2,令和3年度,3569200,3418682,150518,1250,149268,66598,6,0,0,66604
2022,61,14061,北海道,古平町,5,2,決算収支の状況,2,令和3年度,6539973,6399121,140852,0,140852,104568,104200,0,0,208768
2022,61,14079,北海道,仁木町,5,2,決算収支の状況,2,令和3年度,4651245,4604736,46509,0,46509,17091,27,0,0,17118
2022,61,14087,北海道,余市町,5,2,決算収支の状況,2,令和3年度,12233655,11736001,497654,8000,489654,209635,150005,0,105285,254355
2022,61,14095,北海道,赤井川村,5,2,決算収支の状況,2,令和3年度,3239225,3097555,141670,8126,133544,85808,125901,0,0,211709
2022,61,14231,北海道,南幌町,5,2,決算収支の状況,2,令和3年度,7283328,7093523,189805,37779,152026,-8791,85792,0,0,77001
2022,61,14249,北海道,奈井江町,5,2,決算収支の状況,2,令和3年度,5443770,5298030,145740,0,145740,48366,183617,0,0,231983
2022,61,14257,北海道,上砂川町,5,2,決算収支の状況,2,令和3年度,3691450,3597773,93677,300,93377,-24441,34,0,0,-24407
2022,61,14273,北海道,由仁町,5,2,決算収支の状況,2,令和3年度,5806363,5734019,72344,305,72039,-38698,168210,0,0,129512
2022,61,14281,北海道,長沼町,5,2,決算収支の状況,2,令和3年度,9203598,9157011,46587,515,46072,1395,301519,0,813,302101
2022,61,14290,北海道,栗山町,5,2,決算収支の状況,2,令和3年度,10881842,10570162,311680,375,311305,84188,405345,0,0,489533
2022,61,14303,北海道,月形町,5,2,決算収支の状況,2,令和3年度,4289059,4197384,91675,0,91675,12220,63,0,0,12283
2022,61,14311,北海道,浦臼町,5,2,決算収支の状況,2,令和3年度,4183393,3874748,308645,53767,254878,91414,635,127900,56913,163036
2022,61,14320,北海道,新十津川町,5,2,決算収支の状況,2,令和3年度,8126869,7654601,472268,83282,388986,137675,936,319937,94000,364548
2022,61,14338,北海道,妹背牛町,5,2,決算収支の状況,2,令和3年度,4454609,4393194,61415,2200,59215,1159,197108,0,0,198267
2022,61,14346,北海道,秩父別町,5,2,決算収支の状況,2,令和3年度,4252245,4142485,109760,900,108860,38500,509,53837,60000,32846
2022,61,14362,北海道,雨竜町,5,2,決算収支の状況,2,令和3年度,4523188,4430902,92286,25586,66700,-59364,193069,0,0,133705
2022,61,14371,北海道,北竜町,5,2,決算収支の状況,2,令和3年度,3950441,3888493,61948,10125,51823,938,51,0,0,989
2022,61,14389,北海道,沼田町,5,2,決算収支の状況,2,令和3年度,5670920,5543492,127428,4796,122632,-30576,93,85429,0,54946
2022,61,14524,北海道,鷹栖町,5,2,決算収支の状況,2,令和3年度,6355694,6054780,300914,122689,178225,18402,155395,0,0,173797
2022,61,14532,北海道,東神楽町,5,2,決算収支の状況,2,令和3年度,9621643,9254458,367185,78169,289016,18108,257000,0,0,275108
2022,61,14541,北海道,当麻町,5,2,決算収支の状況,2,令和3年度,7128634,6893276,235358,1662,233696,54406,11,0,0,54417
2022,61,14559,北海道,比布町,5,2,決算収支の状況,2,令和3年度,4295534,3998327,297207,6434,290773,69678,586,0,8000,62264
2022,61,14567,北海道,愛別町,5,2,決算収支の状況,2,令和3年度,3753972,3627491,126481,25431,101050,-11466,168491,0,0,157025
2022,61,14575,北海道,上川町,5,2,決算収支の状況,2,令和3年度,6176457,5988944,187513,18063,169450,-43838,70529,447,0,27138
2022,61,14583,北海道,東川町,5,2,決算収支の状況,2,令和3年度,12884063,12425799,458264,69472,388792,88965,92,0,0,89057
2022,61,14591,北海道,美瑛町,5,2,決算収支の状況,2,令和3年度,12316539,12025509,291030,14938,276092,51079,4,0,0,51083
2022,61,14605,北海道,上富良野町,5,2,決算収支の状況,2,令和3年度,9228255,8767096,461159,7400,453759,41505,130021,0,30000,141526
2022,61,14613,北海道,中富良野町,5,2,決算収支の状況,2,令和3年度,7897977,7663840,234137,4560,229577,45146,114487,0,38985,120648
2022,61,14621,北海道,南富良野町,5,2,決算収支の状況,2,令和3年度,5922827,5807843,114984,3401,111583,38796,5,0,0,38801
2022,61,14630,北海道,占冠村,5,2,決算収支の状況,2,令和3年度,3085491,3022728,62763,2100,60663,8570,18889,0,7000,20459
2022,61,14648,北海道,和寒町,5,2,決算収支の状況,2,令和3年度,5161610,4964298,197312,86735,110577,18831,314668,0,66407,267092
2022,61,14656,北海道,剣淵町,5,2,決算収支の状況,2,令和3年度,4527320,4227883,299437,164938,134499,24392,102882,0,84050,43224
2022,61,14681,北海道,下川町,5,2,決算収支の状況,2,令和3年度,6176844,5997048,179796,9610,170186,28221,230874,0,0,259095
2022,61,14699,北海道,美深町,5,2,決算収支の状況,2,令和3年度,5883094,5438663,444431,50691,393740,82380,25,0,0,82405
2022,61,14702,北海道,音威子府村,5,2,決算収支の状況,2,令和3年度,2106216,1997334,108882,4070,104812,8491,36010,0,4315,40186
2022,61,14711,北海道,中川町,5,2,決算収支の状況,2,令和3年度,4108664,3859445,249219,109346,139873,-72347,107021,0,0,34674
2022,61,14729,北海道,幌加内町,5,2,決算収支の状況,2,令和3年度,4662095,4571237,90858,268,90590,36840,302,0,0,37142
2022,61,14818,北海道,増毛町,5,2,決算収支の状況,2,令和3年度,6232193,6014804,217389,900,216489,146901,272,0,188323,-41150
2022,61,14826,北海道,小平町,5,2,決算収支の状況,2,令和3年度,5351095,4965084,386011,10344,375667,225051,23,0,0,225074
2022,61,14834,北海道,苫前町,5,2,決算収支の状況,2,令和3年度,4810819,4644956,165863,15798,150065,96599,1809,0,0,98408
2022,61,14842,北海道,羽幌町,5,2,決算収支の状況,2,令和3年度,7327970,7129577,198393,6106,192287,181866,5219,0,0,187085
2022,61,14851,北海道,初山別村,5,2,決算収支の状況,2,令和3年度,2579370,2534980,44390,19751,24639,-303,90,0,0,-213
2022,61,14869,北海道,遠別町,5,2,決算収支の状況,2,令和3年度,4467152,4343931,123221,0,123221,87514,40681,77914,0,206109
2022,61,14877,北海道,天塩町,5,2,決算収支の状況,2,令和3年度,5127814,4643326,484488,134000,350488,273549,6,0,0,273555
2022,61,15113,北海道,猿払村,5,2,決算収支の状況,2,令和3年度,5532251,5449547,82704,3128,79576,6213,36717,0,0,42930
2022,61,15121,北海道,浜頓別町,5,2,決算収支の状況,2,令和3年度,5308963,5021933,287030,24311,262719,39655,8871,0,0,48526
2022,61,15130,北海道,中頓別町,5,2,決算収支の状況,2,令和3年度,4324636,4150252,174384,327,174057,15592,17,0,0,15609
2022,61,15148,北海道,枝幸町,5,2,決算収支の状況,2,令和3年度,11670018,11558064,111954,28419,83535,-17360,845,0,9287,-25802
2022,61,15164,北海道,豊富町,5,2,決算収支の状況,2,令和3年度,6755901,6074136,681765,1,681764,81734,101022,0,0,182756
2022,61,15172,北海道,礼文町,5,2,決算収支の状況,2,令和3年度,6209800,6134720,75080,1,75079,1178,332187,0,160657,172708
2022,61,15181,北海道,利尻町,5,2,決算収支の状況,2,令和3年度,4578816,4443255,135561,11276,124285,68513,100001,0,0,168514
2022,61,15199,北海道,利尻富士町,5,2,決算収支の状況,2,令和3年度,5440412,5374418,65994,0,65994,38477,171795,0,0,210272
2022,61,15202,北海道,幌延町,5,2,決算収支の状況,2,令和3年度,5023255,4789757,233498,99310,134188,-7060,74,14580,0,7594
2022,61,15431,北海道,美幌町,5,2,決算収支の状況,2,令和3年度,12820548,12504815,315733,227990,87743,4438,260935,0,1567,263806
2022,61,15440,北海道,津別町,5,2,決算収支の状況,2,令和3年度,7430900,7240590,190310,15264,175046,2731,314440,7313,292832,31652
2022,61,15458,北海道,斜里町,5,2,決算収支の状況,2,令和3年度,10185872,9821474,364398,0,364398,107925,290603,0,50000,348528
2022,61,15466,北海道,清里町,5,2,決算収支の状況,2,令和3年度,7391942,7023178,368764,0,368764,96257,217379,0,28846,284790
2022,61,15474,北海道,小清水町,5,2,決算収支の状況,2,令和3年度,8185159,7748423,436736,21719,415017,223290,8,0,0,223298
2022,61,15491,北海道,訓子府町,5,2,決算収支の状況,2,令和3年度,6336434,6097953,238481,2376,236105,92146,1898,0,187483,-93439
2022,61,15504,北海道,置戸町,5,2,決算収支の状況,2,令和3年度,4917873,4782121,135752,0,135752,-33176,50097,0,0,16921
2022,61,15521,北海道,佐呂間町,5,2,決算収支の状況,2,令和3年度,6857879,6647027,210852,0,210852,-15787,364808,0,0,349021
2022,61,15555,北海道,遠軽町,5,2,決算収支の状況,2,令和3年度,21592709,20337081,1255628,274356,981272,164569,206813,0,0,371382
2022,61,15598,北海道,湧別町,5,2,決算収支の状況,2,令和3年度,10565872,9875156,690716,283963,406753,49076,468321,0,0,517397
2022,61,15601,北海道,滝上町,5,2,決算収支の状況,2,令和3年度,4713365,4320021,393344,5280,388064,93798,170554,0,0,264352
2022,61,15610,北海道,興部町,5,2,決算収支の状況,2,令和3年度,5954260,5673077,281183,33030,248153,41131,123245,0,250000,-85624
2022,61,15628,北海道,西興部村,5,2,決算収支の状況,2,令和3年度,2390357,2319933,70424,248,70176,45422,15249,0,0,60671
2022,61,15636,北海道,雄武町,5,2,決算収支の状況,2,令和3年度,7316471,6773913,542558,162794,379764,168625,201520,0,350000,20145
2022,61,15644,北海道,大空町,5,2,決算収支の状況,2,令和3年度,9690631,9490121,200510,5155,195355,10195,233,0,0,10428
2022,61,15717,北海道,豊浦町,5,2,決算収支の状況,2,令和3年度,5524399,5351985,172414,127924,44490,22903,341,0,0,23244
2022,61,15750,北海道,壮瞥町,5,2,決算収支の状況,2,令和3年度,4307438,4245897,61541,1800,59741,-28059,276032,0,0,247973
2022,61,15784,北海道,白老町,5,2,決算収支の状況,2,令和3年度,13006548,12652692,353856,44919,308937,13933,288945,0,123195,179683
2022,61,15814,北海道,厚真町,5,2,決算収支の状況,2,令和3年度,13583922,12400419,1183503,519929,663574,8641,1916,0,0,10557
2022,61,15849,北海道,洞爺湖町,5,2,決算収支の状況,2,令和3年度,8539116,8327476,211640,14000,197640,113491,141,0,0,113632
2022,61,15857,北海道,安平町,5,2,決算収支の状況,2,令和3年度,9530434,9393412,137022,7419,129603,-3285,177317,0,0,174032
2022,61,15865,北海道,むかわ町,5,2,決算収支の状況,2,令和3年度,10657557,10390361,267196,13521,253675,53621,324770,0,0,378391
2022,61,16012,北海道,日高町,5,2,決算収支の状況,2,令和3年度,12959210,12223745,735465,418392,317073,122111,97885,0,890,219106
2022,61,16021,北海道,平取町,5,2,決算収支の状況,2,令和3年度,7251848,7114007,137841,23847,113994,38676,3461,0,0,42137
2022,61,16047,北海道,新冠町,5,2,決算収支の状況,2,令和3年度,6349511,6226183,123328,3388,119940,32872,131967,0,25513,139326
2022,61,16071,北海道,浦河町,5,2,決算収支の状況,2,令和3年度,11891654,11528612,363042,63509,299533,35023,45,0,53469,-18401
2022,61,16080,北海道,様似町,5,2,決算収支の状況,2,令和3年度,5173898,5119835,54063,149,53914,12594,280660,0,0,293254
2022,61,16098,北海道,えりも町,5,2,決算収支の状況,2,令和3年度,6188685,6119086,69599,485,69114,28520,811000,0,218000,621520
2022,61,16101,北海道,新ひだか町,5,2,決算収支の状況,2,令和3年度,18968423,18086700,881723,393561,488162,327022,287145,0,0,614167
2022,61,16314,北海道,音更町,5,2,決算収支の状況,2,令和3年度,25332808,24719244,613564,33953,579611,39483,7,0,0,39490
2022,61,16322,北海道,士幌町,5,2,決算収支の状況,2,令和3年度,8506451,8012954,493497,224299,269198,36755,100205,156050,0,293010
2022,61,16331,北海道,上士幌町,5,2,決算収支の状況,2,令和3年度,9274764,8759985,514779,4342,510437,3801,188378,0,209933,-17754
2022,61,16349,北海道,鹿追町,5,2,決算収支の状況,2,令和3年度,8451401,7891455,559946,27698,532248,-61466,100,0,0,-61366
2022,61,16357,北海道,新得町,5,2,決算収支の状況,2,令和3年度,9760115,8896609,863506,798938,64568,-5257,1040,265864,214000,47647
2022,61,16365,北海道,清水町,5,2,決算収支の状況,2,令和3年度,10367619,9959460,408159,24992,383167,35797,285434,861,413846,-91754
2022,61,16373,北海道,芽室町,5,2,決算収支の状況,2,令和3年度,15721989,15051655,670334,58365,611969,224843,50022,113945,0,388810
2022,61,16381,北海道,中札内村,5,2,決算収支の状況,2,令和3年度,6962534,6499652,462882,143471,319411,177459,21,0,190000,-12520
2022,61,16390,北海道,更別村,5,2,決算収支の状況,2,令和3年度,5513667,5302026,211641,1538,210103,83029,63581,119790,117441,148959
2022,61,16411,北海道,大樹町,5,2,決算収支の状況,2,令和3年度,11836200,11474084,362116,2553,359563,138919,100018,0,87200,151737
2022,61,16420,北海道,広尾町,5,2,決算収支の状況,2,令和3年度,8046380,7818817,227563,909,226654,70650,8,0,0,70658
2022,61,16438,北海道,幕別町,5,2,決算収支の状況,2,令和3年度,19125085,18144512,980573,475012,505561,55108,61000,0,0,116108
2022,61,16446,北海道,池田町,5,2,決算収支の状況,2,令和3年度,9071721,8838212,233509,18297,215212,10088,143617,0,0,153705
2022,61,16454,北海道,豊頃町,5,2,決算収支の状況,2,令和3年度,5695442,5601017,94425,288,94137,-24103,60526,0,0,36423
2022,61,16462,北海道,本別町,5,2,決算収支の状況,2,令和3年度,7965338,7832978,132360,441,131919,12881,502458,53,159987,355405
2022,61,16471,北海道,足寄町,5,2,決算収支の状況,2,令和3年度,10533104,10376758,156346,16112,140234,49164,170380,0,0,219544
2022,61,16489,北海道,陸別町,5,2,決算収支の状況,2,令和3年度,5711157,5607391,103766,2091,101675,-24740,62707,0,200000,-162033
2022,61,16497,北海道,浦幌町,5,2,決算収支の状況,2,令和3年度,7728253,7512584,215669,1600,214069,6831,187539,0,0,194370
2022,61,16616,北海道,釧路町,5,2,決算収支の状況,2,令和3年度,11038341,10650517,387824,4275,383549,234373,219220,0,6500,447093
2022,61,16624,北海道,厚岸町,5,2,決算収支の状況,2,令和3年度,12368321,11752159,616162,23485,592677,110256,50000,0,311607,-151351
2022,61,16632,北海道,浜中町,5,2,決算収支の状況,2,令和3年度,9306671,9148939,157732,14600,143132,26110,291498,0,0,317608
2022,61,16641,北海道,標茶町,5,2,決算収支の状況,2,令和3年度,13946942,13065337,881605,692763,188842,29605,352402,0,590000,-207993
2022,61,16659,北海道,弟子屈町,5,2,決算収支の状況,2,令和3年度,15952352,15766690,185662,61627,124035,20531,417430,0,0,437961
2022,61,16675,北海道,鶴居村,5,2,決算収支の状況,2,令和3年度,5700014,5579363,120651,47534,73117,-2235,97695,0,0,95460
2022,61,16683,北海道,白糠町,5,2,決算収支の状況,2,令和3年度,24699034,24580667,118367,88,118279,-107690,61471,0,177000,-223219
2022,61,16918,北海道,別海町,5,2,決算収支の状況,2,令和3年度,23860380,22731909,1128471,792116,336355,276039,1834,0,0,277873
2022,61,16926,北海道,中標津町,5,2,決算収支の状況,2,令和3年度,17878131,17247416,630715,9504,621211,375012,538434,0,11500,901946
2022,61,16934,北海道,標津町,5,2,決算収支の状況,2,令和3年度,8453258,8118470,334788,5055,329733,79832,1,0,0,79833
2022,61,16942,北海道,羅臼町,5,2,決算収支の状況,2,令和3年度,6343800,5994190,349610,1051,348559,239129,425,0,0,239554
2022,61,18015,北海道,日高中部広域連合,6,2,決算収支の状況,2,令和3年度,468428,468102,326,0,326,326,0,0,0,326
2022,61,18023,北海道,北海道市町村総合事務組合,6,2,決算収支の状況,2,令和3年度,1039618,1019493,20125,0,20125,-3896,4771,0,0,875
2022,61,18031,北海道,南空知葬斎組合,6,2,決算収支の状況,2,令和3年度,103936,100026,3910,0,3910,117,0,0,0,117
2022,61,18058,北海道,北海道市町村備荒資金組合,6,2,決算収支の状況,2,令和3年度,19483263,19482110,1153,1153,0,0,0,0,0,0
2022,61,18074,北海道,北海道市町村職員退職手当組合,6,2,決算収支の状況,2,令和3年度,24228015,22266161,1961854,0,1961854,-108021,0,0,0,-108021
2022,61,18104,北海道,北後志衛生施設組合,6,2,決算収支の状況,2,令和3年度,182311,166230,16081,0,16081,-6702,0,0,0,-6702
2022,61,18121,北海道,空知中部広域連合,6,2,決算収支の状況,2,令和3年度,95039,93615,1424,0,1424,-183,0,0,5860,-6043
2022,61,18139,北海道,根室北部廃棄物処理広域連合,6,2,決算収支の状況,2,令和3年度,899498,881820,17678,0,17678,1052,0,0,0,1052
2022,61,18155,北海道,後志広域連合,6,2,決算収支の状況,2,令和3年度,188817,187264,1553,0,1553,-579,0,0,0,-579
2022,61,18163,北海道,とかち広域消防事務組合,6,2,決算収支の状況,2,令和3年度,6735202,6363931,371271,4498,366773,23811,0,0,0,23811
2022,61,18198,北海道,名寄地区衛生施設事務組合,6,2,決算収支の状況,2,令和3年度,591692,522282,69410,0,69410,16250,0,0,0,16250
2022,61,18236,北海道,富良野広域連合,6,2,決算収支の状況,2,令和3年度,2234284,2190394,43890,0,43890,-4345,0,0,0,-4345
2022,61,18244,北海道,釧路・根室広域地方税滞納整理機構,6,2,決算収支の状況,2,令和3年度,37796,35441,2355,0,2355,266,2089,0,567,1788
2022,61,18279,北海道,大雪浄化組合,6,2,決算収支の状況,2,令和3年度,105268,101016,4252,0,4252,-1383,1,0,3800,-5182
2022,61,18295,北海道,日高東部衛生組合,6,2,決算収支の状況,2,令和3年度,451058,445511,5547,0,5547,-6189,1,0,2000,-8188
2022,61,18309,北海道,上川中部福祉事務組合,6,2,決算収支の状況,2,令和3年度,82,82,0,0,0,0,0,0,0,0
2022,61,18325,北海道,大雪地区広域連合,6,2,決算収支の状況,2,令和3年度,1343424,1341425,1999,0,1999,505,0,0,0,505
2022,61,18333,北海道,上川広域滞納整理機構,6,2,決算収支の状況,2,令和3年度,20901,19532,1369,0,1369,-88,0,0,0,-88
2022,61,18384,北海道,北空知衛生センター組合,6,2,決算収支の状況,2,令和3年度,499217,465399,33818,0,33818,24917,0,0,0,24917
2022,61,18481,北海道,北しりべし廃棄物処理広域連合,6,2,決算収支の状況,2,令和3年度,1463765,1417180,46585,0,46585,23943,0,0,0,23943
2022,61,18490,北海道,南空知公衆衛生組合,6,2,決算収支の状況,2,令和3年度,407909,386574,21335,0,21335,8366,1918,0,0,10284
2022,61,18554,北海道,南部後志環境衛生組合,6,2,決算収支の状況,2,令和3年度,100842,99635,1207,0,1207,406,0,0,0,406
2022,61,18571,北海道,中空知広域市町村圏組合（事業会計分）,7,2,決算収支の状況,2,令和3年度,0,0,0,0,0,0,0,0,0,0
2022,61,18597,北海道,岩内地方衛生組合,6,2,決算収支の状況,2,令和3年度,625858,572289,53569,0,53569,3449,0,0,0,3449
2022,61,18601,北海道,北部桧山衛生センター組合,6,2,決算収支の状況,2,令和3年度,408421,405579,2842,0,2842,-1865,0,0,0,-1865
2022,61,18619,北海道,羽幌町外２町村衛生施設組合,6,2,決算収支の状況,2,令和3年度,456231,436371,19860,0,19860,2592,0,0,0,2592
2022,61,18635,北海道,空知教育センター組合,6,2,決算収支の状況,2,令和3年度,19934,18278,1656,0,1656,-159,0,0,0,-159
2022,61,18643,北海道,北海道町村議会議員公務災害補償等組合,6,2,決算収支の状況,2,令和3年度,46420,43049,3371,0,3371,1794,0,0,3000,-1206
2022,61,18651,北海道,羊蹄山麓環境衛生組合,6,2,決算収支の状況,2,令和3年度,168842,157020,11822,0,11822,5896,0,0,0,5896
2022,61,18678,北海道,北海道後期高齢者医療広域連合,7,2,決算収支の状況,2,令和3年度,702129,399541,302588,0,302588,81722,160073,0,113454,128341
2022,61,18686,北海道,南渡島衛生施設組合,6,2,決算収支の状況,2,令和3年度,166066,153022,13044,0,13044,20,8001,0,0,8021
2022,61,18694,北海道,砂川地区保健衛生組合,6,2,決算収支の状況,2,令和3年度,357110,357110,0,0,0,0,0,0,0,0
2022,61,18716,北海道,苫小牧港管理組合,6,2,決算収支の状況,2,令和3年度,4544089,4256719,287370,2900,284470,112226,0,0,0,112226
2022,61,18732,北海道,斜里郡３町終末処理事業組合,6,2,決算収支の状況,2,令和3年度,96241,92975,3266,0,3266,884,0,0,0,884
2022,61,18759,北海道,西天北五町衛生施設組合,6,2,決算収支の状況,2,令和3年度,572135,553118,19017,0,19017,1525,10,0,18681,-17146
2022,61,18775,北海道,南十勝複合事務組合,6,2,決算収支の状況,2,令和3年度,322856,317305,5551,0,5551,-965,0,0,0,-965
2022,61,18791,北海道,安平・厚真行政事務組合,6,2,決算収支の状況,2,令和3年度,255776,243471,12305,0,12305,-363,1,0,4059,-4421
2022,61,18830,北海道,中空知衛生施設組合,6,2,決算収支の状況,2,令和3年度,830539,762157,68382,0,68382,-55182,0,0,0,-55182
2022,61,18856,北海道,十勝圏複合事務組合,6,2,決算収支の状況,2,令和3年度,2995820,2814772,181048,0,181048,15044,0,0,0,15044
2022,61,18899,北海道,南部檜山衛生処理組合,6,2,決算収支の状況,2,令和3年度,659944,627797,32147,0,32147,9283,0,0,0,9283
2022,61,18902,北海道,中・北空知廃棄物処理広域連合,6,2,決算収支の状況,2,令和3年度,740477,734110,6367,0,6367,260,0,0,0,260
2022,61,18911,北海道,北空知衛生施設組合,6,2,決算収支の状況,2,令和3年度,54782,48447,6335,0,6335,-1252,0,0,0,-1252
2022,61,18929,北海道,南宗谷衛生施設組合,6,2,決算収支の状況,2,令和3年度,471658,471658,0,0,0,0,0,0,0,0
2022,61,18937,北海道,函館圏公立大学広域連合,6,2,決算収支の状況,2,令和3年度,1993914,1990893,3021,0,3021,671,0,0,0,671
2022,61,18945,北海道,西胆振行政事務組合,6,2,決算収支の状況,2,令和3年度,1484843,1396233,88610,0,88610,7485,5764,0,0,13249
2022,61,18953,北海道,根室北部衛生組合,6,2,決算収支の状況,2,令和3年度,652873,650733,2140,0,2140,-272,0,0,0,-272
2022,61,18961,北海道,江差町・上ノ国町学校給食組合,6,2,決算収支の状況,2,令和3年度,551567,509062,42505,40854,1651,1548,0,0,0,1548
2022,61,18970,北海道,渡島・檜山地方税滞納整理機構,6,2,決算収支の状況,2,令和3年度,42246,36820,5426,0,5426,478,0,0,0,478
2022,61,19003,北海道,川上郡衛生処理組合,6,2,決算収支の状況,2,令和3年度,84103,78617,5486,0,5486,-1113,0,0,0,-1113
2022,61,19011,北海道,石狩北部地区消防事務組合,6,2,決算収支の状況,2,令和3年度,2057923,1993353,64570,0,64570,-1948,0,0,0,-1948
2022,61,19020,北海道,渡島西部広域事務組合,6,2,決算収支の状況,2,令和3年度,1532897,1512874,20023,0,20023,4364,0,0,0,4364
2022,61,19046,北海道,中空知広域市町村圏組合（普通会計分）,6,2,決算収支の状況,2,令和3年度,61774,23144,38630,0,38630,1622,0,0,0,1622
2022,61,19101,北海道,日高東部消防組合,6,2,決算収支の状況,2,令和3年度,836690,831188,5502,0,5502,-3447,0,0,0,-3447
2022,61,19135,北海道,日高中部消防組合,6,2,決算収支の状況,2,令和3年度,882446,872075,10371,0,10371,627,0,0,0,627
2022,61,19143,北海道,胆振東部消防組合,6,2,決算収支の状況,2,令和3年度,2323339,2296716,26623,0,26623,26486,17400,0,0,43886
2022,61,19160,北海道,日高中部衛生施設組合,6,2,決算収支の状況,2,令和3年度,778297,745634,32663,18656,14007,-4648,0,0,0,-4648
2022,61,19186,北海道,上川北部消防事務組合,6,2,決算収支の状況,2,令和3年度,1205947,1185550,20397,0,20397,-327,0,0,0,-327
2022,61,19194,北海道,遠軽地区広域組合,6,2,決算収支の状況,2,令和3年度,1854006,1801685,52321,0,52321,-9141,0,0,0,-9141
2022,61,19208,北海道,美幌・津別広域事務組合,6,2,決算収支の状況,2,令和3年度,1178019,1163229,14790,0,14790,525,0,0,0,525
2022,61,19216,北海道,網走地区消防組合,6,2,決算収支の状況,2,令和3年度,1263550,1249006,14544,0,14544,-6772,0,0,0,-6772
2022,61,19224,北海道,網走地方教育研修センター組合,6,2,決算収支の状況,2,令和3年度,17251,13713,3538,0,3538,-2,0,0,0,-2
2022,61,19232,北海道,愛別町外３町塵芥処理組合,6,2,決算収支の状況,2,令和3年度,900485,889060,11425,0,11425,-920,158,0,10000,-10762
2022,61,19241,北海道,滝川地区広域消防事務組合,6,2,決算収支の状況,2,令和3年度,2067007,1989906,77101,0,77101,-13967,0,0,0,-13967
2022,61,19259,北海道,北見地区消防組合,6,2,決算収支の状況,2,令和3年度,2908758,2844594,64164,0,64164,-19347,0,0,0,-19347
2022,61,19267,北海道,南空知消防組合,6,2,決算収支の状況,2,令和3年度,1147452,1128644,18808,0,18808,-1285,0,0,0,-1285
2022,61,19275,北海道,深川地区消防組合,6,2,決算収支の状況,2,令和3年度,1050518,1011454,39064,0,39064,570,0,0,0,570
2022,61,19283,北海道,岩見沢地区消防事務組合,6,2,決算収支の状況,2,令和3年度,1488945,1469429,19516,0,19516,-16348,0,0,0,-16348
2022,61,19291,北海道,砂川地区広域消防組合,6,2,決算収支の状況,2,令和3年度,801264,801264,0,0,0,0,0,0,0,0
2022,61,19305,北海道,根室北部消防事務組合,6,2,決算収支の状況,2,令和3年度,1665877,1665877,0,0,0,0,0,0,0,0
2022,61,19313,北海道,士別地方消防事務組合,6,2,決算収支の状況,2,令和3年度,944418,940210,4208,0,4208,-6535,0,0,0,-6535
2022,61,19321,北海道,胆振東部日高西部衛生組合,6,2,決算収支の状況,2,令和3年度,166476,160389,6087,0,6087,-1445,66,0,0,-1379
2022,61,19330,北海道,西いぶり広域連合,6,2,決算収支の状況,2,令和3年度,2666303,2665259,1044,0,1044,-569,0,0,0,-569
2022,61,19348,北海道,利尻郡清掃施設組合,6,2,決算収支の状況,2,令和3年度,292452,290356,2096,0,2096,-613,0,0,0,-613
2022,61,19364,北海道,上川教育研修センター組合,6,2,決算収支の状況,2,令和3年度,32760,29688,3072,0,3072,644,2438,0,3000,82
2022,61,19372,北海道,南渡島消防事務組合,6,2,決算収支の状況,2,令和3年度,1891451,1868607,22844,0,22844,-1403,0,0,0,-1403
2022,61,19381,北海道,斜里地区消防組合,6,2,決算収支の状況,2,令和3年度,903232,901903,1329,0,1329,8,0,0,0,8
2022,61,19402,北海道,羊蹄山ろく消防組合,6,2,決算収支の状況,2,令和3年度,1532113,1518457,13656,0,13656,2906,0,0,0,2906
2022,61,19411,北海道,南部後志衛生施設組合,6,2,決算収支の状況,2,令和3年度,235471,224464,11007,0,11007,108,1,0,0,109
2022,61,19429,北海道,大雪消防組合,6,2,決算収支の状況,2,令和3年度,1309879,1281545,28334,0,28334,-1915,0,0,0,-1915
2022,61,19437,北海道,大雪清掃組合,6,2,決算収支の状況,2,令和3年度,352895,343099,9796,0,9796,920,0,0,0,920
2022,61,19445,北海道,北留萌消防組合,6,2,決算収支の状況,2,令和3年度,1051310,1015521,35789,1617,34172,2945,0,0,0,2945
2022,61,19453,北海道,稚内地区消防事務組合,6,2,決算収支の状況,2,令和3年度,1057690,1035535,22155,0,22155,-8068,0,0,0,-8068
2022,61,19461,北海道,利尻礼文消防事務組合,6,2,決算収支の状況,2,令和3年度,594460,583575,10885,0,10885,2274,0,0,0,2274
2022,61,19470,北海道,南宗谷消防組合,6,2,決算収支の状況,2,令和3年度,637454,626698,10756,0,10756,-2131,0,0,0,-2131
2022,61,19488,北海道,紋別地区消防組合,6,2,決算収支の状況,2,令和3年度,1334914,1304310,30604,0,30604,7487,0,0,0,7487
2022,61,19496,北海道,日高西部消防組合,6,2,決算収支の状況,2,令和3年度,814647,795271,19376,0,19376,3580,0,0,0,3580
2022,61,19500,北海道,平取町外２町衛生施設組合,6,2,決算収支の状況,2,令和3年度,636423,543405,93018,47795,45223,6611,0,0,0,6611
2022,61,19518,北海道,釧路北部消防事務組合,6,2,決算収支の状況,2,令和3年度,845009,831533,13476,756,12720,968,0,0,0,968
2022,61,19534,北海道,利尻郡学校給食組合,6,2,決算収支の状況,2,令和3年度,103210,102008,1202,0,1202,198,0,0,0,198
2022,61,19551,北海道,渡島廃棄物処理広域連合,6,2,決算収支の状況,2,令和3年度,1383378,1352652,30726,0,30726,-16830,0,0,0,-16830
2022,61,19577,北海道,留萌南部衛生組合,6,2,決算収支の状況,2,令和3年度,820970,803894,17076,0,17076,-5444,0,0,0,-5444
2022,61,19585,北海道,道央廃棄物処理組合,6,2,決算収支の状況,2,令和3年度,1981270,1977016,4254,0,4254,407,0,0,0,407
2022,61,19593,北海道,檜山広域行政組合,6,2,決算収支の状況,2,令和3年度,1626831,1579977,46854,0,46854,4936,0,0,0,4936
2022,61,19607,北海道,北十勝２町環境衛生処理組合,6,2,決算収支の状況,2,令和3年度,170239,164998,5241,0,5241,2251,0,0,0,2251
2022,61,19631,北海道,留萌消防組合,6,2,決算収支の状況,2,令和3年度,538276,526735,11541,0,11541,1886,0,0,0,1886
2022,61,19640,北海道,岩内・寿都地方消防組合,6,2,決算収支の状況,2,令和3年度,1158819,1114458,44361,0,44361,-6910,0,0,0,-6910
2022,61,19658,北海道,北後志消防組合,6,2,決算収支の状況,2,令和3年度,1349128,1285996,63132,0,63132,7079,0,0,0,7079
2022,61,19666,北海道,釧路東部消防組合,6,2,決算収支の状況,2,令和3年度,1300913,1282262,18651,0,18651,-1548,0,0,0,-1548
2022,61,19712,北海道,中標津町外２町葬斎組合,6,2,決算収支の状況,2,令和3年度,71855,71855,0,0,0,0,0,0,0,0
2022,61,19721,北海道,釧路広域連合,6,2,決算収支の状況,2,令和3年度,3068031,3065643,2388,0,2388,929,0,0,0,929
2022,61,19739,北海道,石狩教育研修センター組合,6,2,決算収支の状況,2,令和3年度,32880,30022,2858,0,2858,-345,0,0,0,-345
2022,61,19747,北海道,後志教育研修センター組合,6,2,決算収支の状況,2,令和3年度,14649,13914,735,0,735,674,0,0,0,674
2022,61,19755,北海道,西紋別地区環境衛生施設組合,6,2,決算収支の状況,2,令和3年度,575217,495396,79821,0,79821,26128,0,0,0,26128
2022,61,19771,北海道,日高管内地方税滞納整理機構,6,2,決算収支の状況,2,令和3年度,24944,24251,693,693,0,0,0,0,0,0
2022,61,19780,北海道,大雪葬斎組合,6,2,決算収支の状況,2,令和3年度,45272,43312,1960,0,1960,113,0,0,0,113
2022,61,19810,北海道,石狩湾新港管理組合,6,2,決算収支の状況,2,令和3年度,1999706,1952923,46783,0,46783,-27948,0,0,0,-27948
2022,61,19852,北海道,北空知圏学校給食組合,6,2,決算収支の状況,2,令和3年度,270886,267351,3535,0,3535,-1442,0,0,0,-1442
2022,61,19925,北海道,釧路公立大学事務組合,6,2,決算収支の状況,2,令和3年度,1359845,1241844,118001,0,118001,-26664,1443,0,0,-25221
2022,61,19976,北海道,南空知ふるさと市町村圏組合,6,2,決算収支の状況,2,令和3年度,84914,36648,48266,0,48266,2072,0,0,0,2072
2022,61,22012,青森県,青森市,8,2,決算収支の状況,2,令和3年度,142061166,136837199,5223967,349766,4874201,2466669,409,61482,477746,2050814
2022,61,22021,青森県,弘前市,3,2,決算収支の状況,2,令和3年度,89468850,87412305,2056545,736962,1319583,898873,669888,0,334521,1234240
2022,61,22039,青森県,八戸市,8,2,決算収支の状況,2,令和3年度,118386410,114283995,4102415,913357,3189058,660924,1502309,0,600000,1563233
2022,61,22047,青森県,黒石市,4,2,決算収支の状況,2,令和3年度,20559055,18244006,2315049,592003,1723046,888596,414058,0,0,1302654
2022,61,22055,青森県,五所川原市,4,2,決算収支の状況,2,令和3年度,36459752,34513486,1946266,8580,1937686,1080660,13,0,833837,246836
2022,61,22063,青森県,十和田市,4,2,決算収支の状況,2,令和3年度,38115275,35235482,2879793,775730,2104063,-48806,6778,0,281721,-323749
2022,61,22071,青森県,三沢市,4,2,決算収支の状況,2,令和3年度,25665651,24808111,857540,185145,672395,4428,17,0,102049,-97604
2022,61,22080,青森県,むつ市,4,2,決算収支の状況,2,令和3年度,40763452,39997499,765953,83177,682776,345148,1618153,0,810174,1153127
2022,61,22098,青森県,つがる市,4,2,決算収支の状況,2,令和3年度,26556252,25912815,643437,19293,624144,40678,535712,0,0,576390
2022,61,22101,青森県,平川市,4,2,決算収支の状況,2,令和3年度,21623112,20600584,1022528,490823,531705,-30453,3977,0,583788,-610264
2022,61,23019,青森県,平内町,5,2,決算収支の状況,2,令和3年度,8325715,8157029,168686,4636,164050,12326,12,0,37016,-24678
2022,61,23035,青森県,今別町,5,2,決算収支の状況,2,令和3年度,3696679,3454342,242337,15938,226399,43677,255004,19250,133000,184931
2022,61,23043,青森県,蓬田村,5,2,決算収支の状況,2,令和3年度,2594305,2541142,53163,7840,45323,-30145,6518,0,0,-23627
2022,61,23078,青森県,外ヶ浜町,5,2,決算収支の状況,2,令和3年度,6449179,6320870,128309,11001,117308,26322,446295,0,468857,3760
2022,61,23213,青森県,鰺ケ沢町,5,2,決算収支の状況,2,令和3年度,8167635,8001103,166532,2923,163609,8487,68924,0,0,77411
2022,61,23230,青森県,深浦町,5,2,決算収支の状況,2,令和3年度,7591149,7393417,197732,21965,175767,86978,1796,0,0,88774
2022,61,23434,青森県,西目屋村,5,2,決算収支の状況,2,令和3年度,2616167,2530316,85851,9664,76187,-34142,130049,268400,50000,314307
2022,61,23612,青森県,藤崎町,5,2,決算収支の状況,2,令和3年度,8855153,8624675,230478,58757,171721,-102004,200273,0,163592,-65323
2022,61,23621,青森県,大鰐町,5,2,決算収支の状況,2,令和3年度,6634727,6295466,339261,630,338631,85085,24,0,0,85109
2022,61,23671,青森県,田舎館村,5,2,決算収支の状況,2,令和3年度,4701616,4145063,556553,2164,554389,41907,2347,0,0,44254
2022,61,23817,青森県,板柳町,5,2,決算収支の状況,2,令和3年度,7591343,7137391,453952,9901,444051,-81407,296242,0,185056,29779
2022,61,23841,青森県,鶴田町,5,2,決算収支の状況,2,令和3年度,7485921,6872045,613876,46744,567132,171488,195352,0,46459,320381
2022,61,23876,青森県,中泊町,5,2,決算収支の状況,2,令和3年度,11733781,11483869,249912,6698,243214,121840,1096988,0,587420,631408
2022,61,24015,青森県,野辺地町,5,2,決算収支の状況,2,令和3年度,7820205,7417236,402969,10241,392728,249719,71600,0,0,321319
2022,61,24023,青森県,七戸町,5,2,決算収支の状況,2,令和3年度,11914340,11472458,441882,157686,284196,116556,265343,207306,0,589205
2022,61,24058,青森県,六戸町,5,2,決算収支の状況,2,令和3年度,6557829,6358878,198951,897,198054,111475,69014,0,0,180489
2022,61,24066,青森県,横浜町,5,2,決算収支の状況,2,令和3年度,4109725,3994848,114877,842,114035,23361,130438,0,0,153799
2022,61,24082,青森県,東北町,5,2,決算収支の状況,2,令和3年度,13198339,12688895,509444,105901,403543,25354,830842,0,975697,-119501
2022,61,24112,青森県,六ケ所村,5,2,決算収支の状況,2,令和3年度,16236924,15895885,341039,161868,179171,76517,8467,0,1169704,-1084720
2022,61,24121,青森県,おいらせ町,5,2,決算収支の状況,2,令和3年度,12068869,11689233,379636,84287,295349,7981,533656,0,0,541637
2022,61,24236,青森県,大間町,5,2,決算収支の状況,2,令和3年度,5308276,5087736,220540,18861,201679,4706,544005,0,373000,175711
2022,61,24244,青森県,東通村,5,2,決算収支の状況,2,令和3年度,9701394,9214007,487387,301103,186284,-104915,393603,0,0,288688
2022,61,24252,青森県,風間浦村,5,2,決算収支の状況,2,令和3年度,3307052,3201382,105670,18635,87035,18345,190010,0,200000,8355
2022,61,24261,青森県,佐井村,5,2,決算収支の状況,2,令和3年度,2640419,2486492,153927,41215,112712,60211,96484,0,0,156695
2022,61,24414,青森県,三戸町,5,2,決算収支の状況,2,令和3年度,7468441,7166614,301827,40046,261781,-1250,72,0,0,-1178
2022,61,24422,青森県,五戸町,5,2,決算収支の状況,2,令和3年度,10354343,10089316,265027,49254,215773,-5060,429352,0,0,424292
2022,61,24431,青森県,田子町,5,2,決算収支の状況,2,令和3年度,5181214,4855891,325323,690,324633,196785,10678,0,0,207463
2022,61,24457,青森県,南部町,5,2,決算収支の状況,2,令和3年度,12028607,11518009,510598,16704,493894,-173284,74,0,0,-173210
2022,61,24465,青森県,階上町,5,2,決算収支の状況,2,令和3年度,6635577,6343471,292106,9181,282925,44618,170281,0,0,214899
2022,61,24503,青森県,新郷村,5,2,決算収支の状況,2,令和3年度,3029625,2868940,160685,14948,145737,-14195,67701,0,0,53506
2022,61,28037,青森県,中部上北広域事業組合,6,2,決算収支の状況,2,令和3年度,2734118,2711143,22975,0,22975,-2882,27002,0,104134,-80014
2022,61,28061,青森県,青森県市町村総合事務組合,6,2,決算収支の状況,2,令和3年度,806571,786669,19902,0,19902,819,22601,0,20000,3420
2022,61,28126,青森県,青森県市町村職員退職手当組合,6,2,決算収支の状況,2,令和3年度,6909353,6701766,207587,0,207587,-2815441,0,0,0,-2815441
2022,61,28177,青森県,弘前地区環境整備事務組合,6,2,決算収支の状況,2,令和3年度,2470378,2392881,77497,0,77497,34493,42046,0,389574,-313035
2022,61,28185,青森県,黒石地区清掃施設組合,6,2,決算収支の状況,2,令和3年度,786916,769497,17419,0,17419,2872,7301,0,3629,6544
2022,61,28193,青森県,西北五環境整備事務組合,6,2,決算収支の状況,2,令和3年度,818050,786204,31846,11000,20846,-3,0,0,0,-3
2022,61,28266,青森県,三戸地区環境整備事務組合,6,2,決算収支の状況,2,令和3年度,730318,697165,33153,0,33153,3976,0,0,0,3976
2022,61,28291,青森県,西海岸衛生処理組合,6,2,決算収支の状況,2,令和3年度,464511,420587,43924,0,43924,16176,0,0,0,16176
2022,61,28304,青森県,西北五広域福祉事務組合,6,2,決算収支の状況,2,令和3年度,243637,235665,7972,0,7972,-1213,9463,0,11000,-2750
2022,61,28347,青森県,上北地方教育・福祉事務組合,6,2,決算収支の状況,2,令和3年度,777233,743322,33911,0,33911,17570,52602,0,16827,53345
2022,61,28398,青森県,青森県交通災害共済組合,7,2,決算収支の状況,2,令和3年度,0,0,0,0,0,0,0,0,0,0
2022,61,28533,青森県,五所川原地区消防事務組合,6,2,決算収支の状況,2,令和3年度,3649764,2891899,757865,721856,36009,-14928,0,0,0,-14928
2022,61,28568,青森県,弘前地区消防事務組合,6,2,決算収支の状況,2,令和3年度,4682072,4601297,80775,0,80775,-42176,122954,0,105840,-25062
2022,61,28592,青森県,八戸地域広域市町村圏事務組合,6,2,決算収支の状況,2,令和3年度,7688063,7481463,206600,6536,200064,-47473,0,0,0,-47473
2022,61,28614,青森県,下北地域広域行政事務組合,6,2,決算収支の状況,2,令和3年度,5636079,5509597,126482,72413,54069,-5884,1,0,31243,-37126
2022,61,28622,青森県,鰺ケ沢地区消防事務組合,6,2,決算収支の状況,2,令和3年度,748949,730631,18318,0,18318,-19381,0,0,0,-19381
2022,61,28631,青森県,十和田地域広域事務組合,6,2,決算収支の状況,2,令和3年度,3867934,3672703,195231,0,195231,-9222,0,0,0,-9222
2022,61,28673,青森県,田子高原広域事務組合,6,2,決算収支の状況,2,令和3年度,14233,4995,9238,0,9238,843,0,0,0,843
2022,61,28703,青森県,青森県市長会館管理組合,6,2,決算収支の状況,2,令和3年度,6773,5292,1481,0,1481,283,0,0,0,283
2022,61,28746,青森県,青森地域広域事務組合,6,2,決算収支の状況,2,令和3年度,6314922,6084845,230077,0,230077,22867,0,0,0,22867
2022,61,28771,青森県,北部上北広域事務組合,6,2,決算収支の状況,2,令和3年度,2050126,2018114,32012,0,32012,8607,0,0,0,8607
2022,61,28789,青森県,津軽広域連合,6,2,決算収支の状況,2,令和3年度,349260,298613,50647,0,50647,-4171,10,0,17900,-22061
2022,61,28797,青森県,つがる西北五広域連合,6,2,決算収支の状況,2,令和3年度,102686,94346,8340,0,8340,-4772,1,0,10972,-15743
2022,61,28801,青森県,青森県後期高齢者医療広域連合,7,2,決算収支の状況,2,令和3年度,162148,130954,31194,0,31194,5382,14,0,23810,-18414
2022,61,32018,岩手県,盛岡市,8,2,決算収支の状況,2,令和3年度,139109169,136553886,2555283,961951,1593332,639100,507991,2266,65,1149292
2022,61,32026,岩手県,宮古市,4,2,決算収支の状況,2,令和3年度,40335627,38962170,1373457,217226,1156231,-356938,764891,1861961,0,2269914
2022,61,32034,岩手県,大船渡市,4,2,決算収支の状況,2,令和3年度,24150487,23181124,969363,73480,895883,-101681,606578,23101,561598,-33600
2022,61,32051,岩手県,花巻市,4,2,決算収支の状況,2,令和3年度,58733269,55977366,2755903,647136,2108767,888774,614754,0,0,1503528
2022,61,32069,岩手県,北上市,4,2,決算収支の状況,2,令和3年度,49358568,47890379,1468189,955921,512268,131957,2050,0,0,134007
2022,61,32077,岩手県,久慈市,4,2,決算収支の状況,2,令和3年度,25828598,24084731,1743867,48061,1695806,360871,725813,0,468381,618303
2022,61,32085,岩手県,遠野市,4,2,決算収支の状況,2,令和3年度,23871200,22809388,1061812,182268,879544,399887,281036,15984,254359,442548
2022,61,32093,岩手県,一関市,3,2,決算収支の状況,2,令和3年度,78405365,73620414,4784951,600577,4184374,-14139,1529126,0,446540,1068447
2022,61,32107,岩手県,陸前高田市,4,2,決算収支の状況,2,令和3年度,31333783,26447126,4886657,308313,4578344,4160553,422217,0,224467,4358303
2022,61,32115,岩手県,釜石市,4,2,決算収支の状況,2,令和3年度,23847090,23553020,294070,3704,290366,-200998,252543,0,0,51545
2022,61,32131,岩手県,二戸市,4,2,決算収支の状況,2,令和3年度,21386409,20436789,949620,233474,716146,-22932,363097,0,86507,253658
2022,61,32140,岩手県,八幡平市,4,2,決算収支の状況,2,令和3年度,24053469,23449046,604423,90199,514224,-100178,308961,124952,300000,33735
2022,61,32158,岩手県,奥州市,3,2,決算収支の状況,2,令和3年度,65032461,62258551,2773910,45897,2728013,2078465,904563,8436,0,2991464
2022,61,32166,岩手県,滝沢市,4,2,決算収支の状況,2,令和3年度,22744612,21839229,905383,149954,755429,222241,783158,0,270231,735168
2022,61,33014,岩手県,雫石町,5,2,決算収支の状況,2,令和3年度,11176114,10877644,298470,39983,258487,107786,207859,0,0,315645
2022,61,33022,岩手県,葛巻町,5,2,決算収支の状況,2,令和3年度,9250029,8906108,343921,63333,280588,-296760,8,267446,0,-29306
2022,61,33031,岩手県,岩手町,5,2,決算収支の状況,2,令和3年度,9689390,9388283,301107,11221,289886,27385,313715,0,0,341100
2022,61,33219,岩手県,紫波町,5,2,決算収支の状況,2,令和3年度,16977572,16619152,358420,3469,354951,148455,529693,0,0,678148
2022,61,33227,岩手県,矢巾町,5,2,決算収支の状況,2,令和3年度,13486647,12938415,548232,45811,502421,145508,802326,0,289148,658686
2022,61,33669,岩手県,西和賀町,5,2,決算収支の状況,2,令和3年度,9601047,9189492,411555,32622,378933,111294,138,0,0,111432
2022,61,33812,岩手県,金ケ崎町,5,2,決算収支の状況,2,令和3年度,11137979,10725945,412034,12684,399350,-6032,854121,0,1016865,-168776
2022,61,34029,岩手県,平泉町,5,2,決算収支の状況,2,令和3年度,6224583,6037604,186979,7380,179599,43976,70968,0,0,114944
2022,61,34410,岩手県,住田町,5,2,決算収支の状況,2,令和3年度,5745470,5519070,226400,205995,20405,-92987,1823,0,0,-91164
2022,61,34614,岩手県,大槌町,5,2,決算収支の状況,2,令和3年度,13438139,12492930,945209,134379,810830,16167,446786,0,302730,160223
2022,61,34827,岩手県,山田町,5,2,決算収支の状況,2,令和3年度,13884354,13427978,456376,351172,105204,-427191,451545,0,0,24354
2022,61,34835,岩手県,岩泉町,5,2,決算収支の状況,2,令和3年度,11493598,10849368,644230,16123,628107,-40762,335081,0,275224,19095
2022,61,34843,岩手県,田野畑村,5,2,決算収支の状況,2,令和3年度,5784830,5538479,246351,90547,155804,-420681,420343,0,73476,-73814
2022,61,34851,岩手県,普代村,5,2,決算収支の状況,2,令和3年度,4634212,4531674,102538,32412,70126,-12131,161560,0,0,149429
2022,61,35017,岩手県,軽米町,5,2,決算収支の状況,2,令和3年度,7782976,7202132,580844,122729,458115,124001,168006,0,0,292007
2022,61,35033,岩手県,野田村,5,2,決算収支の状況,2,令和3年度,4460448,4185844,274604,61526,213078,10138,102881,0,0,113019
2022,61,35068,岩手県,九戸村,5,2,決算収支の状況,2,令和3年度,5592964,5506747,86217,18427,67790,-38776,236057,0,200000,-2719
2022,61,35076,岩手県,洋野町,5,2,決算収支の状況,2,令和3年度,12431194,11859524,571670,5407,566263,58708,271046,0,0,329754
2022,61,35246,岩手県,一戸町,5,2,決算収支の状況,2,令和3年度,10241030,9747936,493094,233528,259566,18723,260941,0,0,279664
2022,61,38083,岩手県,矢櫃山造林一部事務組合,6,2,決算収支の状況,2,令和3年度,2723,1090,1633,0,1633,-50,0,0,0,-50
2022,61,38156,岩手県,岩手県市町村総合事務組合,6,2,決算収支の状況,2,令和3年度,10965260,10735428,229832,0,229832,-276372,0,0,0,-276372
2022,61,38181,岩手県,大船渡地区消防組合,6,2,決算収支の状況,2,令和3年度,920130,896863,23267,0,23267,-2158,0,0,0,-2158
2022,61,38199,岩手県,北上地区広域行政組合,6,2,決算収支の状況,2,令和3年度,462455,442511,19944,0,19944,-4419,0,0,0,-4419
2022,61,38288,岩手県,二戸地区広域行政事務組合,6,2,決算収支の状況,2,令和3年度,4173636,4064428,109208,0,109208,42749,0,0,0,42749
2022,61,38296,岩手県,盛岡北部行政事務組合,6,2,決算収支の状況,2,令和3年度,471217,446437,24780,0,24780,-3394,1,0,0,-3393
2022,61,38334,岩手県,岩手・玉山環境組合,6,2,決算収支の状況,2,令和3年度,456760,420303,36457,0,36457,14063,0,0,0,14063
2022,61,38407,岩手県,盛岡・紫波地区環境施設組合,6,2,決算収支の状況,2,令和3年度,2139652,2055953,83699,0,83699,-3642,0,0,0,-3642
2022,61,38440,岩手県,岩手県競馬組合,7,2,決算収支の状況,2,令和3年度,0,0,0,0,0,0,0,0,0,0
2022,61,38539,岩手県,岩手県沿岸知的障害児施設組合,6,2,決算収支の状況,2,令和3年度,178178,160434,17744,0,17744,2560,0,0,0,2560
2022,61,38547,岩手県,盛岡地区衛生処理組合,6,2,決算収支の状況,2,令和3年度,525394,524274,1120,0,1120,-91,0,0,0,-91
2022,61,38555,岩手県,大船渡地区環境衛生組合,6,2,決算収支の状況,2,令和3年度,238584,221675,16909,3740,13169,2765,0,0,0,2765
2022,61,38563,岩手県,盛岡地区広域消防組合,6,2,決算収支の状況,2,令和3年度,6834510,6775710,58800,0,58800,3271,0,0,0,3271
2022,61,38628,岩手県,釜石大槌地区行政事務組合,6,2,決算収支の状況,2,令和3年度,1685951,1658092,27859,0,27859,13081,13781,0,0,26862
2022,61,38679,岩手県,宮古地区広域行政組合,6,2,決算収支の状況,2,令和3年度,3011367,2947179,64188,0,64188,-22876,0,0,0,-22876
2022,61,38709,岩手県,北上地区消防組合,6,2,決算収支の状況,2,令和3年度,1502466,1472542,29924,1597,28327,4246,0,0,0,4246
2022,61,38733,岩手県,奥州金ケ崎行政事務組合,6,2,決算収支の状況,2,令和3年度,3291180,3205953,85227,0,85227,3924,0,0,0,3924
2022,61,38750,岩手県,岩手県自治会館管理組合,6,2,決算収支の状況,2,令和3年度,62502,57635,4867,0,4867,1247,8551,0,9439,359
2022,61,38784,岩手県,気仙広域連合,6,2,決算収支の状況,2,令和3年度,221114,209898,11216,0,11216,-1959,0,0,0,-1959
2022,61,38806,岩手県,久慈広域連合,6,2,決算収支の状況,2,令和3年度,6448025,6347453,100572,6314,94258,1819,0,0,0,1819
2022,61,38814,岩手県,岩手中部広域行政組合,6,2,決算収支の状況,2,令和3年度,559849,524203,35646,0,35646,373,0,0,0,373
2022,61,38822,岩手県,一関地区広域行政組合,6,2,決算収支の状況,2,令和3年度,2842435,2639975,202460,33592,168868,47998,120879,0,113816,55061
2022,61,38831,岩手県,岩手沿岸南部広域環境組合,6,2,決算収支の状況,2,令和3年度,1458864,1447754,11110,0,11110,1773,9039,0,0,10812
2022,61,38849,岩手県,岩手県後期高齢者医療広域連合,7,2,決算収支の状況,2,令和3年度,148881,142957,5924,0,5924,360,5564,0,1779,4145
2022,61,38865,岩手県,滝沢・雫石環境組合,6,2,決算収支の状況,2,令和3年度,1327201,1282364,44837,0,44837,9942,0,0,0,9942
2022,61,38938,岩手県,盛岡広域環境組合,6,2,決算収支の状況,2,令和3年度,0,0,0,0,0,0,0,0,0,0
2022,61,41009,宮城県,仙台市,1,2,決算収支の状況,2,令和3年度,636972145,626496644,10475501,3580888,6894613,2556266,293373,0,31341,2818298
2022,61,42021,宮城県,石巻市,3,2,決算収支の状況,2,令和3年度,194183397,156977288,37206109,32174002,5032107,-713834,379,14926083,3200000,11012628
2022,61,42030,宮城県,塩竈市,4,2,決算収支の状況,2,令和3年度,28779385,27113104,1666281,535296,1130985,17481,44419,0,159600,-97700
2022,61,42056,宮城県,気仙沼市,4,2,決算収支の状況,2,令和3年度,78008663,69421915,8586748,4749898,3836850,288082,273,8195056,0,8483411
2022,61,42064,宮城県,白石市,4,2,決算収支の状況,2,令和3年度,19429607,18512418,917189,283128,634061,131764,588602,0,4200,716166
2022,61,42072,宮城県,名取市,4,2,決算収支の状況,2,令和3年度,43950658,42160306,1790352,760076,1030276,-451642,74,0,391379,-842947
2022,61,42081,宮城県,角田市,4,2,決算収支の状況,2,令和3年度,19083368,18354444,728924,200149,528775,80450,31,27397,0,107878
2022,61,42099,宮城県,多賀城市,4,2,決算収支の状況,2,令和3年度,28861563,27562597,1298966,259557,1039409,581210,607430,0,0,1188640
2022,61,42111,宮城県,岩沼市,4,2,決算収支の状況,2,令和3年度,22394806,20658585,1736221,348693,1387528,-123597,4343,0,1144320,-1263574
2022,61,42129,宮城県,登米市,4,2,決算収支の状況,2,令和3年度,48574153,47346252,1227901,62830,1165071,338407,4156,0,850781,-508218
2022,61,42137,宮城県,栗原市,4,2,決算収支の状況,2,令和3年度,46597780,45074287,1523493,231275,1292218,259445,714563,0,0,974008
2022,61,42145,宮城県,東松島市,4,2,決算収支の状況,2,令和3年度,26475166,25057648,1417518,471008,946510,144305,300033,0,763784,-319446
2022,61,42153,宮城県,大崎市,3,2,決算収支の状況,2,令和3年度,79565623,76148181,3417442,1148723,2268719,-25607,5887,0,2307068,-2326788
2022,61,42161,宮城県,富谷市,4,2,決算収支の状況,2,令和3年度,19317037,17962623,1354414,303632,1050782,82603,629780,0,300000,412383
2022,61,43010,宮城県,蔵王町,5,2,決算収支の状況,2,令和3年度,7658987,7453699,205288,11242,194046,-2817,201030,0,0,198213
2022,61,43028,宮城県,七ケ宿町,5,2,決算収支の状況,2,令和3年度,2677937,2572525,105412,4801,100611,3160,101516,0,40000,64676
2022,61,43214,宮城県,大河原町,5,2,決算収支の状況,2,令和3年度,12777740,12378902,398838,44736,354102,102567,296702,0,0,399269
2022,61,43222,宮城県,村田町,5,2,決算収支の状況,2,令和3年度,6660709,6385663,275046,101506,173540,7502,89524,0,0,97026
2022,61,43231,宮城県,柴田町,5,2,決算収支の状況,2,令和3年度,18613472,18066408,547064,60257,486807,7287,383881,0,0,391168
2022,61,43249,宮城県,川崎町,5,2,決算収支の状況,2,令和3年度,6133186,5839388,293798,22385,271413,95992,436975,0,0,532967
2022,61,43419,宮城県,丸森町,5,2,決算収支の状況,2,令和3年度,16115016,15404154,710862,439000,271862,94887,3056,0,332643,-234700
2022,61,43613,宮城県,亘理町,5,2,決算収支の状況,2,令和3年度,16347536,15846683,500853,203627,297226,-168754,232722,0,0,63968
2022,61,43621,宮城県,山元町,5,2,決算収支の状況,2,令和3年度,14548900,12690010,1858890,1366417,492473,-339696,984772,0,0,645076
2022,61,44016,宮城県,松島町,5,2,決算収支の状況,2,令和3年度,8701084,8291264,409820,23552,386268,-6682,200334,0,214279,-20627
2022,61,44041,宮城県,七ケ浜町,5,2,決算収支の状況,2,令和3年度,8675050,8246170,428880,89387,339493,89724,224000,0,228800,84924
2022,61,44067,宮城県,利府町,5,2,決算収支の状況,2,令和3年度,14454605,13833437,621168,37783,583385,2245,180465,0,50267,132443
2022,61,44211,宮城県,大和町,5,2,決算収支の状況,2,令和3年度,14835949,14230033,605916,248498,357418,-431255,11347,0,361691,-781599
2022,61,44229,宮城県,大郷町,5,2,決算収支の状況,2,令和3年度,7533204,6817693,715511,188442,527069,103984,217,0,185642,-81441
2022,61,44245,宮城県,大衡村,5,2,決算収支の状況,2,令和3年度,5700881,5599627,101254,16259,84995,-23768,411137,0,0,387369
2022,61,44440,宮城県,色麻町,5,2,決算収支の状況,2,令和3年度,5092307,4951872,140435,8178,132257,26830,111000,0,0,137830
2022,61,44458,宮城県,加美町,5,2,決算収支の状況,2,令和3年度,15472993,14501577,971416,45265,926151,324843,10291,0,200000,135134
2022,61,45012,宮城県,涌谷町,5,2,決算収支の状況,2,令和3年度,8468073,8343388,124685,25811,98874,-75456,376840,0,0,301384
2022,61,45055,宮城県,美里町,5,2,決算収支の状況,2,令和3年度,12395717,12041081,354636,31606,323030,125917,205,0,20317,105805
2022,61,45811,宮城県,女川町,5,2,決算収支の状況,2,令和3年度,17081126,14675319,2405807,2247255,158552,-29462,69949,0,600000,-559513
2022,61,46060,宮城県,南三陸町,5,2,決算収支の状況,2,令和3年度,22995988,20394924,2601064,1236928,1364136,-121987,580060,0,0,458073
2022,61,48101,宮城県,色麻町外一市一ヶ村花川ダム管理組合,6,2,決算収支の状況,2,令和3年度,3777,2869,908,0,908,78,1,0,733,-654
2022,61,48151,宮城県,吉田川流域溜池大和町外３市３ヶ町村組合,6,2,決算収支の状況,2,令和3年度,1941,1608,333,0,333,-372,0,0,0,-372
2022,61,48160,宮城県,大衡村外一町牛野ダム管理組合,6,2,決算収支の状況,2,令和3年度,1849,1112,737,0,737,38,2,0,0,40
2022,61,48453,宮城県,白石市外二町組合,6,2,決算収支の状況,2,令和3年度,2859,2708,151,0,151,-26,0,0,0,-26
2022,61,48674,宮城県,黒川地域行政事務組合,6,2,決算収支の状況,2,令和3年度,2173708,2078699,95009,74888,20121,-14428,39364,0,16696,8240
2022,61,48691,宮城県,亘理名取共立衛生処理組合,6,2,決算収支の状況,2,令和3年度,2508049,2487000,21049,0,21049,-18864,15156,0,40826,-44534
2022,61,48721,宮城県,宮城東部衛生処理組合,6,2,決算収支の状況,2,令和3年度,937174,918480,18694,0,18694,-1660,975,0,0,-685
2022,61,49221,宮城県,宮城県市町村職員退職手当組合,6,2,決算収支の状況,2,令和3年度,10977650,10531941,445709,0,445709,-243074,116000,0,660000,-787074
2022,61,49255,宮城県,宮城県市町村非常勤消防団員補償報償組合,6,2,決算収支の状況,2,令和3年度,859663,857686,1977,0,1977,-17,48,0,1200,-1169
2022,61,49280,宮城県,石巻地区広域行政事務組合,6,2,決算収支の状況,2,令和3年度,6109087,6016084,93003,0,93003,11691,4,0,62476,-50781
2022,61,49298,宮城県,塩釜地区消防事務組合,6,2,決算収支の状況,2,令和3年度,3419848,3346425,73423,0,73423,-2468,0,0,63489,-65957
2022,61,49310,宮城県,亘理地区行政事務組合,6,2,決算収支の状況,2,令和3年度,1260361,1237459,22902,0,22902,-123,1,0,16040,-16162
2022,61,49328,宮城県,仙南地域広域行政事務組合,6,2,決算収支の状況,2,令和3年度,4902274,4754316,147958,99,147859,16200,61290,0,146160,-68670
2022,61,49361,宮城県,大崎地域広域行政事務組合,6,2,決算収支の状況,2,令和3年度,12439142,12331801,107341,4400,102941,11778,2806,0,136258,-121674
2022,61,49387,宮城県,気仙沼・本吉地域広域行政事務組合,6,2,決算収支の状況,2,令和3年度,1811598,1777997,33601,4818,28783,-4276,1,0,10682,-14957
2022,61,49654,宮城県,宮城県市町村自治振興センター,6,2,決算収支の状況,2,令和3年度,162867,159999,2868,0,2868,-1172,1,0,8283,-9454
2022,61,49689,宮城県,加美郡保健医療福祉行政事務組合,6,2,決算収支の状況,2,令和3年度,870641,862517,8124,0,8124,763,500,0,0,1263
2022,61,49727,宮城県,宮城県後期高齢者医療広域連合,7,2,決算収支の状況,2,令和3年度,248913,170959,77954,0,77954,9003,68960,0,34737,43226
2022,61,52019,秋田県,秋田市,8,2,決算収支の状況,2,令和3年度,164291055,161777061,2513994,610529,1903465,62504,1023998,7281,323515,770268
2022,61,52027,秋田県,能代市,4,2,決算収支の状況,2,令和3年度,32980804,31613884,1366920,314894,1052026,158408,452880,250,598874,12664
2022,61,52035,秋田県,横手市,4,2,決算収支の状況,2,令和3年度,60635360,57968592,2666768,225362,2441406,356214,1142335,0,694290,804259
2022,61,52043,秋田県,大館市,4,2,決算収支の状況,2,令和3年度,46966198,44631079,2335119,172469,2162650,330673,878035,479867,771567,917008
2022,61,52060,秋田県,男鹿市,4,2,決算収支の状況,2,令和3年度,18421465,17967558,453907,14638,439269,-102373,447924,0,36769,308782
2022,61,52078,秋田県,湯沢市,4,2,決算収支の状況,2,令和3年度,31710216,30905028,805188,46591,758597,-447835,601161,0,423239,-269913
2022,61,52094,秋田県,鹿角市,4,2,決算収支の状況,2,令和3年度,20216431,19759845,456586,60406,396180,88332,214040,0,0,302372
2022,61,52108,秋田県,由利本荘市,4,2,決算収支の状況,2,令和3年度,54943641,54351417,592224,281244,310980,-1380722,1749094,0,0,368372
2022,61,52116,秋田県,潟上市,4,2,決算収支の状況,2,令和3年度,18710742,17619704,1091038,9418,1081620,153148,875821,0,370000,658969
2022,61,52124,秋田県,大仙市,4,2,決算収支の状況,2,令和3年度,52455602,50030096,2425506,143126,2282380,398289,1000114,49,500000,898452
2022,61,52132,秋田県,北秋田市,4,2,決算収支の状況,2,令和3年度,27539066,26679565,859501,123178,736323,22025,1129121,10000,0,1161146
2022,61,52141,秋田県,にかほ市,4,2,決算収支の状況,2,令和3年度,17850737,17208773,641964,218630,423334,76299,430359,0,0,506658
2022,61,52159,秋田県,仙北市,4,2,決算収支の状況,2,令和3年度,22424854,21864551,560303,61392,498911,90049,131018,0,0,221067
2022,61,53031,秋田県,小坂町,5,2,決算収支の状況,2,令和3年度,5377033,5244339,132694,24725,107969,-962,344280,33238,344280,32276
2022,61,53279,秋田県,上小阿仁村,5,2,決算収支の状況,2,令和3年度,2966951,2850136,116815,274,116541,-11205,66012,0,25693,29114
2022,61,53465,秋田県,藤里町,5,2,決算収支の状況,2,令和3年度,4282694,4149014,133680,8929,124751,-3235,90934,0,0,87699
2022,61,53481,秋田県,三種町,5,2,決算収支の状況,2,令和3年度,11029863,10753770,276093,85959,190134,4737,534671,0,0,539408
2022,61,53490,秋田県,八峰町,5,2,決算収支の状況,2,令和3年度,6609329,6450216,159113,6911,152202,-161053,329380,0,2943,165384
2022,61,53619,秋田県,五城目町,5,2,決算収支の状況,2,令和3年度,6604175,6159736,444439,8559,435880,131793,151743,0,0,283536
2022,61,53635,秋田県,八郎潟町,5,2,決算収支の状況,2,令和3年度,4493976,4283513,210463,9924,200539,-27217,1384,145516,35953,83730
2022,61,53660,秋田県,井川町,5,2,決算収支の状況,2,令和3年度,3999382,3723526,275856,36529,239327,40878,3000,88025,20000,111903
2022,61,53686,秋田県,大潟村,5,2,決算収支の状況,2,令和3年度,5172048,4937591,234457,39359,195098,71845,97000,0,0,168845
2022,61,54348,秋田県,美郷町,5,2,決算収支の状況,2,令和3年度,13883814,13292315,591499,65410,526089,-116586,1444,329202,0,214060
2022,61,54631,秋田県,羽後町,5,2,決算収支の状況,2,令和3年度,9385922,8985388,400534,9007,391527,26059,352375,0,0,378434
2022,61,54640,秋田県,東成瀬村,5,2,決算収支の状況,2,令和3年度,4523312,4449970,73342,11066,62276,51039,807000,122731,588000,392770
2022,61,58041,秋田県,秋田県市町村総合事務組合,6,2,決算収支の状況,2,令和3年度,8084425,7770990,313435,0,313435,-12222,0,0,0,-12222
2022,61,58220,秋田県,井川町・潟上市共有財産管理組合,6,2,決算収支の状況,2,令和3年度,8724,5595,3129,0,3129,409,0,0,0,409
2022,61,58394,秋田県,北秋田市上小阿仁村生活環境施設組合,6,2,決算収支の状況,2,令和3年度,85328,80958,4370,0,4370,1260,2059,0,5802,-2483
2022,61,58505,秋田県,湯沢雄勝広域市町村圏組合,6,2,決算収支の状況,2,令和3年度,3095364,3062271,33093,0,33093,7697,0,0,0,7697
2022,61,58548,秋田県,本荘由利広域市町村圏組合,6,2,決算収支の状況,2,令和3年度,1107404,1000670,106734,0,106734,439,0,0,0,439
2022,61,58611,秋田県,能代山本広域市町村圏組合,6,2,決算収支の状況,2,令和3年度,3233010,3132784,100226,0,100226,-6977,0,0,0,-6977
2022,61,58629,秋田県,大曲仙北広域市町村圏組合,6,2,決算収支の状況,2,令和3年度,5011279,4979292,31987,1,31986,-12644,33924,0,65000,-43720
2022,61,58653,秋田県,三種・八峰養護老人ホーム組合,6,2,決算収支の状況,2,令和3年度,275312,194540,80772,0,80772,-9631,0,0,0,-9631
2022,61,58670,秋田県,鹿角広域行政組合,6,2,決算収支の状況,2,令和3年度,3176387,3136698,39689,0,39689,1866,0,0,0,1866
2022,61,58726,秋田県,男鹿地区消防一部事務組合,6,2,決算収支の状況,2,令和3年度,1386871,1364878,21993,605,21388,-3859,0,0,0,-3859
2022,61,58742,秋田県,男鹿地区衛生処理一部事務組合,6,2,決算収支の状況,2,令和3年度,209939,203645,6294,0,6294,-591,5366,0,0,4775
2022,61,58785,秋田県,大仙美郷介護福祉組合,6,2,決算収支の状況,2,令和3年度,120669,120669,0,0,0,0,0,0,0,0
2022,61,58815,秋田県,湖東地区行政一部事務組合,6,2,決算収支の状況,2,令和3年度,655451,647358,8093,0,8093,-14168,0,0,0,-14168
2022,61,58823,秋田県,八郎潟町・井川町衛生処理施設組合,6,2,決算収支の状況,2,令和3年度,79455,75915,3540,0,3540,105,14115,0,0,14220
2022,61,58831,秋田県,秋田県市町村会館管理組合,6,2,決算収支の状況,2,令和3年度,120008,109098,10910,0,10910,-4658,1,0,0,-4657
2022,61,58840,秋田県,八郎湖周辺清掃事務組合,6,2,決算収支の状況,2,令和3年度,588925,585745,3180,0,3180,-4511,20931,0,0,16420
2022,61,58858,秋田県,秋田県後期高齢者医療広域連合,7,2,決算収支の状況,2,令和3年度,105044,68211,36833,0,36833,-1826,0,0,0,-1826
2022,61,58866,秋田県,秋田県町村電算システム共同事業組合,6,2,決算収支の状況,2,令和3年度,671703,663926,7777,0,7777,-2749,0,0,49581,-52330
2022,61,62014,山形県,山形市,8,2,決算収支の状況,2,令和3年度,123467444,118477629,4989815,1236761,3753054,1078944,1326858,0,582630,1823172
2022,61,62022,山形県,米沢市,4,2,決算収支の状況,2,令和3年度,50406761,48953272,1453489,89877,1363612,151022,650547,0,650000,151569
2022,61,62031,山形県,鶴岡市,3,2,決算収支の状況,2,令和3年度,79466102,77255965,2210137,38296,2171841,844504,194530,285686,0,1324720
2022,61,62049,山形県,酒田市,3,2,決算収支の状況,2,令和3年度,67138114,64916403,2221711,285742,1935969,288570,1642688,606893,1239062,1299089
2022,61,62057,山形県,新庄市,4,2,決算収支の状況,2,令和3年度,24623861,23395404,1228457,7318,1221139,-122599,380021,0,433000,-175578
2022,61,62065,山形県,寒河江市,4,2,決算収支の状況,2,令和3年度,27367412,26393445,973967,94745,879222,100332,24,0,454550,-354194
2022,61,62073,山形県,上山市,4,2,決算収支の状況,2,令和3年度,18597377,17598877,998500,45479,953021,-12092,38,846387,0,834333
2022,61,62081,山形県,村山市,4,2,決算収支の状況,2,令和3年度,19269484,17719637,1549847,109609,1440238,212179,18,43378,400000,-144425
2022,61,62090,山形県,長井市,4,2,決算収支の状況,2,令和3年度,20508046,19800366,707680,92525,615155,140671,246246,0,0,386917
2022,61,62103,山形県,天童市,4,2,決算収支の状況,2,令和3年度,33418107,31512525,1905582,120717,1784865,-261545,2243882,0,0,1982337
2022,61,62111,山形県,東根市,4,2,決算収支の状況,2,令和3年度,26682224,25482248,1199976,22099,1177877,532832,269120,0,0,801952
2022,61,62120,山形県,尾花沢市,4,2,決算収支の状況,2,令和3年度,14516301,13539242,977059,79682,897377,126642,503661,0,350000,280303
2022,61,62138,山形県,南陽市,4,2,決算収支の状況,2,令和3年度,19418526,18220502,1198024,11884,1186140,385128,505231,0,465776,424583
2022,61,63011,山形県,山辺町,5,2,決算収支の状況,2,令和3年度,6914490,6683499,230991,11000,219991,51275,70061,0,0,121336
2022,61,63029,山形県,中山町,5,2,決算収支の状況,2,令和3年度,5976735,5624497,352238,31347,320891,-75652,358147,0,0,282495
2022,61,63215,山形県,河北町,5,2,決算収支の状況,2,令和3年度,13459625,13099737,359888,9621,350267,165475,50,0,198013,-32488
2022,61,63223,山形県,西川町,5,2,決算収支の状況,2,令和3年度,6125284,5747443,377841,73309,304532,-45324,158,4800,200000,-240366
2022,61,63231,山形県,朝日町,5,2,決算収支の状況,2,令和3年度,6602886,5985985,616901,153359,463542,-20696,173,0,146875,-167398
2022,61,63240,山形県,大江町,5,2,決算収支の状況,2,令和3年度,6394895,5974181,420714,114309,306405,11356,147653,0,60000,99009
2022,61,63410,山形県,大石田町,5,2,決算収支の状況,2,令和3年度,6333846,6048038,285808,16629,269179,151950,60054,0,0,212004
2022,61,63614,山形県,金山町,5,2,決算収支の状況,2,令和3年度,4812476,4526696,285780,3394,282386,-14728,301330,0,0,286602
2022,61,63622,山形県,最上町,5,2,決算収支の状況,2,令和3年度,7399477,7111224,288253,19832,268421,-30524,455314,0,355314,69476
2022,61,63631,山形県,舟形町,5,2,決算収支の状況,2,令和3年度,6182877,5921170,261707,14780,246927,-13842,130396,0,24974,91580
2022,61,63649,山形県,真室川町,5,2,決算収支の状況,2,令和3年度,6578466,6117257,461209,36787,424422,180755,6,245494,0,426255
2022,61,63657,山形県,大蔵村,5,2,決算収支の状況,2,令和3年度,4808248,4695338,112910,8286,104624,37829,40030,0,0,77859
2022,61,63665,山形県,鮭川村,5,2,決算収支の状況,2,令和3年度,4725301,4129198,596103,75946,520157,191389,220314,0,220000,191703
2022,61,63673,山形県,戸沢村,5,2,決算収支の状況,2,令和3年度,5345296,4735374,609922,43405,566517,142460,350269,0,250000,242729
2022,61,63819,山形県,高畠町,5,2,決算収支の状況,2,令和3年度,13254530,12474457,780073,20025,760048,114786,333915,191496,288871,351326
2022,61,63827,山形県,川西町,5,2,決算収支の状況,2,令和3年度,12406390,11943300,463090,166155,296935,135291,195729,0,0,331020
2022,61,64017,山形県,小国町,5,2,決算収支の状況,2,令和3年度,7981154,7507926,473228,184,473044,25935,100022,0,0,125957
2022,61,64025,山形県,白鷹町,5,2,決算収支の状況,2,令和3年度,10691647,9651584,1040063,146378,893685,236993,50673,0,0,287666
2022,61,64033,山形県,飯豊町,5,2,決算収支の状況,2,令和3年度,7674206,7201582,472624,51961,420663,155240,112,0,78000,77352
2022,61,64262,山形県,三川町,5,2,決算収支の状況,2,令和3年度,6126156,5810469,315687,4547,311140,70667,141250,0,208100,3817
2022,61,64289,山形県,庄内町,5,2,決算収支の状況,2,令和3年度,13756021,12908288,847733,47836,799897,118606,401511,0,0,520117
2022,61,64611,山形県,遊佐町,5,2,決算収支の状況,2,令和3年度,11514199,10916506,597693,54290,543403,24650,106,260000,10427,274329
2022,61,68012,山形県,山形県消防補償等組合,6,2,決算収支の状況,2,令和3年度,1065351,1061789,3562,0,3562,-240,1737,0,0,1497
2022,61,68021,山形県,山形県自治会館管理組合,6,2,決算収支の状況,2,令和3年度,88283,75955,12328,0,12328,-4542,15263,0,0,10721
2022,61,68039,山形県,山形県市町村職員退職手当組合,6,2,決算収支の状況,2,令和3年度,6845907,6763827,82080,0,82080,-99106,0,0,0,-99106
2022,61,68217,山形県,東根市外二市一町共立衛生処理組合,6,2,決算収支の状況,2,令和3年度,3141987,3050875,91112,0,91112,7096,0,0,0,7096
2022,61,68314,山形県,山形広域環境事務組合,6,2,決算収支の状況,2,令和3年度,3713452,3629545,83907,0,83907,-15488,0,0,0,-15488
2022,61,68829,山形県,松川堰組合,6,2,決算収支の状況,2,令和3年度,12633,10693,1940,0,1940,-1325,0,0,0,-1325
2022,61,69230,山形県,山形県市町村交通災害共済組合,7,2,決算収支の状況,2,令和3年度,0,0,0,0,0,0,0,0,0,0
2022,61,69451,山形県,庄内広域行政組合（普通会計分）,6,2,決算収支の状況,2,令和3年度,17414,14051,3363,0,3363,555,0,0,0,555
2022,61,69515,山形県,最上広域市町村圏事務組合,6,2,決算収支の状況,2,令和3年度,3145297,3066787,78510,0,78510,-40207,20873,0,0,-19334
2022,61,69523,山形県,置賜広域行政事務組合,6,2,決算収支の状況,2,令和3年度,6989646,6852988,136658,0,136658,34417,0,0,0,34417
2022,61,69531,山形県,西村山広域行政事務組合（普通会計分）,6,2,決算収支の状況,2,令和3年度,2557391,2512117,45274,0,45274,-1091,6,0,16276,-17361
2022,61,69540,山形県,北村山広域行政事務組合,6,2,決算収支の状況,2,令和3年度,99145,88148,10997,0,10997,388,0,0,0,388
2022,61,69639,山形県,酒田地区広域行政組合,6,2,決算収支の状況,2,令和3年度,5921627,5853783,67844,0,67844,-3627,0,0,0,-3627
2022,61,69647,山形県,河北町ほか２市広域斎場事務組合,6,2,決算収支の状況,2,令和3年度,69519,62211,7308,0,7308,846,0,0,0,846
2022,61,69655,山形県,尾花沢市大石田町環境衛生事業組合（普通会計分）,6,2,決算収支の状況,2,令和3年度,719102,685372,33730,9305,24425,2111,0,0,0,2111
2022,61,69698,山形県,西置賜行政組合,6,2,決算収支の状況,2,令和3年度,1664270,1601194,63076,0,63076,-15715,0,0,0,-15715
2022,61,69728,山形県,最上地区広域連合（普通会計分）,6,2,決算収支の状況,2,令和3年度,209066,180815,28251,0,28251,-21117,24684,0,0,3567
2022,61,69736,山形県,最上地区広域連合（事業会計分）,7,2,決算収支の状況,2,令和3年度,0,0,0,0,0,0,0,0,0,0
2022,61,69744,山形県,山形県後期高齢者医療広域連合（普通会計分）,6,2,決算収支の状況,2,令和3年度,222161,127052,95109,0,95109,38649,0,0,0,38649
2022,61,69752,山形県,山形県後期高齢者医療広域連合（事業会計分）,7,2,決算収支の状況,2,令和3年度,0,0,0,0,0,0,0,0,0,0
2022,61,72010,福島県,福島市,8,2,決算収支の状況,2,令和3年度,143827662,133255557,10572105,2027564,8544541,3324609,2122572,0,2100000,3347181
2022,61,72028,福島県,会津若松市,3,2,決算収支の状況,2,令和3年度,56966109,52626124,4339985,114111,4225874,2038169,37,0,153895,1884311
2022,61,72036,福島県,郡山市,8,2,決算収支の状況,2,令和3年度,164205175,155586109,8619066,1718081,6900985,838264,8750098,0,5780000,3808362
2022,61,72044,福島県,いわき市,8,2,決算収支の状況,2,令和3年度,173401310,164135000,9266310,1117673,8148637,5337191,5845019,0,6959683,4222527
2022,61,72052,福島県,白河市,4,2,決算収支の状況,2,令和3年度,36728207,34929688,1798519,74911,1723608,509042,1044535,595071,833909,1314739
2022,61,72079,福島県,須賀川市,4,2,決算収支の状況,2,令和3年度,42043954,40940842,1103112,208676,894436,349403,0,7009,570000,-213588
2022,61,72087,福島県,喜多方市,4,2,決算収支の状況,2,令和3年度,31256901,30293150,963751,204263,759488,340581,644546,0,376655,608472
2022,61,72095,福島県,相馬市,4,2,決算収支の状況,2,令和3年度,23788048,22465385,1322663,753565,569098,-112895,222,0,852356,-965029
2022,61,72109,福島県,二本松市,4,2,決算収支の状況,2,令和3年度,37900804,35411568,2489236,356400,2132836,477245,850134,0,0,1327379
2022,61,72117,福島県,田村市,4,2,決算収支の状況,2,令和3年度,29980369,26277126,3703243,2622262,1080981,88547,19483,0,12000,96030
2022,61,72125,福島県,南相馬市,4,2,決算収支の状況,2,令和3年度,61672374,54986220,6686154,4165524,2520630,713976,1613268,546169,982314,1891099
2022,61,72133,福島県,伊達市,4,2,決算収支の状況,2,令和3年度,37699417,34945726,2753691,171430,2582261,430827,1100083,0,707490,823420
2022,61,72141,福島県,本宮市,4,2,決算収支の状況,2,令和3年度,20241591,18729752,1511839,269938,1241901,264619,428326,81195,559451,214689
2022,61,73016,福島県,桑折町,5,2,決算収支の状況,2,令和3年度,7041668,6431122,610546,26539,584007,362358,1395,0,0,363753
2022,61,73032,福島県,国見町,5,2,決算収支の状況,2,令和3年度,8084695,7320492,764203,250324,513879,-83277,20183,301885,0,238791
2022,61,73083,福島県,川俣町,5,2,決算収支の状況,2,令和3年度,9990207,9138320,851887,197020,654867,202135,36,164713,0,366884
2022,61,73229,福島県,大玉村,5,2,決算収支の状況,2,令和3年度,6133700,5578662,555038,53451,501587,180021,220017,0,128000,272038
2022,61,73423,福島県,鏡石町,5,2,決算収支の状況,2,令和3年度,7602904,7445299,157605,30358,127247,-54350,90222,0,17255,18617
2022,61,73440,福島県,天栄村,5,2,決算収支の状況,2,令和3年度,5404695,5167946,236749,78192,158557,25491,548020,0,0,573511
2022,61,73628,福島県,下郷町,5,2,決算収支の状況,2,令和3年度,5521330,5182150,339180,155,339025,-91536,100186,0,135000,-126350
2022,61,73644,福島県,檜枝岐村,5,2,決算収支の状況,2,令和3年度,2242329,2133723,108606,7640,100966,-2341,27,77686,17044,58328
2022,61,73679,福島県,只見町,5,2,決算収支の状況,2,令和3年度,6194756,6071750,123006,35480,87526,-29587,31,53789,0,24233
2022,61,73687,福島県,南会津町,5,2,決算収支の状況,2,令和3年度,14284973,13867958,417015,13222,403793,47363,178307,0,0,225670
2022,61,74021,福島県,北塩原村,5,2,決算収支の状況,2,令和3年度,3427101,3253661,173440,2576,170864,57953,121812,0,0,179765
2022,61,74055,福島県,西会津町,5,2,決算収支の状況,2,令和3年度,7257580,7026669,230911,25775,205136,-36834,782726,0,548661,197231
2022,61,74071,福島県,磐梯町,5,2,決算収支の状況,2,令和3年度,5385382,5147648,237734,102474,135260,1451,500117,0,0,501568
2022,61,74080,福島県,猪苗代町,5,2,決算収支の状況,2,令和3年度,10632702,10319408,313294,5694,307600,9450,399707,0,0,409157
2022,61,74217,福島県,会津坂下町,5,2,決算収支の状況,2,令和3年度,9979598,9555440,424158,42939,381219,9969,221127,5573,39343,197326
2022,61,74225,福島県,湯川村,5,2,決算収支の状況,2,令和3年度,3014677,2860472,154205,51598,102607,-3345,53045,0,0,49700
2022,61,74233,福島県,柳津町,5,2,決算収支の状況,2,令和3年度,4419119,4197043,222076,28819,193257,59482,59,153843,0,213384
2022,61,74446,福島県,三島町,5,2,決算収支の状況,2,令和3年度,2747710,2581433,166277,4311,161966,-12652,87051,0,0,74399
2022,61,74454,福島県,金山町,5,2,決算収支の状況,2,令和3年度,3748910,3497023,251887,2457,249430,18383,22,93726,18379,93752
2022,61,74462,福島県,昭和村,5,2,決算収支の状況,2,令和3年度,2292007,2190340,101667,0,101667,50559,116,0,7687,42988
2022,61,74471,福島県,会津美里町,5,2,決算収支の状況,2,令和3年度,13609710,13137571,472139,57733,414406,8887,894061,0,176800,726148
2022,61,74616,福島県,西郷村,5,2,決算収支の状況,2,令和3年度,12488724,11728279,760445,198744,561701,220999,278751,0,0,499750
2022,61,74641,福島県,泉崎村,5,2,決算収支の状況,2,令和3年度,4551558,4148245,403313,36472,366841,77343,222793,0,46560,253576
2022,61,74659,福島県,中島村,5,2,決算収支の状況,2,令和3年度,3770179,3538331,231848,2019,229829,-28991,300,0,0,-28691
2022,61,74667,福島県,矢吹町,5,2,決算収支の状況,2,令和3年度,9101727,8610501,491226,72073,419153,132267,738,61978,0,194983
2022,61,74811,福島県,棚倉町,5,2,決算収支の状況,2,令和3年度,8232644,7746907,485737,44742,440995,53752,20,0,57000,-3228
2022,61,74829,福島県,矢祭町,5,2,決算収支の状況,2,令和3年度,5852186,5089168,763018,141241,621777,271460,55154,304664,0,631278
2022,61,74837,福島県,塙町,5,2,決算収支の状況,2,令和3年度,7579852,7376251,203601,66453,137148,878,68258,0,0,69136
2022,61,74845,福島県,鮫川村,5,2,決算収支の状況,2,令和3年度,4035807,3803921,231886,14804,217082,-57257,282065,0,189500,35308
2022,61,75019,福島県,石川町,5,2,決算収支の状況,2,令和3年度,8669589,8023447,646142,50556,595586,367144,48000,0,0,415144
2022,61,75027,福島県,玉川村,5,2,決算収支の状況,2,令和3年度,5050224,4767841,282383,23302,259081,-77662,168460,0,0,90798
2022,61,75035,福島県,平田村,5,2,決算収支の状況,2,令和3年度,5463244,5010022,453222,83763,369459,46972,310003,13021,0,369996
2022,61,75043,福島県,浅川町,5,2,決算収支の状況,2,令和3年度,4100115,3878336,221779,51043,170736,-89050,370000,0,170000,110950
2022,61,75051,福島県,古殿町,5,2,決算収支の状況,2,令和3年度,5466247,5214084,252163,28660,223503,113357,191708,0,0,305065
2022,61,75213,福島県,三春町,5,2,決算収支の状況,2,令和3年度,9837046,9058735,778311,135271,643040,462865,101475,0,337172,227168
2022,61,75221,福島県,小野町,5,2,決算収支の状況,2,令和3年度,6819036,6580044,238992,17402,221590,5286,307849,0,0,313135
2022,61,75418,福島県,広野町,5,2,決算収支の状況,2,令和3年度,6315149,5703801,611348,221548,389800,-62179,245,0,706767,-768701
2022,61,75426,福島県,楢葉町,5,2,決算収支の状況,2,令和3年度,12982512,11509873,1472639,705923,766716,-182361,3565,0,0,-178796
2022,61,75434,福島県,富岡町,5,2,決算収支の状況,2,令和3年度,21053128,19629577,1423551,97045,1326506,705717,433373,0,0,1139090
2022,61,75442,福島県,川内村,5,2,決算収支の状況,2,令和3年度,6446628,5944052,502576,445931,56645,-41692,317,0,100000,-141375
2022,61,75451,福島県,大熊町,5,2,決算収支の状況,2,令和3年度,43107963,38703372,4404591,3838593,565998,-37559,6767,0,0,-30792
2022,61,75469,福島県,双葉町,5,2,決算収支の状況,2,令和3年度,33068901,31436167,1632734,178425,1454309,244763,611443,0,500000,356206
2022,61,75477,福島県,浪江町,5,2,決算収支の状況,2,令和3年度,41641011,40236501,1404510,776026,628484,426783,230591,0,0,657374
2022,61,75485,福島県,葛尾村,5,2,決算収支の状況,2,令和3年度,5215803,4829744,386059,203783,182276,119608,329401,0,153390,295619
2022,61,75612,福島県,新地町,5,2,決算収支の状況,2,令和3年度,8837355,8115475,721880,263064,458816,398919,30130,0,0,429049
2022,61,75647,福島県,飯舘村,5,2,決算収支の状況,2,令和3年度,16672907,15791781,881126,804037,77089,-934287,447,0,0,-933840
2022,61,78026,福島県,福島県市町村総合事務組合,6,2,決算収支の状況,2,令和3年度,9588987,8414761,1174226,0,1174226,415704,0,0,0,415704
2022,61,78069,福島県,川俣方部衛生処理組合,6,2,決算収支の状況,2,令和3年度,176444,160387,16057,0,16057,5064,14780,0,22535,-2691
2022,61,78077,福島県,福島県市民交通災害共済組合,7,2,決算収支の状況,2,令和3年度,0,0,0,0,0,0,0,0,0,0
2022,61,78085,福島県,福島県伊達郡国見町桑折町有北山組合,6,2,決算収支の状況,2,令和3年度,808,586,222,0,222,15,159,0,0,174
2022,61,78115,福島県,伊達地方衛生処理組合,6,2,決算収支の状況,2,令和3年度,1044365,1023392,20973,4313,16660,5732,184,0,0,5916
2022,61,78204,福島県,須賀川地方保健環境組合,6,2,決算収支の状況,2,令和3年度,2074323,1634333,439990,200184,239806,-27358,0,0,0,-27358
2022,61,78255,福島県,耶麻郡磐梯町外一市二町一ケ村組合,6,2,決算収支の状況,2,令和3年度,15891,9391,6500,0,6500,5009,2346,0,5300,2055
2022,61,78441,福島県,東白衛生組合,6,2,決算収支の状況,2,令和3年度,779756,727496,52260,0,52260,-50984,0,0,0,-50984
2022,61,78468,福島県,石川地方生活環境施設組合,6,2,決算収支の状況,2,令和3年度,868587,786472,82115,0,82115,-92020,0,0,0,-92020
2022,61,78531,福島県,田村広域行政組合,6,2,決算収支の状況,2,令和3年度,1237522,1182966,54556,19377,35179,-7499,1,0,28000,-35498
2022,61,78620,福島県,相馬方部衛生組合,6,2,決算収支の状況,2,令和3年度,748439,645558,102881,0,102881,44232,0,0,0,44232
2022,61,78671,福島県,白河地方広域市町村圏整備組合,6,2,決算収支の状況,2,令和3年度,3946601,3771158,175443,0,175443,-24227,0,0,0,-24227
2022,61,78689,福島県,喜多方地方広域市町村圏組合,6,2,決算収支の状況,2,令和3年度,3481251,3432533,48718,0,48718,-51688,0,0,0,-51688
2022,61,78697,福島県,伊達地方消防組合,6,2,決算収支の状況,2,令和3年度,1761409,1729106,32303,3025,29278,-6515,39146,0,50000,-17369
2022,61,78701,福島県,相馬地方広域市町村圏組合,6,2,決算収支の状況,2,令和3年度,1916903,1769178,147725,0,147725,28963,0,0,0,28963
2022,61,78719,福島県,安達地方広域行政組合,6,2,決算収支の状況,2,令和3年度,7504575,7273316,231259,42671,188588,-45522,50,0,0,-45472
2022,61,78727,福島県,会津若松地方広域市町村圏整備組合,6,2,決算収支の状況,2,令和3年度,8703130,8508518,194612,56453,138159,3324,80024,0,160000,-76652
2022,61,78735,福島県,双葉地方広域市町村圏組合,6,2,決算収支の状況,2,令和3年度,3698284,3591186,107098,0,107098,-33799,357676,0,175152,148725
2022,61,78751,福島県,須賀川地方広域消防組合,6,2,決算収支の状況,2,令和3年度,2238872,2191590,47282,18260,29022,1611,27,0,98796,-97158
2022,61,78760,福島県,郡山地方広域消防組合,6,2,決算収支の状況,2,令和3年度,4817027,4762995,54032,0,54032,-22360,93392,0,0,71032
2022,61,78778,福島県,南会津地方広域市町村圏組合,6,2,決算収支の状況,2,令和3年度,920575,883106,37469,0,37469,-4375,21000,0,7900,8725
2022,61,78921,福島県,福島県後期高齢者医療広域連合,7,2,決算収支の状況,2,令和3年度,140558,122324,18234,0,18234,-935,0,0,0,-935
2022,61,78930,福島県,南会津地方環境衛生組合,6,2,決算収支の状況,2,令和3年度,999970,985570,14400,0,14400,-35716,25068,0,0,-10648
2022,61,82015,茨城県,水戸市,8,2,決算収支の状況,2,令和3年度,140504361,133682176,6822185,772831,6049354,2108679,2000110,0,0,4108789
2022,61,82023,茨城県,日立市,3,2,決算収支の状況,2,令和3年度,88685272,83265703,5419569,944445,4475124,2041465,2359902,0,1788609,2612758
2022,61,82031,茨城県,土浦市,3,2,決算収支の状況,2,令和3年度,60613324,56906889,3706435,771883,2934552,1641587,647399,900869,100138,3089717
2022,61,82040,茨城県,古河市,3,2,決算収支の状況,2,令和3年度,61315396,57450948,3864448,142826,3721622,1684742,355615,514080,0,2554437
2022,61,82058,茨城県,石岡市,4,2,決算収支の状況,2,令和3年度,34793245,32819879,1973366,563653,1409713,353667,562153,0,0,915820
2022,61,82074,茨城県,結城市,4,2,決算収支の状況,2,令和3年度,20993420,19298056,1695364,88702,1606662,580504,240286,0,0,820790
2022,61,82082,茨城県,龍ケ崎市,4,2,決算収支の状況,2,令和3年度,31341672,28603174,2738498,110465,2628033,1586786,1516,0,0,1588302
2022,61,82104,茨城県,下妻市,4,2,決算収支の状況,2,令和3年度,22868751,21370891,1497860,46126,1451734,550146,250548,0,0,800694
2022,61,82112,茨城県,常総市,4,2,決算収支の状況,2,令和3年度,28004721,26679015,1325706,325706,1000000,288587,1180075,89500,0,1558162
2022,61,82121,茨城県,常陸太田市,4,2,決算収支の状況,2,令和3年度,27890315,26204284,1686031,161497,1524534,217066,903106,0,0,1120172
2022,61,82147,茨城県,高萩市,4,2,決算収支の状況,2,令和3年度,15073427,14131466,941961,120073,821888,406639,10257,0,210000,206896
2022,61,82155,茨城県,北茨城市,4,2,決算収支の状況,2,令和3年度,24088087,22701125,1386962,427721,959241,97465,492655,0,0,590120
2022,61,82163,茨城県,笠間市,4,2,決算収支の状況,2,令和3年度,39371893,38070707,1301186,48396,1252790,442022,751786,0,0,1193808
2022,61,82171,茨城県,取手市,3,2,決算収支の状況,2,令和3年度,46823100,45178076,1645024,200564,1444460,188350,791847,0,24000,956197
2022,61,82198,茨城県,牛久市,4,2,決算収支の状況,2,令和3年度,33531821,31079268,2452553,295557,2156996,760654,427621,17300,0,1205575
2022,61,82201,茨城県,つくば市,9,2,決算収支の状況,2,令和3年度,105563459,98838105,6725354,461823,6263531,1897974,2285375,0,275600,3907749
2022,61,82210,茨城県,ひたちなか市,3,2,決算収支の状況,2,令和3年度,62867572,59050533,3817039,556493,3260546,1001758,33,0,641119,360672
2022,61,82228,茨城県,鹿嶋市,4,2,決算収支の状況,2,令和3年度,28965081,27341683,1623398,280212,1343186,795293,562,0,192910,602945
2022,61,82236,茨城県,潮来市,4,2,決算収支の状況,2,令和3年度,16578411,15190513,1387898,108453,1279445,323271,658160,0,0,981431
2022,61,82244,茨城県,守谷市,4,2,決算収支の状況,2,令和3年度,34528499,31535734,2992765,792507,2200258,597462,387,0,500088,97761
2022,61,82252,茨城県,常陸大宮市,4,2,決算収支の状況,2,令和3年度,25565208,24381527,1183681,364290,819391,-278271,535883,0,0,257612
2022,61,82261,茨城県,那珂市,4,2,決算収支の状況,2,令和3年度,25083554,23542851,1540703,134263,1406440,681507,500,0,0,682007
2022,61,82279,茨城県,筑西市,3,2,決算収支の状況,2,令和3年度,50864880,47560747,3304133,634857,2669276,552953,1124460,0,0,1677413
2022,61,82287,茨城県,坂東市,4,2,決算収支の状況,2,令和3年度,24207545,23287831,919714,64646,855068,-400700,541191,0,0,140491
2022,61,82295,茨城県,稲敷市,4,2,決算収支の状況,2,令和3年度,25491537,24110609,1380928,331799,1049129,144308,5745,0,0,150053
2022,61,82309,茨城県,かすみがうら市,4,2,決算収支の状況,2,令和3年度,21727835,20450657,1277178,87671,1189507,654831,12370,0,0,667201
2022,61,82317,茨城県,桜川市,4,2,決算収支の状況,2,令和3年度,23008475,20850865,2157610,322681,1834929,-450413,600680,0,0,150267
2022,61,82325,茨城県,神栖市,4,2,決算収支の状況,2,令和3年度,53039473,48055896,4983577,505579,4477998,1288831,1600310,2984,2640350,251775
2022,61,82333,茨城県,行方市,4,2,決算収支の状況,2,令和3年度,19072055,18462416,609639,67870,541769,-131265,441732,0,0,310467
2022,61,82341,茨城県,鉾田市,4,2,決算収支の状況,2,令和3年度,26842161,25385492,1456669,487507,969162,24775,1334,0,200000,-173891
2022,61,82350,茨城県,つくばみらい市,4,2,決算収支の状況,2,令和3年度,26093808,25177942,915866,377827,538039,73897,1589025,0,0,1662922
2022,61,82368,茨城県,小美玉市,4,2,決算収支の状況,2,令和3年度,28643779,27423414,1220365,156245,1064120,567561,126889,0,0,694450
2022,61,83020,茨城県,茨城町,5,2,決算収支の状況,2,令和3年度,15019563,14251359,768204,84344,683860,287882,20,0,0,287902
2022,61,83097,茨城県,大洗町,5,2,決算収支の状況,2,令和3年度,9894296,9093383,800913,115575,685338,211956,2,0,0,211958
2022,61,83101,茨城県,城里町,5,2,決算収支の状況,2,令和3年度,11867425,11341331,526094,130524,395570,-70714,598111,0,0,527397
2022,61,83411,茨城県,東海村,5,2,決算収支の状況,2,令和3年度,20864787,19637975,1226812,91662,1135150,473997,1150448,0,0,1624445
2022,61,83640,茨城県,大子町,5,2,決算収支の状況,2,令和3年度,12957703,11442691,1515012,20044,1494968,534424,300214,0,2006,832632
2022,61,84425,茨城県,美浦村,5,2,決算収支の状況,2,令和3年度,7525722,7137156,388566,18161,370405,82730,371749,0,0,454479
2022,61,84433,茨城県,阿見町,5,2,決算収支の状況,2,令和3年度,20130640,18514152,1616488,160723,1455765,873864,259135,256591,0,1389590
2022,61,84476,茨城県,河内町,5,2,決算収支の状況,2,令和3年度,5793013,5147937,645076,213288,431788,69438,100013,0,0,169451
2022,61,85219,茨城県,八千代町,5,2,決算収支の状況,2,令和3年度,9807509,9054762,752747,0,752747,286993,234993,0,3000,518986
2022,61,85421,茨城県,五霞町,5,2,決算収支の状況,2,令和3年度,5864891,5417810,447081,54210,392871,-165030,445903,0,0,280873
2022,61,85464,茨城県,境町,5,2,決算収支の状況,2,令和3年度,22557974,21201833,1356141,298923,1057218,608500,37352,0,0,645852
2022,61,85642,茨城県,利根町,5,2,決算収支の状況,2,令和3年度,7030257,6750728,279529,721,278808,68243,105301,0,181316,-7772
2022,61,88366,茨城県,大宮地方環境整備組合,6,2,決算収支の状況,2,令和3年度,1287050,1127830,159220,0,159220,8614,0,0,0,8614
2022,61,88404,茨城県,清水丘診療所事務組合,7,2,決算収支の状況,2,令和3年度,0,0,0,0,0,0,0,0,0,0
2022,61,88439,茨城県,常総衛生組合,6,2,決算収支の状況,2,令和3年度,334173,289026,45147,0,45147,-11631,0,0,0,-11631
2022,61,88455,茨城県,龍ヶ崎地方塵芥処理組合,6,2,決算収支の状況,2,令和3年度,1462416,1405203,57213,0,57213,-52529,93909,0,10150,31230
2022,61,88501,茨城県,龍ヶ崎地方衛生組合,6,2,決算収支の状況,2,令和3年度,390402,367137,23265,0,23265,2574,20,0,0,2594
2022,61,88510,茨城県,さしま環境管理事務組合,6,2,決算収支の状況,2,令和3年度,3103891,2862250,241641,118972,122669,-44158,259717,0,67781,147778
2022,61,88536,茨城県,筑北環境衛生組合,6,2,決算収支の状況,2,令和3年度,214243,198044,16199,0,16199,5895,0,0,0,5895
2022,61,88552,茨城県,茨城地方広域環境事務組合,6,2,決算収支の状況,2,令和3年度,282548,252376,30172,0,30172,4373,0,0,0,4373
2022,61,88579,茨城県,取手市外２市火葬場組合,6,2,決算収支の状況,2,令和3年度,167157,140301,26856,0,26856,964,0,0,0,964
2022,61,88595,茨城県,大洗，鉾田，水戸環境組合,6,2,決算収支の状況,2,令和3年度,708554,646516,62038,0,62038,-12615,38475,0,0,25860
2022,61,88676,茨城県,江戸崎地方衛生土木組合,6,2,決算収支の状況,2,令和3年度,3897217,3835931,61286,0,61286,-12440,100,0,0,-12340
2022,61,88714,茨城県,湖北環境衛生組合,6,2,決算収支の状況,2,令和3年度,503194,415448,87746,0,87746,-1580,0,0,0,-1580
2022,61,88838,茨城県,茨城西南地方広域市町村圏事務組合,6,2,決算収支の状況,2,令和3年度,4998243,4940974,57269,0,57269,-42049,26,0,0,-42023
2022,61,88862,茨城県,筑西広域市町村圏事務組合,6,2,決算収支の状況,2,令和3年度,6908847,6520318,388529,36851,351678,-411758,0,0,0,-411758
2022,61,88951,茨城県,常総地方広域市町村圏事務組合,6,2,決算収支の状況,2,令和3年度,7329150,6655003,674147,25149,648998,325832,0,0,0,325832
2022,61,88960,茨城県,鹿行広域事務組合,6,2,決算収支の状況,2,令和3年度,2374595,2277529,97066,0,97066,-17633,568,0,0,-17065
2022,61,88986,茨城県,霞台厚生施設組合,6,2,決算収支の状況,2,令和3年度,1543785,1389536,154249,2497,151752,52845,0,0,0,52845
2022,61,89010,茨城県,稲敷地方広域市町村圏事務組合,6,2,決算収支の状況,2,令和3年度,4182359,4122769,59590,0,59590,4965,972,0,0,5937
2022,61,89079,茨城県,茨城県市町村総合事務組合（普通会計分）,6,2,決算収支の状況,2,令和3年度,15746835,15725013,21822,0,21822,1689,1671000,0,66000,1606689
2022,61,89087,茨城県,茨城県市町村総合事務組合（事業会計分）,7,2,決算収支の状況,2,令和3年度,0,0,0,0,0,0,0,0,0,0
2022,61,89095,茨城県,石岡地方斎場組合,6,2,決算収支の状況,2,令和3年度,386982,323269,63713,0,63713,1202,0,0,0,1202
2022,61,89109,茨城県,笠間地方広域事務組合,6,2,決算収支の状況,2,令和3年度,219839,209370,10469,0,10469,1085,7128,0,49995,-41782
2022,61,89168,茨城県,鹿島地方事務組合,6,2,決算収支の状況,2,令和3年度,13986080,11806633,2179447,2064140,115307,-231935,0,0,0,-231935
2022,61,89257,茨城県,高萩・北茨城広域事務組合,6,2,決算収支の状況,2,令和3年度,7982370,7075507,906863,904668,2195,486,0,0,0,486
2022,61,89346,茨城県,下妻地方広域事務組合,6,2,決算収支の状況,2,令和3年度,1763740,1508517,255223,0,255223,-14837,0,0,0,-14837
2022,61,89354,茨城県,ひたちなか・東海広域事務組合,6,2,決算収支の状況,2,令和3年度,3267827,3218307,49520,0,49520,-4251,0,0,0,-4251
2022,61,89389,茨城県,牛久市・阿見町斎場組合,6,2,決算収支の状況,2,令和3年度,280459,276404,4055,0,4055,-10562,14036,0,0,3474
2022,61,89401,茨城県,茨城租税債権管理機構,6,2,決算収支の状況,2,令和3年度,460986,256896,204090,0,204090,-15792,0,0,0,-15792
2022,61,89427,茨城県,利根川水系県南水防事務組合,6,2,決算収支の状況,2,令和3年度,19177,17749,1428,0,1428,-1570,2995,0,11680,-10255
2022,61,89443,茨城県,茨城県後期高齢者医療広域連合,7,2,決算収支の状況,2,令和3年度,122467,112635,9832,0,9832,234,1,0,0,235
2022,61,89451,茨城県,土浦・かすみがうら土地区画整理一部事務組合,6,2,決算収支の状況,2,令和3年度,535293,525271,10022,4725,5297,-102723,0,0,0,-102723
2022,61,89460,茨城県,鉾田・大洗広域事務組合,6,2,決算収支の状況,2,令和3年度,173201,120508,52693,18270,34423,34423,0,0,0,34423
2022,61,92011,栃木県,宇都宮市,8,2,決算収支の状況,2,令和3年度,262190928,251411785,10779143,4330956,6448187,4878493,16337,0,0,4894830
2022,61,92029,栃木県,足利市,3,2,決算収支の状況,2,令和3年度,59924194,56530138,3394056,340524,3053532,1440695,165334,0,0,1606029
2022,61,92037,栃木県,栃木市,3,2,決算収支の状況,2,令和3年度,76665057,72929697,3735360,167241,3568119,-1123382,2493058,16000,0,1385676
2022,61,92045,栃木県,佐野市,3,2,決算収支の状況,2,令和3年度,59812144,56394230,3417914,88350,3329564,172287,1980473,0,1048914,1103846
2022,61,92053,栃木県,鹿沼市,4,2,決算収支の状況,2,令和3年度,50253572,47611832,2641740,1002260,1639480,-24026,404416,0,0,380390
2022,61,92061,栃木県,日光市,4,2,決算収支の状況,2,令和3年度,47307271,45385238,1922033,86159,1835874,962571,36,0,0,962607
2022,61,92088,栃木県,小山市,3,2,決算収支の状況,2,令和3年度,74235360,70896051,3339309,192629,3146680,1129144,1289419,0,240,2418323
2022,61,92096,栃木県,真岡市,4,2,決算収支の状況,2,令和3年度,38957554,35031479,3926075,305405,3620670,1211081,708,0,0,1211789
2022,61,92100,栃木県,大田原市,4,2,決算収支の状況,2,令和3年度,36991738,33833531,3158207,75590,3082617,1855528,300010,0,0,2155538
2022,61,92118,栃木県,矢板市,4,2,決算収支の状況,2,令和3年度,16047903,14986448,1061455,49808,1011647,17540,860170,0,0,877710
2022,61,92134,栃木県,那須塩原市,3,2,決算収支の状況,2,令和3年度,57458414,53251156,4207258,504418,3702840,1215062,1244157,0,700000,1759219
2022,61,92142,栃木県,さくら市,4,2,決算収支の状況,2,令和3年度,23440018,21732678,1707340,87704,1619636,422045,137877,0,0,559922
2022,61,92151,栃木県,那須烏山市,4,2,決算収支の状況,2,令和3年度,13662277,13098408,563869,48163,515706,-30827,408898,0,0,378071
2022,61,92169,栃木県,下野市,4,2,決算収支の状況,2,令和3年度,33051510,30270639,2780871,469945,2310926,593922,4318,0,7702,590538
2022,61,93017,栃木県,上三川町,5,2,決算収支の状況,2,令和3年度,13326504,12271126,1055378,81324,974054,285629,156585,0,0,442214
2022,61,93424,栃木県,益子町,5,2,決算収支の状況,2,令和3年度,9489392,8820323,669069,15986,653083,162033,90038,0,0,252071
2022,61,93432,栃木県,茂木町,5,2,決算収支の状況,2,令和3年度,8753784,7484674,1269110,48831,1220279,473001,417971,0,203548,687424
2022,61,93441,栃木県,市貝町,5,2,決算収支の状況,2,令和3年度,6493380,5581537,911843,96599,815244,312160,250000,0,150000,412160
2022,61,93459,栃木県,芳賀町,5,2,決算収支の状況,2,令和3年度,11650835,10663872,986963,271987,714976,271766,312878,0,500000,84644
2022,61,93611,栃木県,壬生町,5,2,決算収支の状況,2,令和3年度,20638568,19694724,943844,16761,927083,397577,357132,0,0,754709
2022,61,93645,栃木県,野木町,5,2,決算収支の状況,2,令和3年度,9119812,8556298,563514,7011,556503,221379,110,0,0,221489
2022,61,93840,栃木県,塩谷町,5,2,決算収支の状況,2,令和3年度,7414563,6449451,965112,639253,325859,46828,30141,0,0,76969
2022,61,93866,栃木県,高根沢町,5,2,決算収支の状況,2,令和3年度,12718649,12214196,504453,42003,462450,-85807,200087,0,0,114280
2022,61,94072,栃木県,那須町,5,2,決算収支の状況,2,令和3年度,15822337,14812930,1009407,105260,904147,-130556,646200,0,0,515644
2022,61,94111,栃木県,那珂川町,5,2,決算収支の状況,2,令和3年度,10939854,9920177,1019677,44243,975434,186853,500,0,41589,145764
2022,61,98060,栃木県,那須地区広域行政事務組合（普通会計分）,6,2,決算収支の状況,2,令和3年度,4568416,4351302,217114,20273,196841,-40665,0,0,0,-40665
2022,61,98086,栃木県,佐野地区衛生施設組合,6,2,決算収支の状況,2,令和3年度,499697,385785,113912,91883,22029,-9321,16513,0,40000,-32808
2022,61,98124,栃木県,黒磯那須共同火葬場組合,6,2,決算収支の状況,2,令和3年度,50417,42734,7683,4530,3153,-148,0,0,0,-148
2022,61,98213,栃木県,芳賀郡中部環境衛生事務組合,6,2,決算収支の状況,2,令和3年度,249037,217046,31991,0,31991,-4897,0,0,0,-4897
2022,61,98281,栃木県,石橋地区消防組合,6,2,決算収支の状況,2,令和3年度,2599787,2514792,84995,0,84995,-15366,37729,24990,21680,25673
2022,61,98337,栃木県,芳賀地区広域行政事務組合（普通会計分）,6,2,決算収支の状況,2,令和3年度,4358155,4036988,321167,23078,298089,-106561,0,0,0,-106561
2022,61,98418,栃木県,南那須地区広域行政事務組合（普通会計分）,6,2,決算収支の状況,2,令和3年度,1683700,1637980,45720,0,45720,-4542,29749,0,37905,-12698
2022,61,98507,栃木県,塩谷広域行政組合,6,2,決算収支の状況,2,令和3年度,4032935,3897154,135781,0,135781,43346,114742,0,180586,-22498
2022,61,98523,栃木県,小山広域保健衛生組合,6,2,決算収支の状況,2,令和3年度,4508165,4249153,259012,2094,256918,4618,327372,0,184900,147090
2022,61,98540,栃木県,宇都宮西中核工業団地事務組合（普通会計分）,6,2,決算収支の状況,2,令和3年度,165608,151260,14348,0,14348,-13451,0,0,0,-13451
2022,61,98621,栃木県,栃木県市町村総合事務組合,6,2,決算収支の状況,2,令和3年度,8162618,7934825,227793,0,227793,11494,924445,0,0,935939
2022,61,98639,栃木県,栃木県後期高齢者医療広域連合,7,2,決算収支の状況,2,令和3年度,160486,152683,7803,0,7803,-1826,42497,0,0,40671
2022,61,98647,栃木県,那須地区消防組合,6,2,決算収支の状況,2,令和3年度,4254647,4085597,169050,0,169050,56256,0,0,0,56256
2022,61,102016,群馬県,前橋市,8,2,決算収支の状況,2,令和3年度,166462111,161455377,5006734,861123,4145611,701968,1309563,4973,0,2016504
2022,61,102024,群馬県,高崎市,8,2,決算収支の状況,2,令和3年度,185452780,176824446,8628334,440586,8187748,3566774,9955,0,3531043,45686
2022,61,102032,群馬県,桐生市,3,2,決算収支の状況,2,令和3年度,51218488,47621236,3597252,34495,3562757,1393765,462,0,923955,470272
2022,61,102041,群馬県,伊勢崎市,9,2,決算収支の状況,2,令和3年度,88369535,84977958,3391577,192946,3198631,472873,248,0,0,473121
2022,61,102059,群馬県,太田市,9,2,決算収支の状況,2,令和3年度,92127122,88350619,3776503,826131,2950372,758026,241,10277,0,768544
2022,61,102067,群馬県,沼田市,4,2,決算収支の状況,2,令和3年度,27148808,25906166,1242642,265117,977525,175481,192632,0,0,368113
2022,61,102075,群馬県,館林市,4,2,決算収支の状況,2,令和3年度,33810070,31097338,2712732,34556,2678176,626957,5838,0,1451486,-818691
2022,61,102083,群馬県,渋川市,4,2,決算収支の状況,2,令和3年度,38970940,36524983,2445957,89471,2356486,609018,54799,0,418622,245195
2022,61,102091,群馬県,藤岡市,4,2,決算収支の状況,2,令和3年度,31412801,29859574,1553227,188435,1364792,1151541,525411,0,0,1676952
2022,61,102105,群馬県,富岡市,4,2,決算収支の状況,2,令和3年度,23531539,22172561,1358978,104665,1254313,379701,244090,0,0,623791
2022,61,102113,群馬県,安中市,4,2,決算収支の状況,2,令和3年度,27701808,26174677,1527131,110203,1416928,247570,876,0,0,248446
2022,61,102121,群馬県,みどり市,4,2,決算収支の状況,2,令和3年度,25260182,23782375,1477807,132245,1345562,53531,52812,0,0,106343
2022,61,103446,群馬県,榛東村,5,2,決算収支の状況,2,令和3年度,7606691,7070806,535885,176882,359003,153103,1307,0,0,154410
2022,61,103454,群馬県,吉岡町,5,2,決算収支の状況,2,令和3年度,9664860,9342755,322105,81851,240254,203935,18155,0,0,222090
2022,61,103667,群馬県,上野村,5,2,決算収支の状況,2,令和3年度,4063551,3925195,138356,44855,93501,-79480,4008,0,33826,-109298
2022,61,103675,群馬県,神流町,5,2,決算収支の状況,2,令和3年度,3637405,3516827,120578,69235,51343,24953,94,0,250000,-224953
2022,61,103829,群馬県,下仁田町,5,2,決算収支の状況,2,令和3年度,5834617,5723961,110656,8450,102206,79487,305134,0,0,384621
2022,61,103837,群馬県,南牧村,5,2,決算収支の状況,2,令和3年度,2528251,2275091,253160,33861,219299,31860,806,0,0,32666
2022,61,103845,群馬県,甘楽町,5,2,決算収支の状況,2,令和3年度,7037707,6669396,368311,55116,313195,71916,300443,0,0,372359
2022,61,104213,群馬県,中之条町,5,2,決算収支の状況,2,令和3年度,11519223,10604038,915185,155279,759906,-13496,383781,0,80000,290285
2022,61,104248,群馬県,長野原町,5,2,決算収支の状況,2,令和3年度,5897894,5422415,475479,77242,398237,-5515,41358,0,6732,29111
2022,61,104256,群馬県,嬬恋村,5,2,決算収支の状況,2,令和3年度,9240908,8612430,628478,338814,289664,275112,7722,0,0,282834
2022,61,104264,群馬県,草津町,5,2,決算収支の状況,2,令和3年度,6173923,6002953,170970,63798,107172,-39099,771539,0,527000,205440
2022,61,104281,群馬県,高山村,5,2,決算収支の状況,2,令和3年度,3804639,3552912,251727,79713,172014,58910,9762,0,0,68672
2022,61,104299,群馬県,東吾妻町,5,2,決算収支の状況,2,令和3年度,9236566,8905299,331267,52583,278684,83126,446542,0,0,529668
2022,61,104434,群馬県,片品村,5,2,決算収支の状況,2,令和3年度,4437835,3873327,564508,50798,513710,229753,216601,0,0,446354
2022,61,104442,群馬県,川場村,5,2,決算収支の状況,2,令和3年度,4136143,3718805,417338,147091,270247,18120,20,0,0,18140
2022,61,104485,群馬県,昭和村,5,2,決算収支の状況,2,令和3年度,6935328,6363181,572147,78258,493889,47921,36976,0,0,84897
2022,61,104493,群馬県,みなかみ町,5,2,決算収支の状況,2,令和3年度,17031872,16121778,910094,147285,762809,386804,80,0,220000,166884
2022,61,104647,群馬県,玉村町,5,2,決算収支の状況,2,令和3年度,14107528,13207805,899723,23074,876649,44810,49,0,0,44859
2022,61,105210,群馬県,板倉町,5,2,決算収支の状況,2,令和3年度,6864187,5979374,884813,24392,860421,152173,454691,0,0,606864
2022,61,105228,群馬県,明和町,5,2,決算収支の状況,2,令和3年度,6488927,6021992,466935,92533,374402,266689,340,0,150000,117029
2022,61,105236,群馬県,千代田町,5,2,決算収支の状況,2,令和3年度,8113822,7211198,902624,85161,817463,460792,350349,0,200000,611141
2022,61,105244,群馬県,大泉町,5,2,決算収支の状況,2,令和3年度,15224656,14426590,798066,18563,779503,168020,315394,0,131682,351732
2022,61,105252,群馬県,邑楽町,5,2,決算収支の状況,2,令和3年度,11635983,11051469,584514,133462,451052,7651,638352,0,487196,158807
2022,61,108065,群馬県,烏帽子山植林組合,6,2,決算収支の状況,2,令和3年度,726,595,131,0,131,115,0,0,0,115
2022,61,108383,群馬県,甘楽西部環境衛生施設組合,6,2,決算収支の状況,2,令和3年度,260632,249413,11219,0,11219,-3301,0,0,0,-3301
2022,61,108391,群馬県,館林衛生施設組合,6,2,決算収支の状況,2,令和3年度,1653812,1601576,52236,0,52236,-7869,1,0,73205,-81073
2022,61,108405,群馬県,吾妻東部衛生施設組合,6,2,決算収支の状況,2,令和3年度,693296,665460,27836,0,27836,-2317,19412,0,35718,-18623
2022,61,108421,群馬県,西吾妻衛生施設組合,6,2,決算収支の状況,2,令和3年度,103086,89519,13567,0,13567,-10111,0,0,0,-10111
2022,61,108618,群馬県,館林地区消防組合,6,2,決算収支の状況,2,令和3年度,2466038,2231468,234570,69555,165015,3910,2,0,164017,-160105
2022,61,108626,群馬県,利根沼田広域市町村圏振興整備組合,6,2,決算収支の状況,2,令和3年度,2038145,1993623,44522,5500,39022,6313,7429,0,9027,4715
2022,61,108634,群馬県,高崎市・安中市消防組合,6,2,決算収支の状況,2,令和3年度,4953271,4900345,52926,0,52926,-18421,0,0,0,-18421
2022,61,108707,群馬県,西吾妻環境衛生施設組合,6,2,決算収支の状況,2,令和3年度,442867,434535,8332,0,8332,-6401,12478,0,0,6077
2022,61,108731,群馬県,渋川地区広域市町村圏振興整備組合,6,2,決算収支の状況,2,令和3年度,3397372,3306863,90509,0,90509,-41912,34,0,37453,-79331
2022,61,108740,群馬県,富岡甘楽広域市町村圏振興整備組合,6,2,決算収支の状況,2,令和3年度,1767463,1713957,53506,0,53506,24298,0,0,0,24298
2022,61,108758,群馬県,沼田市外二箇村清掃施設組合,6,2,決算収支の状況,2,令和3年度,474988,463885,11103,0,11103,-6611,1,0,20000,-26610
2022,61,108766,群馬県,群馬県市町村会館管理組合,6,2,決算収支の状況,2,令和3年度,146527,124757,21770,0,21770,-13313,0,0,0,-13313
2022,61,108804,群馬県,吾妻広域町村圏振興整備組合（普通会計分）,6,2,決算収支の状況,2,令和3年度,1712420,1663574,48846,0,48846,-10002,53849,0,43156,691
2022,61,108821,群馬県,多野藤岡広域市町村圏振興整備組合,6,2,決算収支の状況,2,令和3年度,1768835,1747523,21312,0,21312,615,28,0,633,10
2022,61,108839,群馬県,利根沼田学校組合,6,2,決算収支の状況,2,令和3年度,511614,489573,22041,0,22041,-369,2,0,5497,-5864
2022,61,108901,群馬県,大泉町外二町環境衛生施設組合,6,2,決算収支の状況,2,令和3年度,411186,378010,33176,0,33176,-28093,0,0,0,-28093
2022,61,108928,群馬県,利根東部衛生施設組合,6,2,決算収支の状況,2,令和3年度,245544,237317,8227,0,8227,-7838,2,0,0,-7836
2022,61,109061,群馬県,群馬県市町村総合事務組合,6,2,決算収支の状況,2,令和3年度,7171537,6595490,576047,0,576047,-106050,48577,0,2440000,-2497473
2022,61,109142,群馬県,太田市外三町広域清掃組合,6,2,決算収支の状況,2,令和3年度,2939976,2630528,309448,0,309448,207610,0,0,0,207610
2022,61,109185,群馬県,群馬県後期高齢者医療広域連合,7,2,決算収支の状況,2,令和3年度,89224,83128,6096,0,6096,-87,2,0,2855,-2940
2022,61,109207,群馬県,吾妻環境施設組合,6,2,決算収支の状況,2,令和3年度,2547,1898,649,0,649,560,0,0,0,560
2022,61,111007,埼玉県,さいたま市,1,2,決算収支の状況,2,令和3年度,654914371,640991108,13923263,6595506,7327757,-462425,7790452,0,0,7328027
2022,61,112011,埼玉県,川越市,8,2,決算収支の状況,2,令和3年度,133592397,125854141,7738256,62995,7675261,3607103,695623,0,4908,4297818
2022,61,112020,埼玉県,熊谷市,9,2,決算収支の状況,2,令和3年度,78998895,72437637,6561258,277128,6284130,835581,1849398,0,0,2684979
2022,61,112038,埼玉県,川口市,8,2,決算収支の状況,2,令和3年度,247467525,235191410,12276115,1778165,10497950,1168177,3415142,0,0,4583319
2022,61,112062,埼玉県,行田市,4,2,決算収支の状況,2,令和3年度,31809787,28580969,3228818,370252,2858566,1373553,202786,0,0,1576339
2022,61,112071,埼玉県,秩父市,4,2,決算収支の状況,2,令和3年度,34664137,32051751,2612386,334392,2277994,976510,874089,785495,550000,2086094
2022,61,112089,埼玉県,所沢市,9,2,決算収支の状況,2,令和3年度,127659838,118826140,8833698,1194405,7639293,2236876,3588839,0,1699374,4126341
2022,61,112097,埼玉県,飯能市,4,2,決算収支の状況,2,令和3年度,36616936,34823285,1793651,192684,1600967,-79329,553337,0,0,474008
2022,61,112101,埼玉県,加須市,3,2,決算収支の状況,2,令和3年度,51941664,45553955,6387709,1327479,5060230,416006,963,227000,19127,624842
2022,61,112119,埼玉県,本庄市,4,2,決算収支の状況,2,令和3年度,34804668,31569303,3235365,135620,3099745,779501,387490,0,0,1166991
2022,61,112127,埼玉県,東松山市,4,2,決算収支の状況,2,令和3年度,37403526,35200005,2203521,352951,1850570,397632,1570646,0,1000500,967778
2022,61,112143,埼玉県,春日部市,9,2,決算収支の状況,2,令和3年度,89933522,84433713,5499809,537280,4962529,1738422,1941279,0,67128,3612573
2022,61,112151,埼玉県,狭山市,3,2,決算収支の状況,2,令和3年度,56681256,53802237,2879019,244082,2634937,1868063,1665768,0,1000000,2533831
2022,61,112160,埼玉県,羽生市,4,2,決算収支の状況,2,令和3年度,23602189,21228385,2373804,374678,1999126,661378,1193309,0,350000,1504687
2022,61,112178,埼玉県,鴻巣市,3,2,決算収支の状況,2,令和3年度,47403982,44797871,2606111,125587,2480524,637660,456180,0,0,1093840
2022,61,112186,埼玉県,深谷市,3,2,決算収支の状況,2,令和3年度,62640544,55172334,7468210,1500190,5968020,2959654,1616642,0,622201,3954095
2022,61,112194,埼玉県,上尾市,3,2,決算収支の状況,2,令和3年度,79893685,75480576,4413109,768551,3644558,297648,1112481,0,0,1410129
2022,61,112216,埼玉県,草加市,9,2,決算収支の状況,2,令和3年度,99448636,90243486,9205150,3366445,5838705,2152562,2895464,0,0,5048026
2022,61,112224,埼玉県,越谷市,8,2,決算収支の状況,2,令和3年度,134371610,122931500,11440110,70792,11369318,4868006,6136700,0,3773000,7231706
2022,61,112232,埼玉県,蕨市,4,2,決算収支の状況,2,令和3年度,33336721,30399219,2937502,314931,2622571,831541,508691,0,0,1340232
2022,61,112241,埼玉県,戸田市,3,2,決算収支の状況,2,令和3年度,66301258,61250512,5050746,763689,4287057,203151,2867991,1391215,2359521,2102836
2022,61,112259,埼玉県,入間市,3,2,決算収支の状況,2,令和3年度,51158353,49060772,2097581,86653,2010928,815246,1694709,0,0,2509955
2022,61,112275,埼玉県,朝霞市,3,2,決算収支の状況,2,令和3年度,53668131,50728561,2939570,108935,2830635,1842454,1671677,0,1762250,1751881
2022,61,112283,埼玉県,志木市,4,2,決算収支の状況,2,令和3年度,33464369,30783049,2681320,334091,2347229,705164,162130,0,0,867294
2022,61,112291,埼玉県,和光市,4,2,決算収支の状況,2,令和3年度,35715416,32550200,3165216,125643,3039573,1224930,1669496,0,1751357,1143069
2022,61,112305,埼玉県,新座市,3,2,決算収支の状況,2,令和3年度,65665463,62166555,3498908,163284,3335624,54548,7149956,0,2569483,4635021
2022,61,112313,埼玉県,桶川市,4,2,決算収支の状況,2,令和3年度,27930342,26985901,944441,37644,906797,292764,15,0,84555,208224
2022,61,112321,埼玉県,久喜市,3,2,決算収支の状況,2,令和3年度,60659466,58162400,2497066,283616,2213450,174677,327,144,843213,-668065
2022,61,112330,埼玉県,北本市,4,2,決算収支の状況,2,令和3年度,25722999,24207852,1515147,17138,1498009,332536,638061,0,0,970597
2022,61,112348,埼玉県,八潮市,4,2,決算収支の状況,2,令和3年度,39733763,36882636,2851127,188595,2662532,846779,979143,0,507012,1318910
2022,61,112356,埼玉県,富士見市,3,2,決算収支の状況,2,令和3年度,40410221,38004997,2405224,896270,1508954,713123,560,0,0,713683
2022,61,112372,埼玉県,三郷市,3,2,決算収支の状況,2,令和3年度,63276810,58220040,5056770,192122,4864648,1508787,5129593,0,3552234,3086146
2022,61,112381,埼玉県,蓮田市,4,2,決算収支の状況,2,令和3年度,24157897,22444443,1713454,342748,1370706,231783,1348344,0,1195080,385047
2022,61,112399,埼玉県,坂戸市,3,2,決算収支の状況,2,令和3年度,37478137,34595907,2882230,292670,2589560,1333816,951577,0,688347,1597046
2022,61,112402,埼玉県,幸手市,4,2,決算収支の状況,2,令和3年度,19721675,18078728,1642947,104170,1538777,613411,660006,0,250000,1023417
2022,61,112411,埼玉県,鶴ケ島市,4,2,決算収支の状況,2,令和3年度,27289335,25965555,1323780,93606,1230174,116662,1003141,0,617431,502372
2022,61,112429,埼玉県,日高市,4,2,決算収支の状況,2,令和3年度,23430746,21094411,2336335,845587,1490748,277046,990442,0,238560,1028928
2022,61,112437,埼玉県,吉川市,4,2,決算収支の状況,2,令和3年度,28355517,27172201,1183316,24814,1158502,314290,775456,0,0,1089746
2022,61,112453,埼玉県,ふじみ野市,3,2,決算収支の状況,2,令和3年度,50945404,48422395,2523009,309196,2213813,207318,2543,0,43791,166070
2022,61,112461,埼玉県,白岡市,4,2,決算収支の状況,2,令和3年度,18234951,17198870,1036081,265680,770401,8744,120848,0,0,129592
2022,61,113018,埼玉県,伊奈町,5,2,決算収支の状況,2,令和3年度,15452334,14798241,654093,5825,648268,134154,96461,0,4,230611
2022,61,113247,埼玉県,三芳町,5,2,決算収支の状況,2,令和3年度,15880372,14738872,1141500,28384,1113116,190710,422406,0,49205,563911
2022,61,113263,埼玉県,毛呂山町,5,2,決算収支の状況,2,令和3年度,11675713,11231843,443870,13846,430024,2242,592027,0,161989,432280
2022,61,113271,埼玉県,越生町,5,2,決算収支の状況,2,令和3年度,5278407,4754056,524351,84397,439954,189339,42383,0,0,231722
2022,61,113417,埼玉県,滑川町,5,2,決算収支の状況,2,令和3年度,8358680,7773480,585200,15208,569992,201314,428212,0,0,629526
2022,61,113425,埼玉県,嵐山町,5,2,決算収支の状況,2,令和3年度,7655324,7169539,485785,28477,457308,164673,470003,0,90000,544676
2022,61,113433,埼玉県,小川町,5,2,決算収支の状況,2,令和3年度,10318596,9832560,486036,40703,445333,196075,140795,3100,0,339970
2022,61,113468,埼玉県,川島町,5,2,決算収支の状況,2,令和3年度,8556768,7919638,637130,93170,543960,-57427,269512,0,0,212085
2022,61,113476,埼玉県,吉見町,5,2,決算収支の状況,2,令和3年度,9174544,8418456,756088,16153,739935,299965,9264,45,0,309274
2022,61,113484,埼玉県,鳩山町,5,2,決算収支の状況,2,令和3年度,6270826,5980973,289853,64670,225183,51973,305148,0,0,357121
2022,61,113492,埼玉県,ときがわ町,5,2,決算収支の状況,2,令和3年度,6563093,6186014,377079,46157,330922,120281,93547,0,17784,196044
2022,61,113611,埼玉県,横瀬町,5,2,決算収支の状況,2,令和3年度,5424844,5188066,236778,25427,211351,58120,280000,0,116000,222120
2022,61,113620,埼玉県,皆野町,5,2,決算収支の状況,2,令和3年度,5142563,4931028,211535,18464,193071,-27345,512728,0,0,485383
2022,61,113638,埼玉県,長瀞町,5,2,決算収支の状況,2,令和3年度,4129588,3862696,266892,46154,220738,81649,97975,0,0,179624
2022,61,113654,埼玉県,小鹿野町,5,2,決算収支の状況,2,令和3年度,8158825,7506710,652115,173180,478935,-187889,310367,0,0,122478
2022,61,113697,埼玉県,東秩父村,5,2,決算収支の状況,2,令和3年度,2869893,2631143,238750,48847,189903,-9199,277022,0,223000,44823
2022,61,113816,埼玉県,美里町,5,2,決算収支の状況,2,令和3年度,6191845,5530222,661623,69758,591865,200133,196074,0,196074,200133
2022,61,113832,埼玉県,神川町,5,2,決算収支の状況,2,令和3年度,7332240,6883338,448902,8162,440740,206964,1925,0,0,208889
2022,61,113859,埼玉県,上里町,5,2,決算収支の状況,2,令和3年度,11993251,11074987,918264,71933,846331,334496,110535,0,45083,399948
2022,61,114081,埼玉県,寄居町,5,2,決算収支の状況,2,令和3年度,13310612,12179636,1130976,40683,1090293,505853,155016,0,0,660869
2022,61,114421,埼玉県,宮代町,5,2,決算収支の状況,2,令和3年度,12766038,11562351,1203687,183197,1020490,534803,243952,0,28175,750580
2022,61,114642,埼玉県,杉戸町,5,2,決算収支の状況,2,令和3年度,16128413,15213321,915092,124316,790776,184805,3,0,0,184808
2022,61,114651,埼玉県,松伏町,5,2,決算収支の状況,2,令和3年度,11482634,10399353,1083281,96540,986741,398117,294328,0,160218,532227
2022,61,118061,埼玉県,埼葛斎場組合,6,2,決算収支の状況,2,令和3年度,445002,402740,42262,440,41822,22841,0,0,0,22841
2022,61,118087,埼玉県,蓮田白岡衛生組合,6,2,決算収支の状況,2,令和3年度,1841464,1740048,101416,64853,36563,-16230,0,0,0,-16230
2022,61,118095,埼玉県,久喜宮代衛生組合,6,2,決算収支の状況,2,令和3年度,3838693,3645827,192866,0,192866,12881,0,0,67000,-54119
2022,61,118109,埼玉県,朝霞地区一部事務組合,6,2,決算収支の状況,2,令和3年度,5729722,5478655,251067,0,251067,-101538,0,0,0,-101538
2022,61,118141,埼玉県,上尾、桶川、伊奈衛生組合,6,2,決算収支の状況,2,令和3年度,286550,275970,10580,0,10580,-19063,17256,0,0,-1807
2022,61,118150,埼玉県,志木地区衛生組合,6,2,決算収支の状況,2,令和3年度,5013969,4849538,164431,0,164431,113298,266543,0,0,379841
2022,61,118168,埼玉県,北本地区衛生組合,6,2,決算収支の状況,2,令和3年度,302687,279218,23469,0,23469,848,0,0,0,848
2022,61,118176,埼玉県,入間西部衛生組合,6,2,決算収支の状況,2,令和3年度,294078,235696,58382,0,58382,741,0,0,0,741
2022,61,118206,埼玉県,小川地区衛生組合,6,2,決算収支の状況,2,令和3年度,1318046,1096691,221355,85855,135500,61810,0,0,0,61810
2022,61,118214,埼玉県,坂戸地区衛生組合,6,2,決算収支の状況,2,令和3年度,264999,245776,19223,0,19223,-10302,0,0,0,-10302
2022,61,118249,埼玉県,東埼玉資源環境組合,6,2,決算収支の状況,2,令和3年度,5878064,5645783,232281,0,232281,32484,0,0,0,32484
2022,61,118273,埼玉県,蕨戸田衛生センター組合,6,2,決算収支の状況,2,令和3年度,3282865,3160151,122714,0,122714,-38787,0,0,0,-38787
2022,61,118303,埼玉県,本庄上里学校給食組合,6,2,決算収支の状況,2,令和3年度,824778,809892,14886,0,14886,-11866,0,0,0,-11866
2022,61,118401,埼玉県,加須市・羽生市水防事務組合,6,2,決算収支の状況,2,令和3年度,10138,1190,8948,0,8948,3310,0,0,0,3310
2022,61,118419,埼玉県,荒川北縁水防事務組合,6,2,決算収支の状況,2,令和3年度,8444,1852,6592,0,6592,2447,0,0,0,2447
2022,61,118435,埼玉県,利根川栗橋流域水防事務組合,6,2,決算収支の状況,2,令和3年度,13751,5467,8284,0,8284,2033,0,0,0,2033
2022,61,118443,埼玉県,江戸川水防事務組合,6,2,決算収支の状況,2,令和3年度,7314,3609,3705,0,3705,-194,0,0,0,-194
2022,61,118451,埼玉県,戸田ボートレース企業団,7,2,決算収支の状況,2,令和3年度,0,0,0,0,0,0,0,0,0,0
2022,61,118486,埼玉県,埼玉県市町村総合事務組合,6,2,決算収支の状況,2,令和3年度,23193458,22713573,479885,0,479885,-514032,3441496,0,5600,2921864
2022,61,118494,埼玉県,埼玉県都市ボートレース企業団,7,2,決算収支の状況,2,令和3年度,0,0,0,0,0,0,0,0,0,0
2022,61,118613,埼玉県,彩北広域清掃組合,6,2,決算収支の状況,2,令和3年度,570933,529355,41578,0,41578,5308,54,0,14000,-8638
2022,61,118630,埼玉県,秩父広域市町村圏組合,6,2,決算収支の状況,2,令和3年度,3489092,3170602,318490,11718,306772,28758,0,0,0,28758
2022,61,118656,埼玉県,入間東部地区事務組合,6,2,決算収支の状況,2,令和3年度,3842500,3664148,178352,0,178352,-80242,0,13903,0,-66339
2022,61,118681,埼玉県,吉川松伏消防組合,6,2,決算収支の状況,2,令和3年度,1794400,1750716,43684,0,43684,-18071,0,0,0,-18071
2022,61,118699,埼玉県,児玉郡市広域市町村圏組合,6,2,決算収支の状況,2,令和3年度,4282926,4149863,133063,0,133063,37343,47867,0,227963,-142753
2022,61,118711,埼玉県,埼玉西部環境保全組合,6,2,決算収支の状況,2,令和3年度,6536512,6402107,134405,11622,122783,102179,38097,0,31875,108401
2022,61,118761,埼玉県,坂戸・鶴ケ島消防組合,6,2,決算収支の状況,2,令和3年度,2577428,2386304,191124,8233,182891,17326,0,0,0,17326
2022,61,118770,埼玉県,比企広域市町村圏組合,6,2,決算収支の状況,2,令和3年度,3847873,3610509,237364,0,237364,17875,0,0,0,17875
2022,61,118788,埼玉県,川越地区消防組合,6,2,決算収支の状況,2,令和3年度,5355831,5127103,228728,660,228068,-68105,0,0,0,-68105
2022,61,118826,埼玉県,埼玉県央広域事務組合,6,2,決算収支の状況,2,令和3年度,3846495,3752910,93585,0,93585,3414,200377,0,149106,54685
2022,61,118842,埼玉県,西入間広域消防組合,6,2,決算収支の状況,2,令和3年度,1202505,1160382,42123,0,42123,11087,0,0,0,11087
2022,61,118851,埼玉県,埼玉中部環境保全組合,6,2,決算収支の状況,2,令和3年度,780935,763773,17162,0,17162,-3494,49481,0,0,45987
2022,61,118869,埼玉県,埼玉県浦和競馬組合,7,2,決算収支の状況,2,令和3年度,0,0,0,0,0,0,0,0,0,0
2022,61,118923,埼玉県,広域飯能斎場組合,6,2,決算収支の状況,2,令和3年度,154084,142034,12050,0,12050,1660,0,0,0,1660
2022,61,118931,埼玉県,広域静苑組合,6,2,決算収支の状況,2,令和3年度,228915,218887,10028,0,10028,-3986,0,0,0,-3986
2022,61,118958,埼玉県,広域利根斎場組合,6,2,決算収支の状況,2,令和3年度,311083,269352,41731,0,41731,14032,0,0,0,14032
2022,61,118974,埼玉県,彩の国さいたま人づくり広域連合,6,2,決算収支の状況,2,令和3年度,331577,323726,7851,0,7851,-10144,0,0,0,-10144
2022,61,118982,埼玉県,皆野・長瀞下水道組合,6,2,決算収支の状況,2,令和3年度,150214,136223,13991,0,13991,2471,0,0,0,2471
2022,61,118991,埼玉県,大里広域市町村圏組合,6,2,決算収支の状況,2,令和3年度,4274872,3979743,295129,0,295129,26438,0,0,0,26438
2022,61,119008,埼玉県,埼玉県後期高齢者医療広域連合,7,2,決算収支の状況,2,令和3年度,172612,136113,36499,0,36499,1992,0,0,0,1992
2022,61,119016,埼玉県,埼玉西部消防組合,6,2,決算収支の状況,2,令和3年度,10264537,9837647,426890,0,426890,-74164,0,0,0,-74164
2022,61,119024,埼玉県,埼玉東部消防組合,6,2,決算収支の状況,2,令和3年度,6219487,6009109,210378,0,210378,-136364,87315,0,58566,-107615
2022,61,119041,埼玉県,草加八潮消防組合,6,2,決算収支の状況,2,令和3年度,4314530,4075832,238698,31460,207238,-56733,0,0,0,-56733
2022,61,119067,埼玉県,朝霞和光資源循環組合,6,2,決算収支の状況,2,令和3年度,674466,571928,102538,0,102538,92376,7907,0,0,100283
2022,61,119075,埼玉県,行田羽生資源環境組合,6,2,決算収支の状況,2,令和3年度,0,0,0,0,0,0,0,0,0,0
2022,61,121002,千葉県,千葉市,1,2,決算収支の状況,2,令和3年度,514381284,507597663,6783621,3805778,2977843,-2743242,6184391,0,35990,3405159
2022,61,122025,千葉県,銚子市,4,2,決算収支の状況,2,令和3年度,27056620,25821542,1235078,13738,1221340,523051,422234,0,0,945285
2022,61,122033,千葉県,市川市,3,2,決算収支の状況,2,令和3年度,184240372,177121994,7118378,2224658,4893720,1063600,13704,0,0,1077304
2022,61,122041,千葉県,船橋市,8,2,決算収支の状況,2,令和3年度,253140520,242389403,10751117,666170,10084947,6386545,44,2890785,0,9277374
2022,61,122050,千葉県,館山市,4,2,決算収支の状況,2,令和3年度,24024592,22930557,1094035,105033,989002,-311051,49,0,0,-311002
2022,61,122068,千葉県,木更津市,3,2,決算収支の状況,2,令和3年度,52770820,50279879,2490941,855603,1635338,285039,2708,0,0,287747
2022,61,122076,千葉県,松戸市,3,2,決算収支の状況,2,令和3年度,194271125,184415163,9855962,864301,8991661,3101544,3547286,1252,0,6650082
2022,61,122084,千葉県,野田市,3,2,決算収支の状況,2,令和3年度,64128997,61109674,3019323,809475,2209848,773029,2275117,0,2030000,1018146
2022,61,122106,千葉県,茂原市,4,2,決算収支の状況,2,令和3年度,36725605,35371483,1354122,55645,1298477,561000,1150014,60000,750000,1021014
2022,61,122114,千葉県,成田市,3,2,決算収支の状況,2,令和3年度,73434283,69538234,3896049,642461,3253588,-144222,3015474,0,2347077,524175
2022,61,122122,千葉県,佐倉市,3,2,決算収支の状況,2,令和3年度,59013603,55702326,3311277,338430,2972847,1340509,1613457,0,530908,2423058
2022,61,122131,千葉県,東金市,4,2,決算収支の状況,2,令和3年度,23628582,22255081,1373501,104376,1269125,488934,18202,0,0,507136
2022,61,122157,千葉県,旭市,4,2,決算収支の状況,2,令和3年度,37907359,35852878,2054481,418138,1636343,-362869,37134,0,459771,-785506
2022,61,122165,千葉県,習志野市,3,2,決算収支の状況,2,令和3年度,68577450,64711330,3866120,281449,3584671,1371710,1988,0,0,1373698
2022,61,122173,千葉県,柏市,8,2,決算収支の状況,2,令和3年度,161481120,153273328,8207792,2715720,5492072,389851,4010,0,0,393861
2022,61,122181,千葉県,勝浦市,4,2,決算収支の状況,2,令和3年度,13712654,13168302,544352,155744,388608,-19077,213882,117117,0,311922
2022,61,122190,千葉県,市原市,3,2,決算収支の状況,2,令和3年度,118354676,111039179,7315497,966365,6349132,1472132,76629,0,4345160,-2796399
2022,61,122203,千葉県,流山市,3,2,決算収支の状況,2,令和3年度,86775249,82867764,3907485,765074,3142411,986061,0,0,0,986061
2022,61,122211,千葉県,八千代市,3,2,決算収支の状況,2,令和3年度,70506590,66776064,3730526,722188,3008338,993764,296376,0,0,1290140
2022,61,122220,千葉県,我孫子市,3,2,決算収支の状況,2,令和3年度,53880777,52184044,1696733,220673,1476060,436109,920000,0,0,1356109
2022,61,122238,千葉県,鴨川市,4,2,決算収支の状況,2,令和3年度,19298961,18281870,1017091,147012,870079,271426,411504,0,0,682930
2022,61,122246,千葉県,鎌ケ谷市,3,2,決算収支の状況,2,令和3年度,45167626,42094516,3073110,229038,2844072,1145708,849236,0,732062,1262882
2022,61,122254,千葉県,君津市,4,2,決算収支の状況,2,令和3年度,42402580,39527141,2875439,511364,2364075,337040,1972879,2347,1078251,1234015
2022,61,122262,千葉県,富津市,4,2,決算収支の状況,2,令和3年度,22029689,20565936,1463753,203720,1260033,505160,58,0,134119,371099
2022,61,122271,千葉県,浦安市,3,2,決算収支の状況,2,令和3年度,75669641,73335776,2333865,697974,1635891,-305125,11779,0,0,-293346
2022,61,122289,千葉県,四街道市,4,2,決算収支の状況,2,令和3年度,36595663,34287367,2308296,393766,1914530,642201,1037658,0,0,1679859
2022,61,122297,千葉県,袖ケ浦市,4,2,決算収支の状況,2,令和3年度,31488632,30350531,1138101,213860,924241,-146133,535765,0,258207,131425
2022,61,122301,千葉県,八街市,4,2,決算収支の状況,2,令和3年度,26318915,24948283,1370632,325334,1045298,-11907,15,0,159684,-171576
2022,61,122319,千葉県,印西市,3,2,決算収支の状況,2,令和3年度,47522438,42455344,5067094,1449635,3617459,619635,3240,0,1261358,-638483
2022,61,122327,千葉県,白井市,4,2,決算収支の状況,2,令和3年度,24977075,23551604,1425471,277983,1147488,319076,839940,0,895794,263222
2022,61,122335,千葉県,富里市,4,2,決算収支の状況,2,令和3年度,20640303,19251610,1388693,218139,1170554,277231,780989,0,0,1058220
2022,61,122343,千葉県,南房総市,4,2,決算収支の状況,2,令和3年度,27826100,26450443,1375657,262607,1113050,-740313,347,0,0,-739966
2022,61,122351,千葉県,匝瑳市,4,2,決算収支の状況,2,令和3年度,17868875,16750239,1118636,79801,1038835,75062,2111,0,84000,-6827
2022,61,122360,千葉県,香取市,4,2,決算収支の状況,2,令和3年度,39646972,36493007,3153965,340061,2813904,-4612,7724,1046800,900000,149912
2022,61,122378,千葉県,山武市,4,2,決算収支の状況,2,令和3年度,27702873,26261665,1441208,292537,1148671,249214,22961,0,600000,-327825
2022,61,122386,千葉県,いすみ市,4,2,決算収支の状況,2,令和3年度,19886954,18599957,1286997,190188,1096809,105145,2334,0,219347,-111868
2022,61,122394,千葉県,大網白里市,4,2,決算収支の状況,2,令和3年度,17887291,16947118,940173,57460,882713,266666,6,0,0,266672
2022,61,123226,千葉県,酒々井町,5,2,決算収支の状況,2,令和3年度,7720567,7290705,429862,20353,409509,181805,8064,0,191204,-1335
2022,61,123293,千葉県,栄町,5,2,決算収支の状況,2,令和3年度,8505825,8102090,403735,14349,389386,54202,226739,0,11746,269195
2022,61,123421,千葉県,神崎町,5,2,決算収支の状況,2,令和3年度,3363223,3097344,265879,17275,248604,47787,100758,0,0,148545
2022,61,123471,千葉県,多古町,5,2,決算収支の状況,2,令和3年度,8507167,7864913,642254,49745,592509,-107288,638793,0,0,531505
2022,61,123498,千葉県,東庄町,5,2,決算収支の状況,2,令和3年度,7059897,6042004,1017893,51404,966489,496523,13,0,0,496536
2022,61,124036,千葉県,九十九里町,5,2,決算収支の状況,2,令和3年度,7653841,7186452,467389,1016,466373,-145482,712824,0,0,567342
2022,61,124095,千葉県,芝山町,5,2,決算収支の状況,2,令和3年度,6763251,6265136,498115,69986,428129,175153,128685,0,0,303838
2022,61,124109,千葉県,横芝光町,5,2,決算収支の状況,2,令和3年度,13510776,12994132,516644,51742,464902,53555,207201,0,50000,210756
2022,61,124214,千葉県,一宮町,5,2,決算収支の状況,2,令和3年度,6123155,5845189,277966,40453,237513,-68691,387171,0,0,318480
2022,61,124222,千葉県,睦沢町,5,2,決算収支の状況,2,令和3年度,4277103,4107026,170077,83303,86774,-63953,153366,0,0,89413
2022,61,124231,千葉県,長生村,5,2,決算収支の状況,2,令和3年度,7527575,7102320,425255,39307,385948,27141,179404,0,84542,122003
2022,61,124249,千葉県,白子町,5,2,決算収支の状況,2,令和3年度,5808161,5530635,277526,12752,264774,86473,251255,0,0,337728
2022,61,124265,千葉県,長柄町,5,2,決算収支の状況,2,令和3年度,5537888,4956739,581149,33471,547678,348688,110003,6078,0,464769
2022,61,124273,千葉県,長南町,5,2,決算収支の状況,2,令和3年度,6104246,5750431,353815,138527,215288,-36166,332616,0,204000,92450
2022,61,124419,千葉県,大多喜町,5,2,決算収支の状況,2,令和3年度,6687398,6079680,607718,202777,404941,91483,180000,0,0,271483
2022,61,124435,千葉県,御宿町,5,2,決算収支の状況,2,令和3年度,4682266,4264220,418046,40456,377590,126848,50125,0,0,176973
2022,61,124630,千葉県,鋸南町,5,2,決算収支の状況,2,令和3年度,5216040,4809225,406815,172546,234269,-97696,380726,0,0,283030
2022,61,128139,千葉県,千葉県市町村総合事務組合,6,2,決算収支の状況,2,令和3年度,21353715,20848995,504720,28049,476671,284885,0,0,0,284885
2022,61,128155,千葉県,東葛中部地区総合開発事務組合,6,2,決算収支の状況,2,令和3年度,928380,792806,135574,87395,48179,-6811,2,0,20000,-26809
2022,61,128163,千葉県,鋸南地区環境衛生組合,6,2,決算収支の状況,2,令和3年度,652420,599931,52489,0,52489,15728,32389,0,0,48117
2022,61,128287,千葉県,佐倉市、酒々井町清掃組合,6,2,決算収支の状況,2,令和3年度,1728789,1611056,117733,19604,98129,-30264,114970,0,170000,-85294
2022,61,128309,千葉県,東金市外三市町清掃組合,6,2,決算収支の状況,2,令和3年度,1523647,1410304,113343,4694,108649,63686,6180,0,82447,-12581
2022,61,128317,千葉県,山武郡市環境衛生組合,6,2,決算収支の状況,2,令和3年度,1216172,1164881,51291,0,51291,12789,71130,0,0,83919
2022,61,128333,千葉県,柏・白井・鎌ケ谷環境衛生組合,6,2,決算収支の状況,2,令和3年度,5392958,5155924,237034,96509,140525,19297,27862,0,52303,-5144
2022,61,128341,千葉県,印旛衛生施設管理組合,6,2,決算収支の状況,2,令和3年度,358675,349867,8808,0,8808,-5238,7025,0,0,1787
2022,61,128350,千葉県,印西地区衛生組合,6,2,決算収支の状況,2,令和3年度,225788,219313,6475,0,6475,-2412,0,0,0,-2412
2022,61,128384,千葉県,東総衛生組合,6,2,決算収支の状況,2,令和3年度,574390,527761,46629,0,46629,-4930,2,0,0,-4928
2022,61,128414,千葉県,夷隅環境衛生組合,6,2,決算収支の状況,2,令和3年度,442389,398205,44184,0,44184,-108,28889,0,23169,5612
2022,61,128449,千葉県,佐倉市、四街道市、酒々井町葬祭組合,6,2,決算収支の状況,2,令和3年度,309473,280765,28708,0,28708,14002,7,0,6483,7526
2022,61,128465,千葉県,一宮聖苑組合,6,2,決算収支の状況,2,令和3年度,68893,65581,3312,0,3312,-2599,12498,0,0,9899
2022,61,128473,千葉県,印旛利根川水防事務組合,6,2,決算収支の状況,2,令和3年度,18697,16401,2296,0,2296,-191,1244,0,5815,-4762
2022,61,128503,千葉県,布施学校組合,6,2,決算収支の状況,2,令和3年度,39946,38525,1421,0,1421,-2310,0,0,0,-2310
2022,61,128538,千葉県,千葉県競馬組合,7,2,決算収支の状況,2,令和3年度,0,0,0,0,0,0,0,0,0,0
2022,61,128546,千葉県,匝瑳市ほか二町環境衛生組合,6,2,決算収支の状況,2,令和3年度,139419,90575,48844,0,48844,44515,7,0,0,44522
2022,61,128571,千葉県,君津郡市広域市町村圏事務組合,6,2,決算収支の状況,2,令和3年度,884840,827011,57829,0,57829,22176,0,0,0,22176
2022,61,128589,千葉県,千葉県市町村交通災害共済事業会計,7,2,決算収支の状況,2,令和3年度,0,0,0,0,0,0,0,0,0,0
2022,61,128601,千葉県,安房郡市広域市町村圏事務組合,6,2,決算収支の状況,2,令和3年度,3572142,3357140,215002,0,215002,-26674,0,0,0,-26674
2022,61,128619,千葉県,四市複合事務組合,6,2,決算収支の状況,2,令和3年度,1728126,1454576,273550,0,273550,115627,0,0,0,115627
2022,61,128635,千葉県,長生郡市広域市町村圏組合（普通会計分）,6,2,決算収支の状況,2,令和3年度,6720303,6493567,226736,25398,201338,12516,0,0,0,12516
2022,61,128651,千葉県,匝瑳市横芝光町消防組合,6,2,決算収支の状況,2,令和3年度,1104271,1050067,54204,32033,22171,3419,0,0,0,3419
2022,61,128660,千葉県,山武郡市広域行政組合,6,2,決算収支の状況,2,令和3年度,4943002,4721031,221971,34376,187595,-18421,0,0,99454,-117875
2022,61,128678,千葉県,香取広域市町村圏事務組合,6,2,決算収支の状況,2,令和3年度,4897352,4408538,488814,0,488814,24242,0,0,0,24242
2022,61,128686,千葉県,佐倉市八街市酒々井町消防組合,6,2,決算収支の状況,2,令和3年度,4767300,4724755,42545,2643,39902,-70267,4,0,55076,-125339
2022,61,128694,千葉県,東総地区広域市町村圏事務組合,6,2,決算収支の状況,2,令和3年度,2325472,2177586,147886,0,147886,47965,0,0,0,47965
2022,61,128708,千葉県,印西地区消防組合,6,2,決算収支の状況,2,令和3年度,3143463,3073671,69792,9348,60444,-17923,0,0,0,-17923
2022,61,128732,千葉県,夷隅郡市広域市町村圏事務組合,6,2,決算収支の状況,2,令和3年度,2091887,1994190,97697,0,97697,18880,0,0,0,18880
2022,61,128741,千葉県,印旛郡市広域市町村圏事務組合（普通会計分）,6,2,決算収支の状況,2,令和3年度,186120,180277,5843,0,5843,453,2696,0,30459,-27310
2022,61,128830,千葉県,印西地区環境整備事業組合（普通会計分）,6,2,決算収支の状況,2,令和3年度,3227809,3097992,129817,24778,105039,18532,0,0,0,18532
2022,61,128902,千葉県,千葉県後期高齢者医療広域連合,7,2,決算収支の状況,2,令和3年度,1034999,774447,260552,0,260552,-74349,167456,0,167595,-74488
2022,61,131016,東京都,千代田区,2,2,決算収支の状況,2,令和3年度,65665269,63455924,2209345,736400,1472945,-155602,1002371,0,529774,316995
2022,61,131024,東京都,中央区,2,2,決算収支の状況,2,令和3年度,132630965,129262005,3368960,1420016,1948944,238307,3570399,0,3950000,-141294
2022,61,131032,東京都,港区,2,2,決算収支の状況,2,令和3年度,193828631,180965170,12863461,1153763,11709698,503245,25410,0,6840805,-6312150
2022,61,131041,東京都,新宿区,2,2,決算収支の状況,2,令和3年度,173062972,166672922,6390050,38665,6351385,2882875,2101713,0,0,4984588
2022,61,131059,東京都,文京区,2,2,決算収支の状況,2,令和3年度,134394457,125897297,8497160,1756275,6740885,-1423273,5794863,0,4873753,-502163
2022,61,131067,東京都,台東区,2,2,決算収支の状況,2,令和3年度,125054197,114411332,10642865,296018,10346847,2558708,942526,0,0,3501234
2022,61,131075,東京都,墨田区,2,2,決算収支の状況,2,令和3年度,144318829,139456738,4862091,301758,4560333,-885842,2753640,0,2493065,-625267
2022,61,131083,東京都,江東区,2,2,決算収支の状況,2,令和3年度,234470059,223533762,10936297,5283,10931014,5289565,3468557,0,0,8758122
2022,61,131091,東京都,品川区,2,2,決算収支の状況,2,令和3年度,193464347,186459178,7005169,61363,6943806,3438321,5650180,0,0,9088501
2022,61,131105,東京都,目黒区,2,2,決算収支の状況,2,令和3年度,130994216,122181630,8812586,103635,8708951,-121325,4452013,0,383,4330305
2022,61,131113,東京都,大田区,2,2,決算収支の状況,2,令和3年度,309878731,299443837,10434894,742240,9692654,2475070,14063,0,0,2489133
2022,61,131121,東京都,世田谷区,2,2,決算収支の状況,2,令和3年度,377662345,357779394,19882951,2806013,17076938,4839088,717008,0,0,5556096
2022,61,131130,東京都,渋谷区,2,2,決算収支の状況,2,令和3年度,128300159,111888354,16411805,717250,15694555,8275289,6037368,0,1500000,12812657
2022,61,131148,東京都,中野区,2,2,決算収支の状況,2,令和3年度,160825435,154345770,6479665,382845,6096820,1728043,6088307,0,4777510,3038840
2022,61,131156,東京都,杉並区,2,2,決算収支の状況,2,令和3年度,249336644,235794002,13542642,346219,13196423,1550935,21072622,0,13355444,9268113
2022,61,131164,東京都,豊島区,2,2,決算収支の状況,2,令和3年度,148944141,143665897,5278244,2716555,2561689,-1300753,3188484,0,4300000,-2412269
2022,61,131172,東京都,北区,2,2,決算収支の状況,2,令和3年度,173803907,165089996,8713911,326242,8387669,1686993,23350,0,3000000,-1289657
2022,61,131181,東京都,荒川区,2,2,決算収支の状況,2,令和3年度,112983666,108027961,4955705,51433,4904272,2652857,581771,0,0,3234628
2022,61,131199,東京都,板橋区,2,2,決算収支の状況,2,令和3年度,260709561,247962929,12746632,196494,12550138,3606327,6828029,0,6957922,3476434
2022,61,131202,東京都,練馬区,2,2,決算収支の状況,2,令和3年度,315337828,304670606,10667222,439228,10227994,1532802,34279,0,3000000,-1432919
2022,61,131211,東京都,足立区,2,2,決算収支の状況,2,令和3年度,350933326,337980768,12952558,1624495,11328063,2796570,2400450,0,4622804,574216
2022,61,131229,東京都,葛飾区,2,2,決算収支の状況,2,令和3年度,238374839,221692274,16682565,47354,16635211,1914917,136053,0,983484,1067486
2022,61,131237,東京都,江戸川区,2,2,決算収支の状況,2,令和3年度,358590970,326853793,31737177,19703948,12033229,650002,11329268,0,12537797,-558527
2022,61,132012,東京都,八王子市,8,2,決算収支の状況,2,令和3年度,246004247,236201001,9803246,2285151,7518095,1366444,3958952,0,0,5325396
2022,61,132021,東京都,立川市,3,2,決算収支の状況,2,令和3年度,96590970,88883679,7707291,1202955,6504336,1168160,188,0,0,1168348
2022,61,132039,東京都,武蔵野市,3,2,決算収支の状況,2,令和3年度,80799412,76957203,3842209,26127,3816082,-458367,540829,0,500000,-417538
2022,61,132047,東京都,三鷹市,3,2,決算収支の状況,2,令和3年度,80516306,78311614,2204692,17177,2187515,-596675,716973,630000,0,750298
2022,61,132055,東京都,青梅市,3,2,決算収支の状況,2,令和3年度,62081371,58615463,3465908,593102,2872806,1288124,2100000,0,0,3388124
2022,61,132063,東京都,府中市,3,2,決算収支の状況,2,令和3年度,140931324,136428463,4502861,76478,4426383,593645,70081,0,329000,334726
2022,61,132071,東京都,昭島市,3,2,決算収支の状況,2,令和3年度,52893142,49581461,3311681,72130,3239551,1660254,2716809,0,0,4377063
2022,61,132080,東京都,調布市,3,2,決算収支の状況,2,令和3年度,108072221,100798818,7273403,567018,6706385,1391605,1702541,0,801929,2292217
2022,61,132098,東京都,町田市,3,2,決算収支の状況,2,令和3年度,200807500,191617973,9189527,1045389,8144138,3991294,2961171,0,2692093,4260372
2022,61,132101,東京都,小金井市,3,2,決算収支の状況,2,令和3年度,53583172,51719510,1863662,8894,1854768,32075,2480057,0,400000,2112132
2022,61,132110,東京都,小平市,3,2,決算収支の状況,2,令和3年度,83018617,76706681,6311936,0,6311936,3157859,1579065,0,0,4736924
2022,61,132128,東京都,日野市,3,2,決算収支の状況,2,令和3年度,83680637,78197025,5483612,285816,5197796,2234345,787642,0,112524,2909463
2022,61,132136,東京都,東村山市,3,2,決算収支の状況,2,令和3年度,70827132,67350236,3476896,169942,3306954,652703,0,770807,1083746,339764
2022,61,132144,東京都,国分寺市,3,2,決算収支の状況,2,令和3年度,59366470,56465640,2900830,512562,2388268,595996,1563359,0,1668973,490382
2022,61,132152,東京都,国立市,4,2,決算収支の状況,2,令和3年度,35253305,34182290,1071015,39765,1031250,419558,319677,0,0,739235
2022,61,132187,東京都,福生市,4,2,決算収支の状況,2,令和3年度,29802966,28293775,1509191,51439,1457752,853342,56729,0,0,910071
2022,61,132195,東京都,狛江市,4,2,決算収支の状況,2,令和3年度,35786216,33225209,2561007,253035,2307972,718350,387661,0,149208,956803
2022,61,132209,東京都,東大和市,4,2,決算収支の状況,2,令和3年度,39429145,36391028,3038117,125733,2912384,996032,958241,0,770856,1183417
2022,61,132217,東京都,清瀬市,4,2,決算収支の状況,2,令和3年度,38105882,35703524,2402358,282801,2119557,902488,625154,0,715549,812093
2022,61,132225,東京都,東久留米市,3,2,決算収支の状況,2,令和3年度,50470918,46871244,3599674,684377,2915297,1857201,580038,0,0,2437239
2022,61,132233,東京都,武蔵村山市,4,2,決算収支の状況,2,令和3年度,33521811,32205435,1316376,16557,1299819,226445,537000,0,7150,756295
2022,61,132241,東京都,多摩市,3,2,決算収支の状況,2,令和3年度,71642396,68528979,3113417,327222,2786195,739321,1031921,0,750000,1021242
2022,61,132250,東京都,稲城市,4,2,決算収支の状況,2,令和3年度,39607171,37238365,2368806,182759,2186047,1246689,176599,0,2627,1420661
2022,61,132276,東京都,羽村市,4,2,決算収支の状況,2,令和3年度,26794375,25279633,1514742,26319,1488423,416604,617927,0,5264,1029267
2022,61,132284,東京都,あきる野市,4,2,決算収支の状況,2,令和3年度,37757829,35920528,1837301,82668,1754633,1170621,156668,0,0,1327289
2022,61,132292,東京都,西東京市,3,2,決算収支の状況,2,令和3年度,85173925,80334621,4839304,1027575,3811729,1945900,1040867,0,500000,2486767
2022,61,133035,東京都,瑞穂町,5,2,決算収支の状況,2,令和3年度,17456169,16760875,695294,13501,681793,293152,716023,0,0,1009175
2022,61,133051,東京都,日の出町,5,2,決算収支の状況,2,令和3年度,10950050,10386127,563923,27622,536301,61414,496691,0,0,558105
2022,61,133078,東京都,檜原村,5,2,決算収支の状況,2,令和3年度,4107932,3887718,220214,73372,146842,11861,372,0,0,12233
2022,61,133086,東京都,奥多摩町,5,2,決算収支の状況,2,令和3年度,7529279,7128989,400290,0,400290,147824,142192,0,0,290016
2022,61,133612,東京都,大島町,5,2,決算収支の状況,2,令和3年度,9024248,8829208,195040,0,195040,-25234,405146,0,0,379912
2022,61,133621,東京都,利島村,5,2,決算収支の状況,2,令和3年度,1574540,1484830,89710,0,89710,-15443,40070,0,0,24627
2022,61,133639,東京都,新島村,5,2,決算収支の状況,2,令和3年度,4258663,3935651,323012,0,323012,159553,280126,0,0,439679
2022,61,133647,東京都,神津島村,5,2,決算収支の状況,2,令和3年度,3491185,3413681,77504,0,77504,506,184250,0,0,184756
2022,61,133817,東京都,三宅村,5,2,決算収支の状況,2,令和3年度,4750084,4553200,196884,0,196884,76105,57379,0,15855,117629
2022,61,133825,東京都,御蔵島村,5,2,決算収支の状況,2,令和3年度,1716850,1502770,214080,90109,123971,103187,216720,0,386714,-66807
2022,61,134015,東京都,八丈町,5,2,決算収支の状況,2,令和3年度,8846059,8602492,243567,88955,154612,-13386,0,0,0,-13386
2022,61,134023,東京都,青ヶ島村,5,2,決算収支の状況,2,令和3年度,1224002,993997,230005,191028,38977,-1043,25019,0,160000,-136024
2022,61,134210,東京都,小笠原村,5,2,決算収支の状況,2,令和3年度,6173747,5928723,245024,99,244925,-46747,0,311656,0,264909
2022,61,138011,東京都,特別区人事・厚生事務組合,6,2,決算収支の状況,2,令和3年度,7741322,7326729,414593,0,414593,-161826,299144,0,0,137318
2022,61,138029,東京都,特別区競馬組合,7,2,決算収支の状況,2,令和3年度,0,0,0,0,0,0,0,0,0,0
2022,61,138061,東京都,東京都島嶼町村一部事務組合,6,2,決算収支の状況,2,令和3年度,520577,515340,5237,0,5237,2761,811,0,50000,-46428
2022,61,138096,東京都,瑞穂斎場組合,6,2,決算収支の状況,2,令和3年度,467610,454755,12855,0,12855,-25195,0,0,0,-25195
2022,61,138151,東京都,ふじみ衛生組合,6,2,決算収支の状況,2,令和3年度,2203987,1850438,353549,0,353549,117652,0,0,0,117652
2022,61,138169,東京都,柳泉園組合,6,2,決算収支の状況,2,令和3年度,2726663,2367142,359521,0,359521,25397,0,0,0,25397
2022,61,138185,東京都,湖南衛生組合,6,2,決算収支の状況,2,令和3年度,131403,118664,12739,0,12739,5394,3673,0,2750,6317
2022,61,138207,東京都,西多摩衛生組合,6,2,決算収支の状況,2,令和3年度,2218308,1967842,250466,150750,99716,-3717,0,0,0,-3717
2022,61,138223,東京都,多摩川衛生組合,6,2,決算収支の状況,2,令和3年度,2170355,2043016,127339,0,127339,40878,6818,0,0,47696
2022,61,138231,東京都,小平・村山・大和衛生組合,6,2,決算収支の状況,2,令和3年度,3604795,3503116,101679,0,101679,-21962,139258,0,0,117296
2022,61,138258,東京都,東京都市町村職員退職手当組合,6,2,決算収支の状況,2,令和3年度,5106141,4706391,399750,0,399750,-185611,0,0,0,-185611
2022,61,138266,東京都,東京都十一市競輪事業組合,7,2,決算収支の状況,2,令和3年度,0,0,0,0,0,0,0,0,0,0
2022,61,138274,東京都,東京都六市競艇事業組合,7,2,決算収支の状況,2,令和3年度,0,0,0,0,0,0,0,0,0,0
2022,61,138282,東京都,東京都四市競艇事業組合,7,2,決算収支の状況,2,令和3年度,0,0,0,0,0,0,0,0,0,0
2022,61,138321,東京都,東京都市町村議会議員公務災害補償等組合,6,2,決算収支の状況,2,令和3年度,3947,2626,1321,0,1321,129,0,0,0,129
2022,61,138398,東京都,羽村・瑞穂地区学校給食組合,6,2,決算収支の状況,2,令和3年度,410316,348272,62044,0,62044,-9501,0,0,0,-9501
2022,61,138410,東京都,東京都三市収益事業組合,7,2,決算収支の状況,2,令和3年度,0,0,0,0,0,0,0,0,0,0
2022,61,138444,東京都,西秋川衛生組合,6,2,決算収支の状況,2,令和3年度,3307464,3277079,30385,0,30385,-9844,0,0,0,-9844
2022,61,138452,東京都,南多摩斎場組合,6,2,決算収支の状況,2,令和3年度,283814,266955,16859,0,16859,-1386,0,0,0,-1386
2022,61,138479,東京都,東京たま広域資源循環組合,6,2,決算収支の状況,2,令和3年度,9272338,8780272,492066,0,492066,36153,3596,0,0,39749
2022,61,138487,東京都,立川・昭島・国立聖苑組合,6,2,決算収支の状況,2,令和3年度,326801,293796,33005,0,33005,20944,38003,0,0,58947
2022,61,138495,東京都,東京市町村総合事務組合,6,2,決算収支の状況,2,令和3年度,977904,948402,29502,0,29502,9845,895,0,65373,-54633
2022,61,138517,東京都,多摩六都科学館組合,6,2,決算収支の状況,2,令和3年度,454355,443439,10916,0,10916,5426,2746,0,1200,6972
2022,61,138525,東京都,多摩ニュータウン環境組合,6,2,決算収支の状況,2,令和3年度,1657890,1571641,86249,0,86249,-50388,154306,0,79069,24849
2022,61,138533,東京都,秋川流域斎場組合,6,2,決算収支の状況,2,令和3年度,239537,214852,24685,0,24685,2764,0,0,0,2764
2022,61,138550,東京都,臨海部広域斎場組合,6,2,決算収支の状況,2,令和3年度,719537,587399,132138,0,132138,53812,0,0,0,53812
2022,61,138568,東京都,東京二十三区清掃一部事務組合,6,2,決算収支の状況,2,令和3年度,96530502,91788835,4741667,15200,4726467,-1647726,6124148,0,10217000,-5740578
2022,61,138584,東京都,東京都後期高齢者医療広域連合,7,2,決算収支の状況,2,令和3年度,3316649,3240497,76152,0,76152,-29045,1439002,0,522248,887709
2022,61,138592,東京都,稲城・府中墓苑組合,6,2,決算収支の状況,2,令和3年度,1038189,1016960,21229,0,21229,2731,13,0,0,2744
2022,61,138606,東京都,浅川清流環境組合,6,2,決算収支の状況,2,令和3年度,1378256,1271419,106837,0,106837,-74872,90855,0,0,15983
2022,61,141003,神奈川県,横浜市,1,2,決算収支の状況,2,令和3年度,2230290510,2202642428,27648082,13651510,13996572,7263752,22672603,0,5400000,24536355
2022,61,141305,神奈川県,川崎市,1,2,決算収支の状況,2,令和3年度,795373552,786995809,8377743,2160593,6217150,5676825,944187,6628,50099,6577541
2022,61,141500,神奈川県,相模原市,1,2,決算収支の状況,2,令和3年度,343241444,317528162,25713282,1102780,24610502,14521378,4405,0,0,14525783
2022,61,142018,神奈川県,横須賀市,8,2,決算収支の状況,2,令和3年度,183681978,174751661,8930317,543772,8386545,5204788,121,46635,35682,5215862
2022,61,142034,神奈川県,平塚市,9,2,決算収支の状況,2,令和3年度,106290831,101950925,4339906,1009475,3330431,256044,1050106,7500,47341,1266309
2022,61,142042,神奈川県,鎌倉市,3,2,決算収支の状況,2,令和3年度,69868970,64948417,4920553,359652,4560901,1335887,1303892,0,69365,2570414
2022,61,142051,神奈川県,藤沢市,3,2,決算収支の状況,2,令和3年度,184237255,177139296,7097959,304735,6793224,1831126,3930007,0,5200000,561133
2022,61,142069,神奈川県,小田原市,9,2,決算収支の状況,2,令和3年度,83995329,79076301,4919028,186781,4732247,1262995,1808439,0,1400000,1671434
2022,61,142077,神奈川県,茅ヶ崎市,9,2,決算収支の状況,2,令和3年度,91061220,83312389,7748831,599369,7149462,671687,3000180,6294,0,3678161
2022,61,142085,神奈川県,逗子市,4,2,決算収支の状況,2,令和3年度,26886087,24557577,2328510,4594,2323916,690322,996088,0,550000,1136410
2022,61,142107,神奈川県,三浦市,4,2,決算収支の状況,2,令和3年度,20117968,19119817,998151,101546,896605,559059,11,0,0,559070
2022,61,142115,神奈川県,秦野市,3,2,決算収支の状況,2,令和3年度,60427945,56559400,3868545,426349,3442196,1687011,885898,0,455400,2117509
2022,61,142123,神奈川県,厚木市,9,2,決算収支の状況,2,令和3年度,104596817,98719102,5877715,312880,5564835,763499,2662902,0,2637965,788436
2022,61,142131,神奈川県,大和市,9,2,決算収支の状況,2,令和3年度,93072959,88122184,4950775,70174,4880601,1413545,117,0,114000,1299662
2022,61,142140,神奈川県,伊勢原市,3,2,決算収支の状況,2,令和3年度,38593373,36101492,2491881,51584,2440297,1253885,583479,0,0,1837364
2022,61,142158,神奈川県,海老名市,3,2,決算収支の状況,2,令和3年度,57747388,54411936,3335452,570276,2765176,777010,742111,185295,536165,1168251
2022,61,142166,神奈川県,座間市,3,2,決算収支の状況,2,令和3年度,51589454,49147184,2442270,199383,2242887,454032,4104245,222904,2610777,2170404
2022,61,142174,神奈川県,南足柄市,4,2,決算収支の状況,2,令和3年度,20863843,19837941,1025902,21276,1004626,156019,1358100,0,460000,1054119
2022,61,142182,神奈川県,綾瀬市,4,2,決算収支の状況,2,令和3年度,36535457,33361368,3174089,175905,2998184,1868841,914941,0,0,2783782
2022,61,143014,神奈川県,葉山町,5,2,決算収支の状況,2,令和3年度,13003120,12044469,958651,8881,949770,336476,381016,0,155000,562492
2022,61,143219,神奈川県,寒川町,5,2,決算収支の状況,2,令和3年度,19626002,17369237,2256765,96181,2160584,1169948,773747,1150,649079,1295766
2022,61,143413,神奈川県,大磯町,5,2,決算収支の状況,2,令和3年度,13368498,12544810,823688,28097,795591,182705,774103,0,417264,539544
2022,61,143421,神奈川県,二宮町,5,2,決算収支の状況,2,令和3年度,10212219,9647498,564721,42263,522458,131087,350011,0,242000,239098
2022,61,143618,神奈川県,中井町,5,2,決算収支の状況,2,令和3年度,4645983,4263961,382022,21339,360683,139852,61156,0,0,201008
2022,61,143626,神奈川県,大井町,5,2,決算収支の状況,2,令和3年度,6813442,6335536,477906,2649,475257,19329,270212,0,0,289541
2022,61,143634,神奈川県,松田町,5,2,決算収支の状況,2,令和3年度,7143485,6617507,525978,20994,504984,133403,225040,0,0,358443
2022,61,143642,神奈川県,山北町,5,2,決算収支の状況,2,令和3年度,6939710,6570208,369502,8910,360592,-13144,254326,0,150000,91182
2022,61,143669,神奈川県,開成町,5,2,決算収支の状況,2,令和3年度,8330816,7722735,608081,78161,529920,58264,600033,0,0,658297
2022,61,143821,神奈川県,箱根町,5,2,決算収支の状況,2,令和3年度,11803427,11283867,519560,68115,451445,24762,804454,0,504976,324240
2022,61,143839,神奈川県,真鶴町,5,2,決算収支の状況,2,令和3年度,4416745,4073683,343062,3222,339840,185441,210000,0,135000,260441
2022,61,143847,神奈川県,湯河原町,5,2,決算収支の状況,2,令和3年度,10909668,10227804,681864,45874,635990,280511,405032,0,150000,535543
2022,61,144011,神奈川県,愛川町,5,2,決算収支の状況,2,令和3年度,15512843,14748921,763922,10234,753688,162499,283142,0,91114,354527
2022,61,144029,神奈川県,清川村,5,2,決算収支の状況,2,令和3年度,2691192,2553121,138071,21308,116763,26039,171427,0,0,197466
2022,61,148016,神奈川県,小田原市外二ヶ市町組合,6,2,決算収支の状況,2,令和3年度,91511,35196,56315,0,56315,-3861,1000,0,0,-2861
2022,61,148024,神奈川県,南足柄市外五ケ市町組合,6,2,決算収支の状況,2,令和3年度,33457,7672,25785,0,25785,-3084,0,0,0,-3084
2022,61,148041,神奈川県,南足柄市外二ケ市町組合,6,2,決算収支の状況,2,令和3年度,8778,4491,4287,0,4287,761,0,0,0,761
2022,61,148059,神奈川県,南足柄市外二ケ町組合,6,2,決算収支の状況,2,令和3年度,53868,6487,47381,0,47381,-855,0,0,0,-855
2022,61,148067,神奈川県,南足柄市・山北町・開成町一部事務組合,6,2,決算収支の状況,2,令和3年度,5906,969,4937,0,4937,925,0,0,0,925
2022,61,148075,神奈川県,松田町外三ヶ町組合,6,2,決算収支の状況,2,令和3年度,29189,1593,27596,0,27596,223,0,0,0,223
2022,61,148130,神奈川県,松田町外二ヶ町組合,6,2,決算収支の状況,2,令和3年度,14331,10806,3525,0,3525,-553,0,0,0,-553
2022,61,148148,神奈川県,金目川水害予防組合,6,2,決算収支の状況,2,令和3年度,5500,5099,401,0,401,-428,100,0,0,-328
2022,61,148156,神奈川県,秦野市伊勢原市環境衛生組合,6,2,決算収支の状況,2,令和3年度,2850531,2765878,84653,5825,78828,-13270,0,0,0,-13270
2022,61,148181,神奈川県,高座清掃施設組合,6,2,決算収支の状況,2,令和3年度,3511753,3016837,494916,39787,455129,198757,0,0,0,198757
2022,61,148199,神奈川県,足柄上衛生組合,6,2,決算収支の状況,2,令和3年度,168876,149590,19286,0,19286,-9912,0,0,0,-9912
2022,61,148202,神奈川県,神奈川県市町村職員退職手当組合,6,2,決算収支の状況,2,令和3年度,3318290,3212632,105658,0,105658,-37830,410336,0,0,372506
2022,61,148229,神奈川県,箱根町外二カ市組合,6,2,決算収支の状況,2,令和3年度,11406,8634,2772,0,2772,-2053,1000,0,0,-1053
2022,61,148237,神奈川県,南足柄市外四ケ市町組合,6,2,決算収支の状況,2,令和3年度,13449,1121,12328,0,12328,1329,0,0,0,1329
2022,61,148270,神奈川県,湯河原町真鶴町衛生組合,6,2,決算収支の状況,2,令和3年度,1091443,1038735,52708,0,52708,-20863,0,0,0,-20863
2022,61,148288,神奈川県,広域大和斎場組合,6,2,決算収支の状況,2,令和3年度,436107,382940,53167,405,52762,22447,0,0,0,22447
2022,61,148296,神奈川県,足柄東部清掃組合,6,2,決算収支の状況,2,令和3年度,401677,361199,40478,0,40478,7540,0,0,0,7540
2022,61,148377,神奈川県,足柄西部清掃組合,6,2,決算収支の状況,2,令和3年度,323422,304842,18580,0,18580,-4168,0,0,0,-4168
2022,61,148393,神奈川県,神奈川県川崎競馬組合,7,2,決算収支の状況,2,令和3年度,0,0,0,0,0,0,0,0,0,0
2022,61,148407,神奈川県,厚木愛甲環境施設組合,6,2,決算収支の状況,2,令和3年度,369757,346644,23113,19274,3839,1041,0,0,0,1041
2022,61,148415,神奈川県,神奈川県後期高齢者医療広域連合,7,2,決算収支の状況,2,令和3年度,1638916,1013430,625486,0,625486,70436,595362,0,0,665798
2022,61,148423,神奈川県,神奈川県町村情報システム共同事業組合,6,2,決算収支の状況,2,令和3年度,1038236,1006441,31795,0,31795,-28153,35000,0,0,6847
2022,61,151009,新潟県,新潟市,1,2,決算収支の状況,2,令和3年度,450147850,438857264,11290586,3724750,7565836,3995884,5751413,0,0,9747297
2022,61,152021,新潟県,長岡市,9,2,決算収支の状況,2,令和3年度,143583860,136745639,6838221,1094460,5743761,588796,2200986,0,0,2789782
2022,61,152048,新潟県,三条市,4,2,決算収支の状況,2,令和3年度,52035810,49668767,2367043,414968,1952075,1646521,1552002,474715,801472,2871766
2022,61,152056,新潟県,柏崎市,4,2,決算収支の状況,2,令和3年度,53235165,50224066,3011099,266602,2744497,740459,1376973,0,2049300,68132
2022,61,152064,新潟県,新発田市,4,2,決算収支の状況,2,令和3年度,52409603,49274238,3135365,576069,2559296,1042912,2015146,0,1581739,1476319
2022,61,152081,新潟県,小千谷市,4,2,決算収支の状況,2,令和3年度,20362183,18900596,1461587,148557,1313030,-2818,659083,0,0,656265
2022,61,152099,新潟県,加茂市,4,2,決算収支の状況,2,令和3年度,13699022,12659911,1039111,23007,1016104,470137,340354,298,0,810789
2022,61,152102,新潟県,十日町市,4,2,決算収支の状況,2,令和3年度,42011970,40573335,1438635,134405,1304230,-164474,3066,50,40000,-201358
2022,61,152111,新潟県,見附市,4,2,決算収支の状況,2,令和3年度,19147470,17966844,1180626,356902,823724,297960,263595,0,376321,185234
2022,61,152129,新潟県,村上市,4,2,決算収支の状況,2,令和3年度,38046509,36211024,1835485,82479,1753006,-74408,1047575,0,0,973167
2022,61,152137,新潟県,燕市,4,2,決算収支の状況,2,令和3年度,44016561,41863519,2153042,173737,1979305,609358,2657933,0,2026450,1240841
2022,61,152161,新潟県,糸魚川市,4,2,決算収支の状況,2,令和3年度,30035792,27825888,2209904,242148,1967756,604406,300400,4812,116983,792635
2022,61,152170,新潟県,妙高市,4,2,決算収支の状況,2,令和3年度,25062831,22683821,2379010,76267,2302743,-698119,2348,0,0,-695771
2022,61,152188,新潟県,五泉市,4,2,決算収支の状況,2,令和3年度,24196326,23183054,1013272,45249,968023,125458,764387,0,0,889845
2022,61,152226,新潟県,上越市,9,2,決算収支の状況,2,令和3年度,110213262,103971849,6241413,1456813,4784600,437308,2173822,853850,2323983,1140997
2022,61,152234,新潟県,阿賀野市,4,2,決算収支の状況,2,令和3年度,24647240,23279950,1367290,445663,921627,353041,400100,0,0,753141
2022,61,152242,新潟県,佐渡市,4,2,決算収支の状況,2,令和3年度,49999204,48010193,1989011,594064,1394947,169503,621985,0,438584,352904
2022,61,152251,新潟県,魚沼市,4,2,決算収支の状況,2,令和3年度,33956234,32717531,1238703,380367,858336,116017,386917,0,467268,35666
2022,61,152269,新潟県,南魚沼市,4,2,決算収支の状況,2,令和3年度,40440280,38785506,1654774,187637,1467137,170571,910763,0,346700,734634
2022,61,152277,新潟県,胎内市,4,2,決算収支の状況,2,令和3年度,20291016,18630688,1660328,125569,1534759,548566,564861,0,0,1113427
2022,61,153079,新潟県,聖籠町,5,2,決算収支の状況,2,令和3年度,9423474,8676416,747058,77337,669721,237178,100112,0,0,337290
2022,61,153427,新潟県,弥彦村,5,2,決算収支の状況,2,令和3年度,6001646,5266851,734795,64288,670507,471185,70100,0,0,541285
2022,61,153613,新潟県,田上町,5,2,決算収支の状況,2,令和3年度,5511979,5324182,187797,1177,186620,-84036,600018,0,0,515982
2022,61,153851,新潟県,阿賀町,5,2,決算収支の状況,2,令和3年度,13885677,12974579,911098,81159,829939,431662,263479,0,0,695141
2022,61,154059,新潟県,出雲崎町,5,2,決算収支の状況,2,令和3年度,3941092,3785775,155317,27109,128208,-2360,249747,0,0,247387
2022,61,154610,新潟県,湯沢町,5,2,決算収支の状況,2,令和3年度,9207266,8300352,906914,227486,679428,76169,125039,0,0,201208
2022,61,154822,新潟県,津南町,5,2,決算収支の状況,2,令和3年度,8319810,7737290,582520,98429,484091,174786,291056,0,0,465842
2022,61,155047,新潟県,刈羽村,5,2,決算収支の状況,2,令和3年度,7105500,6753060,352440,37380,315060,24060,795006,0,93779,725287
2022,61,155811,新潟県,関川村,5,2,決算収支の状況,2,令和3年度,5754670,5400674,353996,153949,200047,32010,50,0,0,32060
2022,61,155861,新潟県,粟島浦村,5,2,決算収支の状況,2,令和3年度,3215531,2864493,351038,16729,334309,160838,40000,0,0,200838
2022,61,158381,新潟県,津南地域衛生施設組合,6,2,決算収支の状況,2,令和3年度,318354,290817,27537,0,27537,-4298,22043,0,18445,-700
2022,61,158542,新潟県,さくら福祉保健事務組合,6,2,決算収支の状況,2,令和3年度,425768,370509,55259,0,55259,8822,0,0,0,8822
2022,61,158551,新潟県,寺泊老人ホーム組合,6,2,決算収支の状況,2,令和3年度,234212,232409,1803,0,1803,-7908,1,0,1000,-8907
2022,61,158607,新潟県,下越福祉行政組合,6,2,決算収支の状況,2,令和3年度,1553599,1431757,121842,0,121842,-76595,0,0,0,-76595
2022,61,158615,新潟県,魚沼地区障害福祉組合,6,2,決算収支の状況,2,令和3年度,413300,388640,24660,0,24660,-15847,2,0,0,-15845
2022,61,158623,新潟県,新潟県中越福祉事務組合,6,2,決算収支の状況,2,令和3年度,696098,634923,61175,0,61175,-4248,5500,0,0,1252
2022,61,158631,新潟県,西蒲原福祉事務組合,6,2,決算収支の状況,2,令和3年度,673518,621806,51712,0,51712,13393,1303,0,0,14696
2022,61,158640,新潟県,新潟県中東福祉事務組合,6,2,決算収支の状況,2,令和3年度,592846,533254,59592,0,59592,5985,20002,0,0,25987
2022,61,158895,新潟県,新潟県三条・燕総合グラウンド施設組合,6,2,決算収支の状況,2,令和3年度,55756,54212,1544,0,1544,-2500,0,0,0,-2500
2022,61,158909,新潟県,三条・燕・西蒲・南蒲広域養護老人ホーム施設組合,6,2,決算収支の状況,2,令和3年度,195697,193788,1909,0,1909,-2080,0,0,4796,-6876
2022,61,158933,新潟県,加茂市・田上町消防衛生保育組合,6,2,決算収支の状況,2,令和3年度,1222261,1170010,52251,4820,47431,35108,0,0,0,35108
2022,61,159000,新潟県,燕・弥彦総合事務組合,6,2,決算収支の状況,2,令和3年度,2884681,2882109,2572,0,2572,408,54629,0,3300,51737
2022,61,159069,新潟県,豊栄郷清掃施設処理組合,6,2,決算収支の状況,2,令和3年度,717476,674440,43036,0,43036,-46473,0,0,0,-46473
2022,61,159123,新潟県,新発田地域広域事務組合,6,2,決算収支の状況,2,令和3年度,4070438,3944263,126175,0,126175,-111958,0,0,0,-111958
2022,61,159166,新潟県,十日町地域広域事務組合,6,2,決算収支の状況,2,令和3年度,1813677,1776561,37116,0,37116,-18855,0,0,0,-18855
2022,61,159174,新潟県,上越地域消防事務組合,6,2,決算収支の状況,2,令和3年度,2806247,2792096,14151,0,14151,66,7052,0,0,7118
2022,61,159476,新潟県,五泉地域衛生施設組合,6,2,決算収支の状況,2,令和3年度,847208,789317,57891,0,57891,6665,0,0,0,6665
2022,61,159522,新潟県,上越広域伝染病院組合,6,2,決算収支の状況,2,令和3年度,23031,10253,12778,0,12778,27,6,0,0,33
2022,61,159573,新潟県,新潟県市町村総合事務組合（普通会計分）,6,2,決算収支の状況,2,令和3年度,8624434,8111077,513357,0,513357,-477645,0,0,0,-477645
2022,61,159581,新潟県,新潟県市町村総合事務組合（事業会計分）,7,2,決算収支の状況,2,令和3年度,0,0,0,0,0,0,0,0,0,0
2022,61,159590,新潟県,新潟県後期高齢者医療広域連合,7,2,決算収支の状況,2,令和3年度,339107,273341,65766,0,65766,6036,0,0,0,6036
2022,61,162019,富山県,富山市,8,2,決算収支の状況,2,令和3年度,198980660,193502159,5478501,2045622,3432879,827706,1000941,0,0,1828647
2022,61,162027,富山県,高岡市,3,2,決算収支の状況,2,令和3年度,76306352,74667063,1639289,602666,1036623,-1387438,400590,2040778,0,1053930
2022,61,162043,富山県,魚津市,4,2,決算収支の状況,2,令和3年度,21394778,19181550,2213228,308507,1904721,420024,200013,0,0,620037
2022,61,162051,富山県,氷見市,4,2,決算収支の状況,2,令和3年度,27202840,26536500,666340,58868,607472,-375555,492004,16426,66043,66832
2022,61,162060,富山県,滑川市,4,2,決算収支の状況,2,令和3年度,16621512,15290109,1331403,204720,1126683,96708,413899,255515,400000,366122
2022,61,162078,富山県,黒部市,4,2,決算収支の状況,2,令和3年度,26503147,25273857,1229290,315205,914085,283708,1473,0,0,285181
2022,61,162086,富山県,砺波市,4,2,決算収支の状況,2,令和3年度,25851315,23740200,2111115,191568,1919547,398601,70,550000,0,948671
2022,61,162094,富山県,小矢部市,4,2,決算収支の状況,2,令和3年度,16542461,15570213,972248,16512,955736,630653,217810,0,0,848463
2022,61,162108,富山県,南砺市,4,2,決算収支の状況,2,令和3年度,38887528,36711101,2176427,116099,2060328,618748,388802,0,322990,684560
2022,61,162116,富山県,射水市,4,2,決算収支の状況,2,令和3年度,47932687,45617480,2315207,523771,1791436,460784,15230,0,0,476014
2022,61,163210,富山県,舟橋村,5,2,決算収支の状況,2,令和3年度,2303382,2083511,219871,22610,197261,84932,100000,0,0,184932
2022,61,163228,富山県,上市町,5,2,決算収支の状況,2,令和3年度,11533496,11142316,391180,60222,330958,17365,49,0,0,17414
2022,61,163236,富山県,立山町,5,2,決算収支の状況,2,令和3年度,14866835,14183102,683733,111829,571904,-60876,200017,336676,0,475817
2022,61,163422,富山県,入善町,5,2,決算収支の状況,2,令和3年度,13999673,13515533,484140,29570,454570,-45276,40502,0,0,-4774
2022,61,163431,富山県,朝日町,5,2,決算収支の状況,2,令和3年度,9421372,9163155,258217,11718,246499,-105855,219768,0,230000,-116087
2022,61,168114,富山県,三郷利田用水市町村組合,6,2,決算収支の状況,2,令和3年度,3581,2805,776,0,776,38,0,0,0,38
2022,61,168157,富山県,黒東合口用水組合,6,2,決算収支の状況,2,令和3年度,7100,5812,1288,0,1288,-406,1553,0,0,1147
2022,61,168165,富山県,下山用水組合,6,2,決算収支の状況,2,令和3年度,6031,3226,2805,0,2805,270,0,0,0,270
2022,61,168424,富山県,砺波地方衛生施設組合,6,2,決算収支の状況,2,令和3年度,233626,231575,2051,0,2051,-1054,3400,0,24800,-22454
2022,61,168611,富山県,庄川水害予防組合,6,2,決算収支の状況,2,令和3年度,3364,133,3231,0,3231,737,0,0,0,737
2022,61,168645,富山県,小矢部川中流水害予防組合,6,2,決算収支の状況,2,令和3年度,114,100,14,0,14,4,0,0,0,4
2022,61,168661,富山県,常願寺川右岸水防市町村組合,6,2,決算収支の状況,2,令和3年度,925,296,629,0,629,-36,0,0,0,-36
2022,61,168726,富山県,富山県市町村総合事務組合,6,2,決算収支の状況,2,令和3年度,6028222,5566139,462083,0,462083,-248049,1074032,0,0,825983
2022,61,168912,富山県,砺波広域圏事務組合,6,2,決算収支の状況,2,令和3年度,3082228,2818320,263908,44316,219592,89991,0,0,0,89991
2022,61,168921,富山県,新川広域圏事務組合,6,2,決算収支の状況,2,令和3年度,1676317,1620384,55933,0,55933,2918,0,0,0,2918
2022,61,168971,富山県,富山地区広域圏事務組合,6,2,決算収支の状況,2,令和3年度,4230784,3577747,653037,56480,596557,-47304,10,0,0,-47294
2022,61,169005,富山県,高岡地区広域圏事務組合,6,2,決算収支の状況,2,令和3年度,1442687,1384756,57931,0,57931,13794,21474,0,71000,-35732
2022,61,169013,富山県,富山県市町村会館管理組合,6,2,決算収支の状況,2,令和3年度,239990,194912,45078,12100,32978,1192,38000,0,10000,29192
2022,61,169048,富山県,中新川広域行政事務組合,6,2,決算収支の状況,2,令和3年度,48640,44117,4523,0,4523,894,0,0,0,894
2022,61,169072,富山県,砺波地方介護保険組合,6,2,決算収支の状況,2,令和3年度,274771,258012,16759,0,16759,6074,1,0,5500,575
2022,61,169099,富山県,新川地域介護保険・ケーブルテレビ事業組合,6,2,決算収支の状況,2,令和3年度,2671965,2634379,37586,4180,33406,-29982,0,0,0,-29982
2022,61,169111,富山県,滑川中新川地区広域情報事務組合,6,2,決算収支の状況,2,令和3年度,2113654,2095802,17852,0,17852,-26142,25005,0,0,-1137
2022,61,169129,富山県,富山県後期高齢者医療広域連合,7,2,決算収支の状況,2,令和3年度,74525,67998,6527,0,6527,-2824,0,0,0,-2824
2022,61,169137,富山県,砺波地域消防組合,6,2,決算収支の状況,2,令和3年度,2244133,2136505,107628,0,107628,9239,0,0,0,9239
2022,61,169145,富山県,富山県東部消防組合,6,2,決算収支の状況,2,令和3年度,1339382,1229829,109553,48092,61461,7361,0,0,0,7361
2022,61,169153,富山県,新川地域消防組合,6,2,決算収支の状況,2,令和3年度,1376440,1335136,41304,0,41304,12673,0,0,0,12673
2022,61,172014,石川県,金沢市,8,2,決算収支の状況,2,令和3年度,221365357,212893035,8472322,3905403,4566919,1130273,555049,1176889,614628,2247583
2022,61,172022,石川県,七尾市,4,2,決算収支の状況,2,令和3年度,38276501,36696255,1580246,355791,1224455,336139,9008,0,1077292,-732145
2022,61,172031,石川県,小松市,3,2,決算収支の状況,2,令和3年度,55453635,54223034,1230601,581490,649111,18684,215,111500,300000,-169601
2022,61,172049,石川県,輪島市,4,2,決算収支の状況,2,令和3年度,25260718,24076650,1184068,132240,1051828,375394,1597,0,0,376991
2022,61,172057,石川県,珠洲市,4,2,決算収支の状況,2,令和3年度,13748199,13233045,515154,104321,410833,-31158,3828,0,0,-27330
2022,61,172065,石川県,加賀市,4,2,決算収支の状況,2,令和3年度,38582530,37244953,1337577,281477,1056100,263730,516,0,845000,-580754
2022,61,172073,石川県,羽咋市,4,2,決算収支の状況,2,令和3年度,14001156,13811940,189216,34269,154947,53839,170643,283173,0,507655
2022,61,172090,石川県,かほく市,4,2,決算収支の状況,2,令和3年度,19713430,19024290,689140,19172,669968,81536,38128,0,120000,-336
2022,61,172103,石川県,白山市,3,2,決算収支の状況,2,令和3年度,63764396,61589931,2174465,147853,2026612,512443,757319,0,0,1269762
2022,61,172111,石川県,能美市,4,2,決算収支の状況,2,令和3年度,25159808,24253715,906093,292345,613748,74080,5090,0,300000,-220830
2022,61,172120,石川県,野々市市,4,2,決算収支の状況,2,令和3年度,21796205,21088515,707690,198277,509413,199392,3643,0,59972,143063
2022,61,173240,石川県,川北町,5,2,決算収支の状況,2,令和3年度,4124208,4049446,74762,9269,65493,2279,294,0,80000,-77427
2022,61,173614,石川県,津幡町,5,2,決算収支の状況,2,令和3年度,17368237,16950053,418184,36654,381530,176364,594912,0,0,771276
2022,61,173657,石川県,内灘町,5,2,決算収支の状況,2,令和3年度,11262211,11108604,153607,13042,140565,64904,218177,0,0,283081
2022,61,173843,石川県,志賀町,5,2,決算収支の状況,2,令和3年度,15279491,14972312,307179,170930,136249,22073,299590,374346,0,696009
2022,61,173860,石川県,宝達志水町,5,2,決算収支の状況,2,令和3年度,9645163,8803704,841459,89281,752178,306011,100505,65142,0,471658
2022,61,174076,石川県,中能登町,5,2,決算収支の状況,2,令和3年度,11486833,10853884,632949,49046,583903,77819,3472,0,237083,-155792
2022,61,174611,石川県,穴水町,5,2,決算収支の状況,2,令和3年度,9201604,8766992,434612,66676,367936,160922,886,0,0,161808
2022,61,174637,石川県,能登町,5,2,決算収支の状況,2,令和3年度,16821985,16497739,324246,43444,280802,-159710,20678,1534972,73728,1322212
2022,61,178063,石川県,石川県市町村消防団員等公務災害補償等組合,6,2,決算収支の状況,2,令和3年度,148437,143914,4523,0,4523,506,0,0,0,506
2022,61,178128,石川県,手取川水防事務組合,6,2,決算収支の状況,2,令和3年度,1324,271,1053,0,1053,629,0,0,0,629
2022,61,178209,石川県,石川県市町村職員退職手当組合,6,2,決算収支の状況,2,令和3年度,3501794,2763016,738778,0,738778,218723,0,0,0,218723
2022,61,178217,石川県,河北郡市広域事務組合,6,2,決算収支の状況,2,令和3年度,5470139,5442639,27500,0,27500,-6261,4850,0,2643,-4054
2022,61,178250,石川県,手取川流域環境衛生事業組合,6,2,決算収支の状況,2,令和3年度,76545,66425,10120,0,10120,-3088,103,0,15000,-17985
2022,61,178268,石川県,輪島市・穴水町環境衛生施設組合,6,2,決算収支の状況,2,令和3年度,2314808,2307205,7603,0,7603,-2143,0,0,0,-2143
2022,61,178292,石川県,手取郷広域事務組合,6,2,決算収支の状況,2,令和3年度,117504,104737,12767,0,12767,-4951,6397,0,0,1446
2022,61,178306,石川県,石川県市町村消防賞じゆつ金組合,6,2,決算収支の状況,2,令和3年度,4077,685,3392,0,3392,894,0,0,0,894
2022,61,178331,石川県,石川県市町議会議員公務災害補償等組合,6,2,決算収支の状況,2,令和3年度,1319,820,499,0,499,86,0,0,0,86
2022,61,178373,石川県,羽咋郡市広域圏事務組合（普通会計分）,6,2,決算収支の状況,2,令和3年度,2301940,2300069,1871,0,1871,-2450,0,0,0,-2450
2022,61,178411,石川県,白山野々市広域事務組合,6,2,決算収支の状況,2,令和3年度,4473712,4299254,174458,0,174458,-54194,0,0,0,-54194
2022,61,178462,石川県,奥能登広域圏事務組合,6,2,決算収支の状況,2,令和3年度,2284353,2239703,44650,0,44650,-4235,0,0,0,-4235
2022,61,178489,石川県,南加賀広域圏事務組合（普通会計分）,6,2,決算収支の状況,2,令和3年度,685180,667893,17287,0,17287,-7881,0,0,0,-7881
2022,61,178519,石川県,のと鉄道運営助成基金事務組合,6,2,決算収支の状況,2,令和3年度,431619,431619,0,0,0,-2,0,0,0,-2
2022,61,178543,石川県,能美介護認定事務組合,6,2,決算収支の状況,2,令和3年度,21371,19095,2276,0,2276,955,0,0,0,955
2022,61,178551,石川県,奥能登クリーン組合,6,2,決算収支の状況,2,令和3年度,2362853,2328272,34581,0,34581,9908,0,0,0,9908
2022,61,178560,石川県,石川北部アール・ディ・エフ広域処理組合,6,2,決算収支の状況,2,令和3年度,1019776,978896,40880,0,40880,-36840,16940,0,18000,-37900
2022,61,178624,石川県,石川県後期高齢者医療広域連合,7,2,決算収支の状況,2,令和3年度,109789,88477,21312,0,21312,4520,12137,0,0,16657
2022,61,182010,福井県,福井市,8,2,決算収支の状況,2,令和3年度,125728159,121633662,4094497,529360,3565137,502903,1732030,0,0,2234933
2022,61,182028,福井県,敦賀市,4,2,決算収支の状況,2,令和3年度,47312447,44686519,2625928,249984,2375944,794930,36495,179400,0,1010825
2022,61,182044,福井県,小浜市,4,2,決算収支の状況,2,令和3年度,19863452,18981776,881676,107561,774115,182794,583759,0,335678,430875
2022,61,182052,福井県,大野市,4,2,決算収支の状況,2,令和3年度,20367389,19407678,959711,73697,886014,43880,422504,0,0,466384
2022,61,182061,福井県,勝山市,4,2,決算収支の状況,2,令和3年度,14397133,13931945,465188,28886,436302,137310,146985,0,0,284295
2022,61,182079,福井県,鯖江市,4,2,決算収支の状況,2,令和3年度,30360382,29162614,1197768,52467,1145301,128738,608000,0,232800,503938
2022,61,182087,福井県,あわら市,4,2,決算収支の状況,2,令和3年度,18846772,17604285,1242487,101241,1141246,488422,978016,0,326016,1140422
2022,61,182095,福井県,越前市,4,2,決算収支の状況,2,令和3年度,41698275,40532983,1165292,180166,985126,85710,1607103,0,1360495,332318
2022,61,182109,福井県,坂井市,4,2,決算収支の状況,2,令和3年度,49339357,47380415,1958942,337408,1621534,335749,444060,0,0,779809
2022,61,183229,福井県,永平寺町,5,2,決算収支の状況,2,令和3年度,10334458,9836153,498305,37633,460672,160978,493605,0,0,654583
2022,61,183822,福井県,池田町,5,2,決算収支の状況,2,令和3年度,4015994,3356343,659651,81212,578439,185924,11406,0,0,197330
2022,61,184047,福井県,南越前町,5,2,決算収支の状況,2,令和3年度,10350809,9885258,465551,95527,370024,-15510,2872,0,0,-12638
2022,61,184233,福井県,越前町,5,2,決算収支の状況,2,令和3年度,15030109,14316478,713631,99405,614226,4320,307775,0,121378,190717
2022,61,184420,福井県,美浜町,5,2,決算収支の状況,2,令和3年度,12454718,11200637,1254081,255399,998682,394169,0,0,0,394169
2022,61,184811,福井県,高浜町,5,2,決算収支の状況,2,令和3年度,13931538,13016118,915420,524575,390845,78454,222305,0,0,300759
2022,61,184837,福井県,おおい町,5,2,決算収支の状況,2,令和3年度,12109352,11142276,967076,541758,425318,9278,6388,0,0,15666
2022,61,185019,福井県,若狭町,5,2,決算収支の状況,2,令和3年度,13500520,12516665,983855,45754,938101,384224,275281,0,0,659505
2022,61,188026,福井県,越前三国競艇企業団,7,2,決算収支の状況,2,令和3年度,0,0,0,0,0,0,0,0,0,0
2022,61,188034,福井県,福井県市町総合事務組合（普通会計分）,6,2,決算収支の状況,2,令和3年度,4581413,3606032,975381,0,975381,89465,0,0,0,89465
2022,61,188182,福井県,福井県市町総合事務組合（事業会計分）,7,2,決算収支の状況,2,令和3年度,0,0,0,0,0,0,0,0,0,0
2022,61,188212,福井県,美浜・三方環境衛生組合,6,2,決算収支の状況,2,令和3年度,813673,678080,135593,0,135593,68778,0,0,0,68778
2022,61,188221,福井県,嶺北消防組合,6,2,決算収支の状況,2,令和3年度,2085918,2056039,29879,0,29879,10471,3,0,0,10474
2022,61,188239,福井県,鯖江・丹生消防組合,6,2,決算収支の状況,2,令和3年度,1500198,1410540,89658,0,89658,19334,0,0,0,19334
2022,61,188255,福井県,福井坂井地区広域市町村圏事務組合,6,2,決算収支の状況,2,令和3年度,2505489,2459175,46314,0,46314,-16339,0,0,0,-16339
2022,61,188271,福井県,南越消防組合,6,2,決算収支の状況,2,令和3年度,1880310,1819104,61206,0,61206,8633,0,0,0,8633
2022,61,188298,福井県,若狭消防組合,6,2,決算収支の状況,2,令和3年度,1459706,1419975,39731,0,39731,-3094,0,0,0,-3094
2022,61,188301,福井県,敦賀美方消防組合,6,2,決算収支の状況,2,令和3年度,2507276,2480761,26515,0,26515,5515,0,0,0,5515
2022,61,188336,福井県,大野・勝山地区広域行政事務組合,6,2,決算収支の状況,2,令和3年度,964467,940345,24122,0,24122,5872,0,0,0,5872
2022,61,188395,福井県,南越清掃組合,6,2,決算収支の状況,2,令和3年度,1798275,1755107,43168,11,43157,-24280,0,0,0,-24280
2022,61,188425,福井県,勝山・永平寺衛生管理組合,6,2,決算収支の状況,2,令和3年度,46489,45233,1256,0,1256,357,0,0,0,357
2022,61,188441,福井県,鯖江広域衛生施設組合,6,2,決算収支の状況,2,令和3年度,1454086,1428272,25814,0,25814,17569,340,0,54958,-37049
2022,61,188484,福井県,福井県丹南広域組合,6,2,決算収支の状況,2,令和3年度,830657,795414,35243,0,35243,-1560,0,0,0,-1560
2022,61,188506,福井県,福井県自治会館組合,6,2,決算収支の状況,2,令和3年度,114175,109560,4615,0,4615,-1836,6483,0,0,4647
2022,61,188514,福井県,嶺南広域行政組合,6,2,決算収支の状況,2,令和3年度,1927945,1926154,1791,0,1791,55,0,0,0,55
2022,61,188531,福井県,坂井地区広域連合,6,2,決算収支の状況,2,令和3年度,520438,492885,27553,0,27553,21756,0,0,0,21756
2022,61,188557,福井県,福井県後期高齢者医療広域連合,7,2,決算収支の状況,2,令和3年度,133824,100945,32879,0,32879,-860,0,0,0,-860
2022,61,188565,福井県,若狭広域行政事務組合,6,2,決算収支の状況,2,令和3年度,2681162,2440444,240718,134650,106068,-116972,0,0,0,-116972
2022,61,192015,山梨県,甲府市,8,2,決算収支の状況,2,令和3年度,88111485,84130075,3981410,324676,3656734,2159882,267,0,0,2160149
2022,61,192023,山梨県,富士吉田市,4,2,決算収支の状況,2,令和3年度,33756015,31808178,1947837,1020246,927591,258039,6383,0,0,264422
2022,61,192040,山梨県,都留市,4,2,決算収支の状況,2,令和3年度,19440570,18707544,733026,164840,568186,-60828,5670,0,350000,-405158
2022,61,192058,山梨県,山梨市,4,2,決算収支の状況,2,令和3年度,24750918,22937821,1813097,121645,1691452,1109115,220,0,0,1109335
2022,61,192066,山梨県,大月市,4,2,決算収支の状況,2,令和3年度,14462611,13936221,526390,37262,489128,103004,482316,0,0,585320
2022,61,192074,山梨県,韮崎市,4,2,決算収支の状況,2,令和3年度,16617561,16034297,583264,204659,378605,-77115,243384,0,269141,-102872
2022,61,192082,山梨県,南アルプス市,4,2,決算収支の状況,2,令和3年度,37333449,34362222,2971227,588064,2383163,191301,164307,590940,0,946548
2022,61,192091,山梨県,北杜市,4,2,決算収支の状況,2,令和3年度,32636743,31102970,1533773,70805,1462968,317665,1497,233400,114302,438260
2022,61,192104,山梨県,甲斐市,4,2,決算収支の状況,2,令和3年度,36498093,34012024,2486069,733538,1752531,305714,1750872,0,884264,1172322
2022,61,192112,山梨県,笛吹市,4,2,決算収支の状況,2,令和3年度,42157968,39644192,2513776,572445,1941331,-293159,427545,0,426649,-292263
2022,61,192121,山梨県,上野原市,4,2,決算収支の状況,2,令和3年度,12711072,11933585,777487,139494,637993,165329,877,0,111410,54796
2022,61,192139,山梨県,甲州市,4,2,決算収支の状況,2,令和3年度,21979986,20700251,1279735,76725,1203010,592032,7,0,0,592039
2022,61,192147,山梨県,中央市,4,2,決算収支の状況,2,令和3年度,17987289,16305281,1682008,388652,1293356,-74293,260621,0,0,186328
2022,61,193461,山梨県,市川三郷町,5,2,決算収支の状況,2,令和3年度,9843885,9541202,302683,93103,209580,-47407,124877,88,0,77558
2022,61,193640,山梨県,早川町,5,2,決算収支の状況,2,令和3年度,3783506,3426762,356744,18478,338266,57543,122,0,0,57665
2022,61,193658,山梨県,身延町,5,2,決算収支の状況,2,令和3年度,10583964,9561290,1022674,67349,955325,188904,578,0,72222,117260
2022,61,193666,山梨県,南部町,5,2,決算収支の状況,2,令和3年度,6578819,5772759,806060,46440,759620,180127,550,0,0,180677
2022,61,193682,山梨県,富士川町,5,2,決算収支の状況,2,令和3年度,9607185,9099209,507976,106359,401617,94411,16,62875,0,157302
2022,61,193844,山梨県,昭和町,5,2,決算収支の状況,2,令和3年度,10717725,10039585,678140,12300,665840,183445,613593,0,807423,-10385
2022,61,194221,山梨県,道志村,5,2,決算収支の状況,2,令和3年度,2544207,2420291,123916,39659,84257,-58972,1,0,0,-58971
2022,61,194239,山梨県,西桂町,5,2,決算収支の状況,2,令和3年度,3006798,2907858,98940,31820,67120,-2388,49690,0,30000,17302
2022,61,194247,山梨県,忍野村,5,2,決算収支の状況,2,令和3年度,6468969,5758889,710080,208879,501201,404818,27,0,690000,-285155
2022,61,194255,山梨県,山中湖村,5,2,決算収支の状況,2,令和3年度,5392267,4944783,447484,36004,411480,114632,221740,0,400000,-63628
2022,61,194298,山梨県,鳴沢村,5,2,決算収支の状況,2,令和3年度,2548529,2405566,142963,12520,130443,-68246,489,0,0,-67757
2022,61,194301,山梨県,富士河口湖町,5,2,決算収支の状況,2,令和3年度,15261785,13734218,1527567,4703,1522864,678350,510467,0,0,1188817
2022,61,194425,山梨県,小菅村,5,2,決算収支の状況,2,令和3年度,1695681,1374048,321633,66370,255263,64849,185,0,0,65034
2022,61,194433,山梨県,丹波山村,5,2,決算収支の状況,2,令和3年度,2094248,1948589,145659,81114,64545,11940,621,0,0,12561
2022,61,198013,山梨県,牛奥山恩賜県有財産保護組合,7,2,決算収支の状況,2,令和3年度,0,0,0,0,0,0,0,0,0,0
2022,61,198021,山梨県,滑沢山恩賜県有財産保護組合,7,2,決算収支の状況,2,令和3年度,0,0,0,0,0,0,0,0,0,0
2022,61,198056,山梨県,金峰前山恩賜県有財産保護組合,7,2,決算収支の状況,2,令和3年度,0,0,0,0,0,0,0,0,0,0
2022,61,198064,山梨県,大蔵沢恩賜県有財産保護組合,7,2,決算収支の状況,2,令和3年度,0,0,0,0,0,0,0,0,0,0
2022,61,198072,山梨県,深沢山恩賜県有財産保護組合,7,2,決算収支の状況,2,令和3年度,0,0,0,0,0,0,0,0,0,0
2022,61,198145,山梨県,京戸入会恩賜県有財産保護組合,7,2,決算収支の状況,2,令和3年度,0,0,0,0,0,0,0,0,0,0
2022,61,198218,山梨県,八町山恩賜県有財産保護組合,7,2,決算収支の状況,2,令和3年度,0,0,0,0,0,0,0,0,0,0
2022,61,198234,山梨県,奥仙重外二字山恩賜県有財産保護組合,7,2,決算収支の状況,2,令和3年度,0,0,0,0,0,0,0,0,0,0
2022,61,198251,山梨県,北奥仙丈外二山恩賜県有財産保護組合,7,2,決算収支の状況,2,令和3年度,0,0,0,0,0,0,0,0,0,0
2022,61,198277,山梨県,御勅使川入旧三十六ケ村入会山恩賜県有財産保護組合,6,2,決算収支の状況,2,令和3年度,1593,404,1189,0,1189,194,0,0,0,194
2022,61,198323,山梨県,御座石山恩賜県有財産保護組合,7,2,決算収支の状況,2,令和3年度,0,0,0,0,0,0,0,0,0,0
2022,61,198340,山梨県,老別当恩賜県有財産保護組合,7,2,決算収支の状況,2,令和3年度,0,0,0,0,0,0,0,0,0,0
2022,61,198358,山梨県,第一御座石前山恩賜県有財産保護組合,7,2,決算収支の状況,2,令和3年度,0,0,0,0,0,0,0,0,0,0
2022,61,198374,山梨県,牛ケ馬場恩賜県有財産保護組合,7,2,決算収支の状況,2,令和3年度,0,0,0,0,0,0,0,0,0,0
2022,61,198382,山梨県,大内窪外壱字恩賜県有財産保護組合,7,2,決算収支の状況,2,令和3年度,0,0,0,0,0,0,0,0,0,0
2022,61,198528,山梨県,釜無山外三字恩賜県有財産保護組合,7,2,決算収支の状況,2,令和3年度,0,0,0,0,0,0,0,0,0,0
2022,61,198544,山梨県,富士吉田市外二ケ村恩賜県有財産保護組合,6,2,決算収支の状況,2,令和3年度,2561938,2385221,176717,82961,93756,11484,638,0,0,12122
2022,61,198561,山梨県,鹿留山恩賜県有財産保護組合,7,2,決算収支の状況,2,令和3年度,0,0,0,0,0,0,0,0,0,0
2022,61,198579,山梨県,大旅外二恩賜県有財産保護組合,7,2,決算収支の状況,2,令和3年度,0,0,0,0,0,0,0,0,0,0
2022,61,198587,山梨県,鳴沢・富士河口湖恩賜県有財産保護組合,6,2,決算収支の状況,2,令和3年度,152794,84347,68447,0,68447,10831,2881,0,0,13712
2022,61,198595,山梨県,小金沢土室山恩賜県有財産保護組合,7,2,決算収支の状況,2,令和3年度,0,0,0,0,0,0,0,0,0,0
2022,61,198617,山梨県,野脇恩賜県有財産保護組合,7,2,決算収支の状況,2,令和3年度,0,0,0,0,0,0,0,0,0,0
2022,61,198714,山梨県,峡南衛生組合,6,2,決算収支の状況,2,令和3年度,487948,460446,27502,0,27502,-1543,30986,0,315,29128
2022,61,198838,山梨県,三郡衛生組合,6,2,決算収支の状況,2,令和3年度,709638,684741,24897,0,24897,-3415,98015,0,182678,-88078
2022,61,198960,山梨県,大月都留広域事務組合,6,2,決算収支の状況,2,令和3年度,1064009,1015866,48143,14300,33843,9061,103,0,0,9164
2022,61,198994,山梨県,河口湖南中学校組合,6,2,決算収支の状況,2,令和3年度,273371,272871,500,0,500,0,0,0,0,0
2022,61,199079,山梨県,青木ケ原衛生センター,6,2,決算収支の状況,2,令和3年度,63875,49819,14056,0,14056,-3775,0,0,0,-3775
2022,61,199176,山梨県,東山梨行政事務組合,6,2,決算収支の状況,2,令和3年度,1566349,1528720,37629,0,37629,9519,11038,0,8963,11594
2022,61,199214,山梨県,青木が原ごみ処理組合,6,2,決算収支の状況,2,令和3年度,40975,28021,12954,0,12954,208,216,0,0,424
2022,61,199222,山梨県,甲府地区広域行政事務組合,6,2,決算収支の状況,2,令和3年度,3558114,3477960,80154,0,80154,-6417,231,0,150000,-156186
2022,61,199249,山梨県,中巨摩地区広域事務組合,6,2,決算収支の状況,2,令和3年度,1757841,1686639,71202,0,71202,53,50366,0,2412,48007
2022,61,199257,山梨県,山梨県市町村総合事務組合（普通会計分）,6,2,決算収支の状況,2,令和3年度,5785175,5356380,428795,0,428795,107143,201818,0,26091,282870
2022,61,199265,山梨県,山梨県市町村総合事務組合（事業会計分）,7,2,決算収支の状況,2,令和3年度,0,0,0,0,0,0,0,0,0,0
2022,61,199303,山梨県,峡北広域行政事務組合,6,2,決算収支の状況,2,令和3年度,3864675,3698499,166176,69308,96868,-28636,118080,0,52449,36995
2022,61,199311,山梨県,東八代広域行政事務組合,6,2,決算収支の状況,2,令和3年度,157049,127443,29606,0,29606,3375,15000,0,0,18375
2022,61,199320,山梨県,峡南広域行政組合,6,2,決算収支の状況,2,令和3年度,1645229,1608379,36850,0,36850,-10810,26243,0,15515,-82
2022,61,199346,山梨県,釈迦堂遺跡博物館組合,6,2,決算収支の状況,2,令和3年度,46248,38186,8062,0,8062,180,0,0,0,180
2022,61,199362,山梨県,富士五湖広域行政事務組合,6,2,決算収支の状況,2,令和3年度,2388017,2385948,2069,0,2069,-55,6,0,4000,-4049
2022,61,199419,山梨県,山梨県後期高齢者医療広域連合,7,2,決算収支の状況,2,令和3年度,137161,99926,37235,0,37235,9483,27754,0,0,37237
2022,61,199427,山梨県,甲府・峡東地域ごみ処理施設事務組合,6,2,決算収支の状況,2,令和3年度,1842773,1790546,52227,0,52227,-1181,0,0,0,-1181
2022,61,199443,山梨県,山梨西部広域環境組合,6,2,決算収支の状況,2,令和3年度,225205,195560,29645,0,29645,-9784,39430,0,0,29646
2022,61,199451,山梨県,富士・東部広域環境事務組合,6,2,決算収支の状況,2,令和3年度,10408,7862,2546,0,2546,2546,0,0,0,2546
2022,61,202011,長野県,長野市,8,2,決算収支の状況,2,令和3年度,175991415,170095758,5895657,1864685,4030972,-413735,15082,0,0,-398653
2022,61,202029,長野県,松本市,8,2,決算収支の状況,2,令和3年度,114029247,110753869,3275378,734824,2540554,-35134,1253793,0,1059340,159319
2022,61,202037,長野県,上田市,3,2,決算収支の状況,2,令和3年度,80286444,77219580,3066864,674107,2392757,1019418,464610,0,0,1484028
2022,61,202045,長野県,岡谷市,4,2,決算収支の状況,2,令和3年度,23960544,22936882,1023662,198320,825342,144081,451400,0,0,595481
2022,61,202053,長野県,飯田市,4,2,決算収支の状況,2,令和3年度,54198650,52809337,1389313,438595,950718,169261,784726,0,0,953987
2022,61,202061,長野県,諏訪市,4,2,決算収支の状況,2,令和3年度,24177820,22675824,1501996,82399,1419597,612482,536258,0,552811,595929
2022,61,202070,長野県,須坂市,4,2,決算収支の状況,2,令和3年度,31550495,30436196,1114299,95042,1019257,97252,542365,0,500000,139617
2022,61,202088,長野県,小諸市,4,2,決算収支の状況,2,令和3年度,21871062,21059921,811141,127251,683890,-36064,503838,129020,0,596794
2022,61,202096,長野県,伊那市,4,2,決算収支の状況,2,令和3年度,45397563,44103333,1294230,369163,925067,-10276,413925,460727,0,864376
2022,61,202100,長野県,駒ケ根市,4,2,決算収支の状況,2,令和3年度,17067069,16703466,363603,31010,332593,-1133,371497,0,0,370364
2022,61,202118,長野県,中野市,4,2,決算収支の状況,2,令和3年度,24777918,23843181,934737,199769,734968,388993,173888,0,0,562881
2022,61,202126,長野県,大町市,4,2,決算収支の状況,2,令和3年度,18943497,17948451,995046,140970,854076,182313,0,0,50000,132313
2022,61,202134,長野県,飯山市,4,2,決算収支の状況,2,令和3年度,17359454,16571812,787642,30404,757238,-51567,200306,0,0,148739
2022,61,202142,長野県,茅野市,4,2,決算収支の状況,2,令和3年度,30035480,28357109,1678371,177433,1500938,622324,213673,0,0,835997
2022,61,202151,長野県,塩尻市,4,2,決算収支の状況,2,令和3年度,35327133,33868611,1458522,275236,1183286,84652,556021,0,0,640673
2022,61,202177,長野県,佐久市,4,2,決算収支の状況,2,令和3年度,61847219,58587429,3259790,1705903,1553887,535281,93607,653330,0,1282218
2022,61,202185,長野県,千曲市,4,2,決算収支の状況,2,令和3年度,30794432,29899066,895366,101673,793693,-557581,4543,0,0,-553038
2022,61,202193,長野県,東御市,4,2,決算収支の状況,2,令和3年度,18891074,17922803,968271,261708,706563,126179,414015,19649,0,559843
2022,61,202207,長野県,安曇野市,4,2,決算収支の状況,2,令和3年度,50024467,48829631,1194836,236800,958036,137912,731012,0,517329,351595
2022,61,203033,長野県,小海町,5,2,決算収支の状況,2,令和3年度,5086778,4472742,614036,94372,519664,142621,9216,0,128315,23522
2022,61,203041,長野県,川上村,5,2,決算収支の状況,2,令和3年度,5882239,5701336,180903,24573,156330,20418,477,82599,0,103494
2022,61,203050,長野県,南牧村,5,2,決算収支の状況,2,令和3年度,4667173,3617226,1049947,183527,866420,253742,266,110209,0,364217
2022,61,203068,長野県,南相木村,5,2,決算収支の状況,2,令和3年度,1951491,1932800,18691,17319,1372,-8401,8047,0,0,-354
2022,61,203076,長野県,北相木村,5,2,決算収支の状況,2,令和3年度,2039397,1794852,244545,29393,215152,153366,210972,0,0,364338
2022,61,203092,長野県,佐久穂町,5,2,決算収支の状況,2,令和3年度,10560113,9402536,1157577,318403,839174,520534,50607,0,240000,331141
2022,61,203211,長野県,軽井沢町,5,2,決算収支の状況,2,令和3年度,17792435,16236560,1555875,181935,1373940,216839,777076,0,330000,663915
2022,61,203238,長野県,御代田町,5,2,決算収支の状況,2,令和3年度,7865816,7351671,514145,36882,477263,223464,5940,112943,0,342347
2022,61,203246,長野県,立科町,5,2,決算収支の状況,2,令和3年度,6098174,5503583,594591,33337,561254,76198,1366,0,0,77564
2022,61,203491,長野県,青木村,5,2,決算収支の状況,2,令和3年度,3469874,3281225,188649,14237,174412,3166,72968,0,0,76134
2022,61,203505,長野県,長和町,5,2,決算収支の状況,2,令和3年度,6961501,6638688,322813,46353,276460,81811,3673,0,34150,51334
2022,61,203611,長野県,下諏訪町,5,2,決算収支の状況,2,令和3年度,9279767,8958506,321261,7725,313536,2146,5777,0,0,7923
2022,61,203629,長野県,富士見町,5,2,決算収支の状況,2,令和3年度,9639863,8664242,975621,37959,937662,358119,301988,0,0,660107
2022,61,203637,長野県,原村,5,2,決算収支の状況,2,令和3年度,5046788,4402098,644690,28864,615826,223915,102965,0,0,326880
2022,61,203823,長野県,辰野町,5,2,決算収支の状況,2,令和3年度,10788468,10147347,641121,200743,440378,91439,101031,0,0,192470
2022,61,203831,長野県,箕輪町,5,2,決算収支の状況,2,令和3年度,12953364,11766962,1186402,201953,984449,211157,40950,0,0,252107
2022,61,203840,長野県,飯島町,5,2,決算収支の状況,2,令和3年度,7118764,6840634,278130,121707,156423,21717,151210,63700,83000,153627
2022,61,203858,長野県,南箕輪村,5,2,決算収支の状況,2,令和3年度,8115683,7147959,967724,454387,513337,35977,111371,0,0,147348
2022,61,203866,長野県,中川村,5,2,決算収支の状況,2,令和3年度,4702653,4247186,455467,55107,400360,150274,500,119747,0,270521
2022,61,203882,長野県,宮田村,5,2,決算収支の状況,2,令和3年度,5489053,5116761,372292,27952,344340,-24569,102285,0,0,77716
2022,61,204021,長野県,松川町,5,2,決算収支の状況,2,令和3年度,8513254,7713274,799980,365240,434740,-15082,9468,0,17200,-22814
2022,61,204030,長野県,高森町,5,2,決算収支の状況,2,令和3年度,8336917,7543297,793620,28711,764909,80119,181195,0,125542,135772
2022,61,204048,長野県,阿南町,5,2,決算収支の状況,2,令和3年度,5635558,5316277,319281,223196,96085,66068,190390,0,0,256458
2022,61,204072,長野県,阿智村,5,2,決算収支の状況,2,令和3年度,6245501,5792101,453400,173782,279618,41827,130459,0,0,172286
2022,61,204099,長野県,平谷村,5,2,決算収支の状況,2,令和3年度,1127393,996953,130440,27990,102450,39112,64000,0,53700,49412
2022,61,204102,長野県,根羽村,5,2,決算収支の状況,2,令和3年度,2509245,2337329,171916,18544,153372,-1340,118,46186,0,44964
2022,61,204111,長野県,下條村,5,2,決算収支の状況,2,令和3年度,3635390,3117284,518106,70081,448025,5562,4182,150600,157000,3344
2022,61,204129,長野県,売木村,5,2,決算収支の状況,2,令和3年度,1325665,1277842,47823,19018,28805,2280,47800,0,0,50080
2022,61,204137,長野県,天龍村,5,2,決算収支の状況,2,令和3年度,3228285,3059739,168546,26624,141922,54353,132200,287593,0,474146
2022,61,204145,長野県,泰阜村,5,2,決算収支の状況,2,令和3年度,2704094,2453032,251062,50530,200532,35973,252711,33314,0,321998
2022,61,204153,長野県,喬木村,5,2,決算収支の状況,2,令和3年度,5265777,4826463,439314,210777,228537,8892,674,0,0,9566
2022,61,204161,長野県,豊丘村,5,2,決算収支の状況,2,令和3年度,6982376,5687161,1295215,221760,1073455,168943,302733,0,0,471676
2022,61,204170,長野県,大鹿村,5,2,決算収支の状況,2,令和3年度,2708110,2554456,153654,68258,85396,-21372,20307,0,0,-1065
2022,61,204226,長野県,上松町,5,2,決算収支の状況,2,令和3年度,4528392,4408566,119826,43132,76694,-16700,73028,0,0,56328
2022,61,204234,長野県,南木曽町,5,2,決算収支の状況,2,令和3年度,4554519,4364535,189984,35197,154787,26154,6,2000,0,28160
2022,61,204251,長野県,木祖村,5,2,決算収支の状況,2,令和3年度,3213888,2945080,268808,35099,233709,96850,810,0,0,97660
2022,61,204293,長野県,王滝村,5,2,決算収支の状況,2,令和3年度,2298806,2147172,151634,30431,121203,7049,219325,0,189125,37249
2022,61,204307,長野県,大桑村,5,2,決算収支の状況,2,令和3年度,5912763,5712603,200160,83436,116724,-18543,27,0,111000,-129516
2022,61,204323,長野県,木曽町,5,2,決算収支の状況,2,令和3年度,13343420,12648857,694563,263742,430821,57466,7495,0,400000,-335039
2022,61,204463,長野県,麻績村,5,2,決算収支の状況,2,令和3年度,3570330,3356669,213661,109886,103775,-2442,144000,55095,67000,129653
2022,61,204480,長野県,生坂村,5,2,決算収支の状況,2,令和3年度,2591213,2573160,18053,9186,8867,-20213,100289,86875,0,166951
2022,61,204501,長野県,山形村,5,2,決算収支の状況,2,令和3年度,4393479,4116933,276546,39927,236619,166564,35723,0,100000,102287
2022,61,204510,長野県,朝日村,5,2,決算収支の状況,2,令和3年度,3743120,3575220,167900,54276,113624,17368,406105,0,0,423473
2022,61,204528,長野県,筑北村,5,2,決算収支の状況,2,令和3年度,5092488,4838108,254380,30358,224022,39497,279573,187598,0,506668
2022,61,204811,長野県,池田町,5,2,決算収支の状況,2,令和3年度,5498869,5415377,83492,25573,57919,11004,92,0,0,11096
2022,61,204820,長野県,松川村,5,2,決算収支の状況,2,令和3年度,4885395,4791983,93412,86279,7133,-7599,243,0,0,-7356
2022,61,204854,長野県,白馬村,5,2,決算収支の状況,2,令和3年度,7006657,6848676,157981,18240,139741,43844,130543,0,0,174387
2022,61,204862,長野県,小谷村,5,2,決算収支の状況,2,令和3年度,5121328,4967037,154291,57703,96588,23898,201,0,0,24099
2022,61,205214,長野県,坂城町,5,2,決算収支の状況,2,令和3年度,8208729,8122568,86161,19460,66701,18596,6549,0,0,25145
2022,61,205419,長野県,小布施町,5,2,決算収支の状況,2,令和3年度,7268182,6390597,877585,172469,705116,106753,410264,0,144000,373017
2022,61,205435,長野県,高山村,5,2,決算収支の状況,2,令和3年度,4648065,4340206,307859,31951,275908,35150,59,0,20760,14449
2022,61,205613,長野県,山ノ内町,5,2,決算収支の状況,2,令和3年度,8530488,8199788,330700,20774,309926,7973,190569,0,0,198542
2022,61,205621,長野県,木島平村,5,2,決算収支の状況,2,令和3年度,4322920,4093154,229766,39466,190300,59006,279846,0,195000,143852
2022,61,205630,長野県,野沢温泉村,5,2,決算収支の状況,2,令和3年度,4028641,3858777,169864,7795,162069,31298,194937,0,0,226235
2022,61,205834,長野県,信濃町,5,2,決算収支の状況,2,令和3年度,6259942,6137738,122204,3009,119195,1866,46000,0,0,47866
2022,61,205885,長野県,小川村,5,2,決算収支の状況,2,令和3年度,3255085,2831373,423712,13175,410537,219184,8222,96792,0,324198
2022,61,205907,長野県,飯綱町,5,2,決算収支の状況,2,令和3年度,9424335,8600497,823838,75934,747904,-9319,1539,204806,223589,-26563
2022,61,206024,長野県,栄村,5,2,決算収支の状況,2,令和3年度,3372111,3023235,348876,21589,327287,151214,229735,0,0,380949
2022,61,208108,長野県,北佐久郡老人福祉施設組合,6,2,決算収支の状況,2,令和3年度,331669,292409,39260,0,39260,7862,12122,0,0,19984
2022,61,208116,長野県,森泉山財産組合,7,2,決算収支の状況,2,令和3年度,0,0,0,0,0,0,0,0,0,0
2022,61,208132,長野県,川西保健衛生施設組合,6,2,決算収支の状況,2,令和3年度,431837,352851,78986,0,78986,-917,0,0,0,-917
2022,61,208175,長野県,上田市東御市真田共有財産組合,7,2,決算収支の状況,2,令和3年度,0,0,0,0,0,0,0,0,0,0
2022,61,208183,長野県,上田市長和町中学校組合,6,2,決算収支の状況,2,令和3年度,122886,121048,1838,0,1838,-103,0,0,0,-103
2022,61,208191,長野県,青木村及び上田市共有財産組合,7,2,決算収支の状況,2,令和3年度,0,0,0,0,0,0,0,0,0,0
2022,61,208213,長野県,葛尾組合,6,2,決算収支の状況,2,令和3年度,534413,482761,51652,0,51652,-20868,0,0,0,-20868
2022,61,208302,長野県,浅麓環境施設組合,6,2,決算収支の状況,2,令和3年度,727415,684774,42641,0,42641,-18335,0,0,0,-18335
2022,61,208311,長野県,千曲衛生施設組合,6,2,決算収支の状況,2,令和3年度,217605,193295,24310,0,24310,11673,11375,0,10000,13048
2022,61,208329,長野県,松本広域連合,6,2,決算収支の状況,2,令和3年度,4905148,4509275,395873,0,395873,47489,0,0,0,47489
2022,61,208388,長野県,佐久平環境衛生組合,6,2,決算収支の状況,2,令和3年度,320816,293804,27012,0,27012,9068,0,0,0,9068
2022,61,208434,長野県,南信地域町村交通災害共済事務組合,7,2,決算収支の状況,2,令和3年度,0,0,0,0,0,0,0,0,0,0
2022,61,208451,長野県,佐久市・北佐久郡環境施設組合,6,2,決算収支の状況,2,令和3年度,703851,619904,83947,0,83947,-14009,0,44695,0,30686
2022,61,208469,長野県,辰野町塩尻市小学校組合,6,2,決算収支の状況,2,令和3年度,100087,83534,16553,460,16093,-7149,0,0,0,-7149
2022,61,208485,長野県,長野広域連合,6,2,決算収支の状況,2,令和3年度,9874327,8463824,1410503,229285,1181218,-272232,9224,0,0,-263008
2022,61,208493,長野県,湖周行政事務組合,6,2,決算収支の状況,2,令和3年度,906534,906534,0,0,0,0,0,0,0,0
2022,61,208531,長野県,安曇野・松本行政事務組合,6,2,決算収支の状況,2,令和3年度,25415,22045,3370,0,3370,-1076,0,0,0,-1076
2022,61,208566,長野県,安曇野市・松本市山林組合,6,2,決算収支の状況,2,令和3年度,11969,10063,1906,0,1906,-781,0,0,0,-781
2022,61,208574,長野県,中信地域町村交通災害共済事務組合,7,2,決算収支の状況,2,令和3年度,0,0,0,0,0,0,0,0,0,0
2022,61,208604,長野県,穂高広域施設組合,6,2,決算収支の状況,2,令和3年度,1148388,1096741,51647,0,51647,5251,2,0,0,5253
2022,61,208647,長野県,池田松川施設組合,6,2,決算収支の状況,2,令和3年度,168306,168087,219,0,219,-361,0,0,0,-361
2022,61,208701,長野県,松塩安筑老人福祉施設組合,6,2,決算収支の状況,2,令和3年度,382903,370804,12099,0,12099,-8862,137,0,0,-8725
2022,61,208736,長野県,松本市・山形村・朝日村中学校組合,6,2,決算収支の状況,2,令和3年度,191309,178834,12475,0,12475,3967,0,0,0,3967
2022,61,208752,長野県,湖北行政事務組合（普通会計分）,6,2,決算収支の状況,2,令和3年度,202689,202689,0,0,0,0,0,0,0,0
2022,61,208787,長野県,諏訪市・茅野市衛生施設組合,6,2,決算収支の状況,2,令和3年度,99085,91032,8053,0,8053,44,0,0,0,44
2022,61,208809,長野県,伊那中央行政組合（普通会計分）,6,2,決算収支の状況,2,令和3年度,1895910,1870651,25259,0,25259,5892,0,0,0,5892
2022,61,208825,長野県,伊南行政組合,6,2,決算収支の状況,2,令和3年度,265468,229191,36277,0,36277,5197,0,0,0,5197
2022,61,208884,長野県,塩尻市辰野町中学校組合,6,2,決算収支の状況,2,令和3年度,132801,113217,19584,450,19134,5696,0,0,0,5696
2022,61,208931,長野県,北アルプス広域連合,6,2,決算収支の状況,2,令和3年度,2448566,2340514,108052,0,108052,32027,4989,0,0,37016
2022,61,208949,長野県,佐久広域連合,6,2,決算収支の状況,2,令和3年度,3294920,3289642,5278,0,5278,415,96371,0,129407,-32621
2022,61,208973,長野県,下伊那郡町村総合事務組合,6,2,決算収支の状況,2,令和3年度,10995,10570,425,0,425,51,0,0,0,51
2022,61,209058,長野県,佐久市・軽井沢町清掃施設組合,6,2,決算収支の状況,2,令和3年度,110112,86376,23736,0,23736,-28030,0,0,0,-28030
2022,61,209066,長野県,南佐久環境衛生組合,6,2,決算収支の状況,2,令和3年度,112736,105629,7107,0,7107,3245,0,0,0,3245
2022,61,209112,長野県,六ケ郷用水組合,6,2,決算収支の状況,2,令和3年度,25644,22649,2995,0,2995,-40,3,0,0,-37
2022,61,209121,長野県,高山村外一市一町財産組合,7,2,決算収支の状況,2,令和3年度,0,0,0,0,0,0,0,0,0,0
2022,61,209147,長野県,下伊那北部総合事務組合,6,2,決算収支の状況,2,令和3年度,80204,74050,6154,0,6154,722,0,0,0,722
2022,61,209171,長野県,東北信市町村交通災害共済事務組合,7,2,決算収支の状況,2,令和3年度,0,0,0,0,0,0,0,0,0,0
2022,61,209201,長野県,北部衛生施設組合,6,2,決算収支の状況,2,令和3年度,89478,82512,6966,0,6966,-7036,0,0,0,-7036
2022,61,209210,長野県,長水部分林組合,6,2,決算収支の状況,2,令和3年度,75,0,75,75,0,0,0,0,0,0
2022,61,209244,長野県,岳南広域消防組合,6,2,決算収支の状況,2,令和3年度,1118706,1084863,33843,0,33843,-5527,0,0,0,-5527
2022,61,209252,長野県,長野県市町村自治振興組合,6,2,決算収支の状況,2,令和3年度,1446514,1407291,39223,0,39223,6166,0,0,0,6166
2022,61,209279,長野県,木曽広域連合,6,2,決算収支の状況,2,令和3年度,4381184,4210535,170649,101663,68986,-191,0,0,0,-191
2022,61,209287,長野県,南信州広域連合,6,2,決算収支の状況,2,令和3年度,3943583,3788665,154918,1529,153389,-437,70043,0,5610,63996
2022,61,209295,長野県,長野県地方税滞納整理機構,6,2,決算収支の状況,2,令和3年度,191629,184488,7141,0,7141,-2044,4594,0,0,2550
2022,61,209317,長野県,依田窪医療福祉事務組合,6,2,決算収支の状況,2,令和3年度,27144,26438,706,0,706,-511,0,0,0,-511
2022,61,209333,長野県,上伊那広域連合,6,2,決算収支の状況,2,令和3年度,4938953,4779440,159513,50169,109344,-11715,0,0,0,-11715
2022,61,209368,長野県,須高行政事務組合,6,2,決算収支の状況,2,令和3年度,221173,212176,8997,0,8997,-1492,0,0,0,-1492
2022,61,209392,長野県,下伊那郡土木技術センター組合,6,2,決算収支の状況,2,令和3年度,212106,205113,6993,0,6993,-11905,10000,0,0,-1905
2022,61,209406,長野県,上田地域広域連合,6,2,決算収支の状況,2,令和3年度,4868475,4615551,252924,11054,241870,-23594,0,0,0,-23594
2022,61,209422,長野県,岳北広域行政組合,6,2,決算収支の状況,2,令和3年度,1374311,1332162,42149,0,42149,-821,0,0,0,-821
2022,61,209431,長野県,小海町北相木村南相木村中学校組合,6,2,決算収支の状況,2,令和3年度,192269,177576,14693,9240,5453,3152,0,0,0,3152
2022,61,209449,長野県,長野県市町村総合事務組合,6,2,決算収支の状況,2,令和3年度,6527722,5588517,939205,0,939205,388618,0,0,0,388618
2022,61,209457,長野県,長野県民交通災害共済組合,7,2,決算収支の状況,2,令和3年度,0,0,0,0,0,0,0,0,0,0
2022,61,209490,長野県,北信保健衛生施設組合,6,2,決算収支の状況,2,令和3年度,841151,815187,25964,0,25964,-1396,0,0,0,-1396
2022,61,209546,長野県,千曲坂城消防組合,6,2,決算収支の状況,2,令和3年度,1227125,1174228,52897,0,52897,-5795,16,0,70828,-76607
2022,61,209554,長野県,諏訪広域公立大学事務組合,6,2,決算収支の状況,2,令和3年度,2184835,2180374,4461,0,4461,-96242,0,0,0,-96242
2022,61,209601,長野県,松塩地区広域施設組合,6,2,決算収支の状況,2,令和3年度,2764628,2675744,88884,0,88884,-3436,0,0,0,-3436
2022,61,209651,長野県,南諏衛生施設組合,6,2,決算収支の状況,2,令和3年度,218286,165749,52537,0,52537,23320,0,0,0,23320
2022,61,209716,長野県,下伊那郡西部衛生施設組合,6,2,決算収支の状況,2,令和3年度,84034,70893,13141,0,13141,2357,0,0,0,2357
2022,61,209791,長野県,長野県後期高齢者医療広域連合,7,2,決算収支の状況,2,令和3年度,347250,293642,53608,0,53608,-8997,0,0,0,-8997
2022,61,209805,長野県,北信広域連合,6,2,決算収支の状況,2,令和3年度,331784,317710,14074,0,14074,-4980,15892,0,0,10912
2022,61,209813,長野県,諏訪広域連合,6,2,決算収支の状況,2,令和3年度,3392956,3156798,236158,0,236158,16974,15558,0,19528,13004
2022,61,209881,長野県,白馬山麓事務組合,6,2,決算収支の状況,2,令和3年度,358216,347835,10381,0,10381,5264,0,0,0,5264
2022,61,209902,長野県,諏訪南行政事務組合,6,2,決算収支の状況,2,令和3年度,2790159,2581847,208312,0,208312,-133869,0,0,0,-133869
2022,61,209911,長野県,下伊那自治センター組合,6,2,決算収支の状況,2,令和3年度,2275,2129,146,0,146,-26,0,0,0,-26
2022,61,209953,長野県,白樺湖下水道組合,6,2,決算収支の状況,2,令和3年度,26718,20389,6329,0,6329,-2335,0,0,0,-2335
2022,61,209970,長野県,下伊那南部総合事務組合,6,2,決算収支の状況,2,令和3年度,143167,136511,6656,0,6656,-3121,21293,0,0,18172
2022,61,209996,長野県,安曇野松筑広域環境施設組合,6,2,決算収支の状況,2,令和3年度,120428,116886,3542,0,3542,-1459,1547,0,0,88
2022,61,212016,岐阜県,岐阜市,8,2,決算収支の状況,2,令和3年度,202888103,193507023,9381080,499693,8881387,1208003,2001207,0,0,3209210
2022,61,212024,岐阜県,大垣市,3,2,決算収支の状況,2,令和3年度,70103502,65001547,5101955,348910,4753045,2531392,1007600,0,0,3538992
2022,61,212032,岐阜県,高山市,4,2,決算収支の状況,2,令和3年度,59386113,54112798,5273315,2468415,2804900,1230274,49484,0,1300000,-20242
2022,61,212041,岐阜県,多治見市,3,2,決算収支の状況,2,令和3年度,49954798,44450340,5504458,400233,5104225,1312263,580182,0,1682100,210345
2022,61,212059,岐阜県,関市,4,2,決算収支の状況,2,令和3年度,49978750,45187160,4791590,377920,4413670,-76230,2466970,0,0,2390740
2022,61,212067,岐阜県,中津川市,4,2,決算収支の状況,2,令和3年度,50622440,44148884,6473556,954078,5519478,973345,502484,0,2066402,-590573
2022,61,212075,岐阜県,美濃市,4,2,決算収支の状況,2,令和3年度,11640601,10641335,999266,375401,623865,264276,6540,0,0,270816
2022,61,212083,岐阜県,瑞浪市,4,2,決算収支の状況,2,令和3年度,18794702,17328756,1465946,738936,727010,208954,15308,20062,8200,236124
2022,61,212091,岐阜県,羽島市,4,2,決算収支の状況,2,令和3年度,29162283,27765276,1397007,120839,1276168,659868,526228,0,600000,586096
2022,61,212105,岐阜県,恵那市,4,2,決算収支の状況,2,令和3年度,32902752,29839454,3063298,610025,2453273,1002386,18596,399731,0,1420713
2022,61,212113,岐阜県,美濃加茂市,4,2,決算収支の状況,2,令和3年度,28934616,26646005,2288611,160597,2128014,851108,113894,0,0,965002
2022,61,212121,岐阜県,土岐市,4,2,決算収支の状況,2,令和3年度,25924970,24637992,1286978,281996,1004982,259621,267861,0,0,527482
2022,61,212130,岐阜県,各務原市,3,2,決算収支の状況,2,令和3年度,66224068,61390436,4833632,221457,4612175,901292,883439,0,0,1784731
2022,61,212148,岐阜県,可児市,4,2,決算収支の状況,2,令和3年度,37449265,34704966,2744299,370243,2374056,859754,469442,0,0,1329196
2022,61,212156,岐阜県,山県市,4,2,決算収支の状況,2,令和3年度,15458988,14662844,796144,39332,756812,643400,436,0,0,643836
2022,61,212164,岐阜県,瑞穂市,4,2,決算収支の状況,2,令和3年度,22810733,21368631,1442102,473849,968253,218923,376018,168080,383000,380021
2022,61,212172,岐阜県,飛騨市,4,2,決算収支の状況,2,令和3年度,23663314,21733763,1929551,384388,1545163,203683,619639,0,796700,26622
2022,61,212181,岐阜県,本巣市,4,2,決算収支の状況,2,令和3年度,20754338,19478389,1275949,125012,1150937,390272,596000,0,0,986272
2022,61,212199,岐阜県,郡上市,4,2,決算収支の状況,2,令和3年度,30560690,28945016,1615674,286630,1329044,92177,305930,0,0,398107
2022,61,212202,岐阜県,下呂市,4,2,決算収支の状況,2,令和3年度,29436582,27643606,1792976,513234,1279742,34508,880188,0,566000,348696
2022,61,212211,岐阜県,海津市,4,2,決算収支の状況,2,令和3年度,17458636,16262968,1195668,187128,1008540,83424,982656,0,0,1066080
2022,61,213021,岐阜県,岐南町,5,2,決算収支の状況,2,令和3年度,10135643,9207944,927699,49592,878107,396807,284108,0,0,680915
2022,61,213039,岐阜県,笠松町,5,2,決算収支の状況,2,令和3年度,8820245,8161662,658583,5482,653101,232423,98903,0,19244,312082
2022,61,213411,岐阜県,養老町,5,2,決算収支の状況,2,令和3年度,13999811,12811628,1188183,32383,1155800,430635,476,0,0,431111
2022,61,213616,岐阜県,垂井町,5,2,決算収支の状況,2,令和3年度,11045474,10412309,633165,14588,618577,79216,448064,0,0,527280
2022,61,213624,岐阜県,関ケ原町,5,2,決算収支の状況,2,令和3年度,4645157,4258046,387111,5787,381324,136525,110063,0,0,246588
2022,61,213811,岐阜県,神戸町,5,2,決算収支の状況,2,令和3年度,7957214,7322766,634448,46100,588348,118823,538778,0,0,657601
2022,61,213829,岐阜県,輪之内町,5,2,決算収支の状況,2,令和3年度,4873283,4638232,235051,3617,231434,106721,71263,0,0,177984
2022,61,213837,岐阜県,安八町,5,2,決算収支の状況,2,令和3年度,7414121,6853334,560787,103418,457369,66458,97748,0,259838,-95632
2022,61,214019,岐阜県,揖斐川町,5,2,決算収支の状況,2,令和3年度,15509725,14528174,981551,43538,938013,367847,277735,0,0,645582
2022,61,214035,岐阜県,大野町,5,2,決算収支の状況,2,令和3年度,9443131,8999236,443895,26573,417322,81638,148306,0,0,229944
2022,61,214043,岐阜県,池田町,5,2,決算収支の状況,2,令和3年度,10727908,9770710,957198,0,957198,492840,242774,0,200000,535614
2022,61,214213,岐阜県,北方町,5,2,決算収支の状況,2,令和3年度,9947339,8969214,978125,413743,564382,136765,410597,0,0,547362
2022,61,215015,岐阜県,坂祝町,5,2,決算収支の状況,2,令和3年度,4070481,3847271,223210,12889,210321,13035,176579,0,0,189614
2022,61,215023,岐阜県,富加町,5,2,決算収支の状況,2,令和3年度,3663983,3462209,201774,0,201774,8052,269661,0,0,277713
2022,61,215031,岐阜県,川辺町,5,2,決算収支の状況,2,令和3年度,5901968,5625330,276638,16245,260393,-29520,6078,0,0,-23442
2022,61,215040,岐阜県,七宗町,5,2,決算収支の状況,2,令和3年度,3437994,3307069,130925,1,130924,64126,50278,0,0,114404
2022,61,215058,岐阜県,八百津町,5,2,決算収支の状況,2,令和3年度,7444810,6991560,453250,68850,384400,39657,1281,0,0,40938
2022,61,215066,岐阜県,白川町,5,2,決算収支の状況,2,令和3年度,7286036,6774538,511498,110470,401028,63335,0,0,0,63335
2022,61,215074,岐阜県,東白川村,5,2,決算収支の状況,2,令和3年度,3190998,2789847,401151,16300,384851,50365,125600,0,0,175965
2022,61,215210,岐阜県,御嵩町,5,2,決算収支の状況,2,令和3年度,8993156,8724611,268545,119728,148817,-120473,135320,0,0,14847
2022,61,216046,岐阜県,白川村,5,2,決算収支の状況,2,令和3年度,4355336,4214290,141046,51776,89270,-22567,55000,0,0,32433
2022,61,218219,岐阜県,岐阜羽島衛生施設組合,6,2,決算収支の状況,2,令和3年度,1019065,820222,198843,1254,197589,66157,0,0,0,66157
2022,61,218227,岐阜県,大垣衛生施設組合,6,2,決算収支の状況,2,令和3年度,543829,438309,105520,0,105520,8533,0,0,0,8533
2022,61,218235,岐阜県,可茂衛生施設利用組合,6,2,決算収支の状況,2,令和3年度,3262258,3136426,125832,7062,118770,-41142,156759,0,169103,-53486
2022,61,218243,岐阜県,南濃衛生施設利用事務組合,6,2,決算収支の状況,2,令和3年度,2375487,2291265,84222,0,84222,-58872,0,0,0,-58872
2022,61,218391,岐阜県,木曽川右岸地帯水防事務組合,6,2,決算収支の状況,2,令和3年度,37340,25982,11358,0,11358,-984,0,0,0,-984
2022,61,218405,岐阜県,大垣輪中水防事務組合,6,2,決算収支の状況,2,令和3年度,63926,39288,24638,0,24638,-671,0,0,0,-671
2022,61,218430,岐阜県,揖斐川水防事務組合,6,2,決算収支の状況,2,令和3年度,1970,665,1305,0,1305,-81,0,0,0,-81
2022,61,218472,岐阜県,土岐川防災ダム一部事務組合,6,2,決算収支の状況,2,令和3年度,17569,15132,2437,0,2437,646,0,0,0,646
2022,61,218481,岐阜県,可児川防災等ため池組合,6,2,決算収支の状況,2,令和3年度,34211,29698,4513,0,4513,-1417,0,0,0,-1417
2022,61,218499,岐阜県,揖斐郡養基小学校養基保育所組合,6,2,決算収支の状況,2,令和3年度,194256,184521,9735,460,9275,1946,0,0,0,1946
2022,61,218537,岐阜県,大垣市安八郡安八町東安中学校組合,6,2,決算収支の状況,2,令和3年度,89927,77899,12028,0,12028,7876,0,0,0,7876
2022,61,218588,岐阜県,可児市・御嵩町中学校組合,6,2,決算収支の状況,2,令和3年度,65206,63167,2039,0,2039,528,0,0,0,528
2022,61,218669,岐阜県,岐阜県市町村会館組合,6,2,決算収支の状況,2,令和3年度,71245,67035,4210,0,4210,349,1,0,0,350
2022,61,218693,岐阜県,樫原谷林野組合,6,2,決算収支の状況,2,令和3年度,254,123,131,0,131,-70,2,0,0,-68
2022,61,218707,岐阜県,足打谷林野組合,6,2,決算収支の状況,2,令和3年度,1315,118,1197,0,1197,704,0,0,0,704
2022,61,218782,岐阜県,岐阜県市町村職員退職手当組合,6,2,決算収支の状況,2,令和3年度,6747683,6363902,383781,0,383781,354744,0,0,0,354744
2022,61,218791,岐阜県,不破消防組合,6,2,決算収支の状況,2,令和3年度,836372,777326,59046,0,59046,20168,0,0,0,20168
2022,61,218821,岐阜県,美濃加茂市富加町中学校組合,6,2,決算収支の状況,2,令和3年度,66843,62241,4602,0,4602,-539,7,0,0,-532
2022,61,218898,岐阜県,揖斐郡消防組合,6,2,決算収支の状況,2,令和3年度,842525,814770,27755,0,27755,8821,10,0,0,8831
2022,61,218901,岐阜県,可茂消防事務組合,6,2,決算収支の状況,2,令和3年度,2979147,2818509,160638,14863,145775,-14751,84,0,0,-14667
2022,61,218936,岐阜県,岐阜県地方競馬組合,7,2,決算収支の状況,2,令和3年度,0,0,0,0,0,0,0,0,0,0
2022,61,218944,岐阜県,大垣消防組合,6,2,決算収支の状況,2,令和3年度,2636181,2428352,207829,0,207829,27117,0,0,0,27117
2022,61,218952,岐阜県,西濃環境整備組合,6,2,決算収支の状況,2,令和3年度,1349314,1313289,36025,0,36025,11364,37,0,115487,-104086
2022,61,219002,岐阜県,岐北衛生施設利用組合,6,2,決算収支の状況,2,令和3年度,230474,199497,30977,0,30977,-6283,0,0,0,-6283
2022,61,219070,岐阜県,中濃地域広域行政事務組合,6,2,決算収支の状況,2,令和3年度,1433227,1276804,156423,8250,148173,-59892,702,0,0,-59190
2022,61,219088,岐阜県,中濃消防組合,6,2,決算収支の状況,2,令和3年度,1857007,1736720,120287,0,120287,-1692,0,0,0,-1692
2022,61,219169,岐阜県,東濃西部広域行政事務組合,6,2,決算収支の状況,2,令和3年度,288540,273361,15179,0,15179,1390,0,0,0,1390
2022,61,219177,岐阜県,西南濃粗大廃棄物処理組合,6,2,決算収支の状況,2,令和3年度,521363,456293,65070,0,65070,37295,0,0,0,37295
2022,61,219321,岐阜県,岐阜地域児童発達支援センター組合,6,2,決算収支の状況,2,令和3年度,185926,178133,7793,0,7793,1655,0,0,0,1655
2022,61,219371,岐阜県,土岐市及び瑞浪市休日急病診療所組合,6,2,決算収支の状況,2,令和3年度,54780,49806,4974,0,4974,2719,0,0,0,2719
2022,61,219754,岐阜県,安八郡広域連合,7,2,決算収支の状況,2,令和3年度,0,0,0,0,0,0,0,0,0,0
2022,61,219762,岐阜県,揖斐広域連合,6,2,決算収支の状況,2,令和3年度,393970,384569,9401,0,9401,3872,2,0,0,3874
2022,61,219771,岐阜県,もとす広域連合（普通会計分）,6,2,決算収支の状況,2,令和3年度,1099309,1068669,30640,0,30640,-11805,61558,0,148099,-98346
2022,61,219843,岐阜県,羽島郡広域連合,6,2,決算収支の状況,2,令和3年度,809770,765039,44731,0,44731,-38769,0,0,0,-38769
2022,61,219851,岐阜県,古川国府給食センター利用組合,6,2,決算収支の状況,2,令和3年度,306431,306428,3,0,3,-136,0,0,0,-136
2022,61,219860,岐阜県,岐阜県後期高齢者医療広域連合,7,2,決算収支の状況,2,令和3年度,177041,157860,19181,0,19181,-16887,0,0,0,-16887
2022,61,221007,静岡県,静岡市,1,2,決算収支の状況,2,令和3年度,363053431,353330636,9722795,3131119,6591676,1249137,5200285,0,2209100,4240322
2022,61,221309,静岡県,浜松市,1,2,決算収支の状況,2,令和3年度,394601514,383252465,11349049,4115682,7233367,753112,3715067,0,0,4468179
2022,61,222038,静岡県,沼津市,9,2,決算収支の状況,2,令和3年度,85613036,81968958,3644078,169531,3474547,1909157,1591024,0,1291610,2208571
2022,61,222054,静岡県,熱海市,4,2,決算収支の状況,2,令和3年度,22595893,20345652,2250241,467912,1782329,1327600,305100,0,497510,1135190
2022,61,222062,静岡県,三島市,3,2,決算収支の状況,2,令和3年度,43319183,41130117,2189066,77514,2111552,1167176,1023020,0,491500,1698696
2022,61,222071,静岡県,富士宮市,3,2,決算収支の状況,2,令和3年度,56748586,52824470,3924116,414284,3509832,1630610,2074096,0,1465677,2239029
2022,61,222089,静岡県,伊東市,4,2,決算収支の状況,2,令和3年度,32316532,30959208,1357324,456341,900983,228613,380351,0,0,608964
2022,61,222097,静岡県,島田市,4,2,決算収支の状況,2,令和3年度,44505578,42519108,1986470,159177,1827293,998208,557,0,0,998765
2022,61,222101,静岡県,富士市,9,2,決算収支の状況,2,令和3年度,101564040,97181378,4382662,251771,4130891,1019440,2897296,0,732000,3184736
2022,61,222119,静岡県,磐田市,3,2,決算収支の状況,2,令和3年度,75329595,72354969,2974626,226282,2748344,1687212,14002,0,0,1701214
2022,61,222127,静岡県,焼津市,3,2,決算収支の状況,2,令和3年度,67216401,63954374,3262027,351199,2910828,553141,9794,0,0,562935
2022,61,222135,静岡県,掛川市,3,2,決算収支の状況,2,令和3年度,55685566,53362488,2323078,111081,2211997,628902,766626,0,0,1395528
2022,61,222143,静岡県,藤枝市,3,2,決算収支の状況,2,令和3年度,63231712,59450142,3781570,80829,3700741,1855216,3893460,0,0,5748676
2022,61,222151,静岡県,御殿場市,4,2,決算収支の状況,2,令和3年度,43238939,40844978,2393961,225672,2168289,409684,1863336,0,1682342,590678
2022,61,222160,静岡県,袋井市,4,2,決算収支の状況,2,令和3年度,41539450,39869228,1670222,204489,1465733,389680,425276,0,0,814956
2022,61,222194,静岡県,下田市,4,2,決算収支の状況,2,令和3年度,13692325,12769800,922525,19800,902725,82099,530005,0,240000,372104
2022,61,222208,静岡県,裾野市,4,2,決算収支の状況,2,令和3年度,24682192,23109753,1572439,790823,781616,167412,80,145092,461626,-149042
2022,61,222216,静岡県,湖西市,4,2,決算収支の状況,2,令和3年度,26856520,25038239,1818281,155112,1663169,-295663,71,0,969326,-1264918
2022,61,222224,静岡県,伊豆市,4,2,決算収支の状況,2,令和3年度,24162173,22446293,1715880,245975,1469905,141477,691018,0,0,832495
2022,61,222232,静岡県,御前崎市,4,2,決算収支の状況,2,令和3年度,18476667,17963826,512841,32800,480041,232530,640500,0,445560,427470
2022,61,222241,静岡県,菊川市,4,2,決算収支の状況,2,令和3年度,22009983,21333079,676904,3432,673472,311940,281389,0,0,593329
2022,61,222259,静岡県,伊豆の国市,4,2,決算収支の状況,2,令和3年度,26415000,25127772,1287228,182542,1104686,169115,473079,0,102221,539973
2022,61,222267,静岡県,牧之原市,4,2,決算収支の状況,2,令和3年度,23347818,22224364,1123454,26534,1096920,318795,276671,0,0,595466
2022,61,223018,静岡県,東伊豆町,5,2,決算収支の状況,2,令和3年度,6646305,6150488,495817,44447,451370,52105,523026,0,0,575131
2022,61,223026,静岡県,河津町,5,2,決算収支の状況,2,令和3年度,5064012,4758966,305046,51504,253542,14672,357220,0,0,371892
2022,61,223042,静岡県,南伊豆町,5,2,決算収支の状況,2,令和3年度,6342136,6066695,275441,0,275441,61950,133471,0,0,195421
2022,61,223051,静岡県,松崎町,5,2,決算収支の状況,2,令和3年度,4200422,4049137,151285,49393,101892,-39291,252101,0,0,212810
2022,61,223069,静岡県,西伊豆町,5,2,決算収支の状況,2,令和3年度,8707024,8105699,601325,289166,312159,158901,86916,0,300000,-54183
2022,61,223255,静岡県,函南町,5,2,決算収支の状況,2,令和3年度,14602265,13930556,671709,3169,668540,148887,1032164,0,275750,905301
2022,61,223417,静岡県,清水町,5,2,決算収支の状況,2,令和3年度,12105775,11222206,883569,16137,867432,525397,219511,0,0,744908
2022,61,223425,静岡県,長泉町,5,2,決算収支の状況,2,令和3年度,17886982,17337515,549467,67349,482118,376608,243123,0,667000,-47269
2022,61,223441,静岡県,小山町,5,2,決算収支の状況,2,令和3年度,14837962,13879939,958023,423942,534081,271762,800007,0,240000,831769
2022,61,224243,静岡県,吉田町,5,2,決算収支の状況,2,令和3年度,13437737,12239239,1198498,3597,1194901,752777,456585,29098,287977,950483
2022,61,224294,静岡県,川根本町,5,2,決算収支の状況,2,令和3年度,6612891,5840877,772014,52507,719507,374432,63649,0,0,438081
2022,61,224618,静岡県,森町,5,2,決算収支の状況,2,令和3年度,10835515,9634998,1200517,17274,1183243,228940,31505,0,0,260445
2022,61,228052,静岡県,浜名湖競艇企業団,7,2,決算収支の状況,2,令和3年度,0,0,0,0,0,0,0,0,0,0
2022,61,228087,静岡県,牧之原市菊川市学校組合,6,2,決算収支の状況,2,令和3年度,283092,255070,28022,0,28022,2693,0,0,0,2693
2022,61,228125,静岡県,小笠老人ホーム施設組合,6,2,決算収支の状況,2,令和3年度,146182,128175,18007,0,18007,5725,0,0,0,5725
2022,61,228168,静岡県,東遠広域施設組合,6,2,決算収支の状況,2,令和3年度,592130,539209,52921,0,52921,-28398,0,0,0,-28398
2022,61,228176,静岡県,静岡県市町総合事務組合,6,2,決算収支の状況,2,令和3年度,4680666,4415152,265514,0,265514,-112240,0,0,0,-112240
2022,61,228192,静岡県,三島函南広域行政組合,6,2,決算収支の状況,2,令和3年度,292426,266701,25725,0,25725,-10114,0,0,0,-10114
2022,61,228206,静岡県,牧之原市御前崎市広域施設組合,6,2,決算収支の状況,2,令和3年度,1130362,1033969,96393,0,96393,-30811,0,0,0,-30811
2022,61,228249,静岡県,御殿場市・小山町広域行政組合,6,2,決算収支の状況,2,令和3年度,3491247,3392751,98496,0,98496,-20521,0,0,0,-20521
2022,61,228257,静岡県,東河環境センター,6,2,決算収支の状況,2,令和3年度,538793,489146,49647,0,49647,-18364,58011,0,0,39647
2022,61,228281,静岡県,南豆衛生プラント組合,6,2,決算収支の状況,2,令和3年度,126361,122101,4260,0,4260,-4774,0,0,0,-4774
2022,61,228419,静岡県,太田川原野谷川治水水防組合,6,2,決算収支の状況,2,令和3年度,5577,5148,429,0,429,152,0,0,0,152
2022,61,228427,静岡県,箱根山御山組合,7,2,決算収支の状況,2,令和3年度,0,0,0,0,0,0,0,0,0,0
2022,61,228435,静岡県,三島市外五ヶ市町箱根山組合,6,2,決算収支の状況,2,令和3年度,0,0,0,0,0,0,0,0,0,0
2022,61,228478,静岡県,西豆衛生プラント組合,6,2,決算収支の状況,2,令和3年度,186559,120649,65910,58300,7610,-6885,0,0,0,-6885
2022,61,228516,静岡県,三島市外三ヶ市町箱根山林組合,6,2,決算収支の状況,2,令和3年度,0,0,0,0,0,0,0,0,0,0
2022,61,228532,静岡県,裾野市長泉町衛生施設組合,6,2,決算収支の状況,2,令和3年度,669797,623045,46752,0,46752,-37720,0,0,0,-37720
2022,61,228541,静岡県,箱根山禁伐林組合,7,2,決算収支の状況,2,令和3年度,0,0,0,0,0,0,0,0,0,0
2022,61,228591,静岡県,静岡県芦湖水利組合,6,2,決算収支の状況,2,令和3年度,10994,4108,6886,0,6886,2051,1,0,0,2052
2022,61,228613,静岡県,伊豆市沼津市衛生施設組合,6,2,決算収支の状況,2,令和3年度,155145,121739,33406,0,33406,8705,1,0,0,8706
2022,61,228621,静岡県,箱根山殖産林組合,7,2,決算収支の状況,2,令和3年度,0,0,0,0,0,0,0,0,0,0
2022,61,228893,静岡県,駿東地区交通災害共済組合,7,2,決算収支の状況,2,令和3年度,0,0,0,0,0,0,0,0,0,0
2022,61,228923,静岡県,岳南排水路管理組合,6,2,決算収支の状況,2,令和3年度,634758,580646,54112,0,54112,15018,0,0,0,15018
2022,61,228958,静岡県,駿遠学園管理組合,6,2,決算収支の状況,2,令和3年度,277824,254025,23799,0,23799,872,0,0,0,872
2022,61,228991,静岡県,御前崎市牧之原市学校組合,6,2,決算収支の状況,2,令和3年度,197803,185763,12040,0,12040,-2276,0,0,0,-2276
2022,61,229024,静岡県,東遠学園組合,6,2,決算収支の状況,2,令和3年度,855062,781373,73689,0,73689,17344,28306,0,13306,32344
2022,61,229041,静岡県,浜名学園組合,6,2,決算収支の状況,2,令和3年度,424745,382470,42275,0,42275,2051,3000,0,0,5051
2022,61,229075,静岡県,駿豆学園管理組合,6,2,決算収支の状況,2,令和3年度,312599,281713,30886,0,30886,-17863,0,0,0,-17863
2022,61,229091,静岡県,袋井市森町広域行政組合,6,2,決算収支の状況,2,令和3年度,3478489,3439492,38997,0,38997,8644,26789,0,34227,1206
2022,61,229113,静岡県,駿東伊豆消防組合,6,2,決算収支の状況,2,令和3年度,6163882,6098222,65660,0,65660,-98490,92256,0,0,-6234
2022,61,229202,静岡県,中遠広域事務組合,6,2,決算収支の状況,2,令和3年度,876301,803094,73207,0,73207,4074,2,0,40000,-35924
2022,61,229211,静岡県,志太広域事務組合,6,2,決算収支の状況,2,令和3年度,7027923,6586377,441546,0,441546,160058,0,0,0,160058
2022,61,229326,静岡県,東遠地区聖苑組合,6,2,決算収支の状況,2,令和3年度,210614,206562,4052,0,4052,-3132,0,0,0,-3132
2022,61,229351,静岡県,伊豆斎場組合,6,2,決算収支の状況,2,令和3年度,325192,308188,17004,0,17004,-1553,0,0,0,-1553
2022,61,229377,静岡県,吉田町牧之原市広域施設組合,6,2,決算収支の状況,2,令和3年度,1864239,1813051,51188,0,51188,-5689,0,0,0,-5689
2022,61,229393,静岡県,下田地区消防組合,6,2,決算収支の状況,2,令和3年度,1312632,1274996,37636,0,37636,-7852,0,0,0,-7852
2022,61,229466,静岡県,中東遠看護専門学校組合,6,2,決算収支の状況,2,令和3年度,419073,390223,28850,1144,27706,12107,16500,0,0,28607
2022,61,229504,静岡県,一部事務組合下田メディカルセンター（普通会計分）,6,2,決算収支の状況,2,令和3年度,39442,33919,5523,5159,364,4,0,0,0,4
2022,61,229539,静岡県,榛原総合病院組合（普通会計分）,6,2,決算収支の状況,2,令和3年度,118314,100247,18067,0,18067,-6020,0,0,0,-6020
2022,61,229547,静岡県,掛川市・菊川市衛生施設組合,6,2,決算収支の状況,2,令和3年度,1530873,1443762,87111,0,87111,68106,0,0,0,68106
2022,61,229563,静岡県,静岡県後期高齢者医療広域連合,7,2,決算収支の状況,2,令和3年度,125171,116068,9103,0,9103,5368,1,0,0,5369
2022,61,229571,静岡県,静岡地方税滞納整理機構,6,2,決算収支の状況,2,令和3年度,306676,291252,15424,0,15424,8036,11810,0,4467,15379
2022,61,229598,静岡県,伊豆市伊豆の国市廃棄物処理施設組合,6,2,決算収支の状況,2,令和3年度,7259394,5910052,1349342,1341170,8172,-4972,0,0,0,-4972
2022,61,229601,静岡県,富士山南東消防組合,6,2,決算収支の状況,2,令和3年度,2714200,2648750,65450,0,65450,-23305,0,0,0,-23305
2022,61,231002,愛知県,名古屋市,1,2,決算収支の状況,2,令和3年度,1396138350,1378101394,18036956,7797000,10239956,1987714,1835906,114485,0,3938105
2022,61,232017,愛知県,豊橋市,8,2,決算収支の状況,2,令和3年度,149342014,143308125,6033889,800406,5233483,474574,5541,0,0,480115
2022,61,232025,愛知県,岡崎市,8,2,決算収支の状況,2,令和3年度,149478844,140818347,8660497,1646065,7014432,1675160,3825731,0,6016290,-515399
2022,61,232033,愛知県,一宮市,8,2,決算収支の状況,2,令和3年度,148589155,141473946,7115209,196655,6918554,2770638,5104430,0,2700000,5175068
2022,61,232041,愛知県,瀬戸市,3,2,決算収支の状況,2,令和3年度,49027186,46130830,2896356,606072,2290284,277531,1225034,0,439975,1062590
2022,61,232050,愛知県,半田市,3,2,決算収支の状況,2,令和3年度,50558405,46674303,3884102,1230229,2653873,1244565,1757944,0,1757852,1244657
2022,61,232068,愛知県,春日井市,9,2,決算収支の状況,2,令和3年度,118769892,117530702,1239190,238960,1000230,954231,33000,0,0,987231
2022,61,232076,愛知県,豊川市,3,2,決算収支の状況,2,令和3年度,77681182,73643106,4038076,272150,3765926,869032,1465102,80058,929641,1484551
2022,61,232084,愛知県,津島市,4,2,決算収支の状況,2,令和3年度,25992314,24942098,1050216,42857,1007359,-88232,1523182,0,0,1434950
2022,61,232092,愛知県,碧南市,4,2,決算収支の状況,2,令和3年度,36137253,33179167,2958086,99135,2858951,99788,6356,0,149774,-43630
2022,61,232106,愛知県,刈谷市,3,2,決算収支の状況,2,令和3年度,72042969,64441938,7601031,2547941,5053090,-245832,10913,0,890027,-1124946
2022,61,232114,愛知県,豊田市,8,2,決算収支の状況,2,令和3年度,209036181,194779488,14256693,5331946,8924747,1519467,4400000,0,8700000,-2780533
2022,61,232122,愛知県,安城市,3,2,決算収支の状況,2,令和3年度,79558012,74125257,5432755,928403,4504352,83264,2228181,0,1630822,680623
2022,61,232131,愛知県,西尾市,3,2,決算収支の状況,2,令和3年度,70780573,66626590,4153983,312656,3841327,744716,202459,0,0,947175
2022,61,232149,愛知県,蒲郡市,4,2,決算収支の状況,2,令和3年度,41711261,38165807,3545454,365391,3180063,752760,409400,0,0,1162160
2022,61,232157,愛知県,犬山市,4,2,決算収支の状況,2,令和3年度,30556129,29208294,1347835,183048,1164787,96305,1837732,0,587305,1346732
2022,61,232165,愛知県,常滑市,4,2,決算収支の状況,2,令和3年度,29926562,28087796,1838766,261436,1577330,336260,300000,0,0,636260
2022,61,232173,愛知県,江南市,4,2,決算収支の状況,2,令和3年度,36540488,34479102,2061386,260272,1801114,1008852,628771,300000,12912,1924711
2022,61,232190,愛知県,小牧市,3,2,決算収支の状況,2,令和3年度,65066222,61779726,3286496,1682104,1604392,47346,7865,0,0,55211
2022,61,232203,愛知県,稲沢市,3,2,決算収支の状況,2,令和3年度,53701616,49400906,4300710,242166,4058544,2213276,201305,0,0,2414581
2022,61,232211,愛知県,新城市,4,2,決算収支の状況,2,令和3年度,26544628,25166129,1378499,52932,1325567,516473,562003,0,0,1078476
2022,61,232220,愛知県,東海市,3,2,決算収支の状況,2,令和3年度,55888499,50729623,5158876,813930,4344946,733673,710931,0,882562,562042
2022,61,232238,愛知県,大府市,4,2,決算収支の状況,2,令和3年度,39505754,36817539,2688215,778114,1910101,755521,9469,0,539909,225081
2022,61,232246,愛知県,知多市,4,2,決算収支の状況,2,令和3年度,32825362,30761566,2063796,112137,1951659,499001,414,0,312919,186496
2022,61,232254,愛知県,知立市,4,2,決算収支の状況,2,令和3年度,26586326,24818751,1767575,244152,1523423,465352,656558,218981,0,1340891
2022,61,232262,愛知県,尾張旭市,4,2,決算収支の状況,2,令和3年度,30381271,28712813,1668458,490894,1177564,520687,649377,0,0,1170064
2022,61,232271,愛知県,高浜市,4,2,決算収支の状況,2,令和3年度,18212802,17229402,983400,53020,930380,194646,2334,0,109388,87592
2022,61,232289,愛知県,岩倉市,4,2,決算収支の状況,2,令和3年度,19677080,18561872,1115208,0,1115208,80507,501514,0,50000,532021
2022,61,232297,愛知県,豊明市,4,2,決算収支の状況,2,令和3年度,28751886,26735860,2016026,265391,1750635,841887,692830,0,845326,689391
2022,61,232301,愛知県,日進市,4,2,決算収支の状況,2,令和3年度,31907085,29744259,2162826,363648,1799178,555331,33330,0,0,588661
2022,61,232319,愛知県,田原市,4,2,決算収支の状況,2,令和3年度,29447295,28465423,981872,100926,880946,47836,2869,0,300000,-249295
2022,61,232327,愛知県,愛西市,4,2,決算収支の状況,2,令和3年度,27262962,26205573,1057389,7087,1050302,75110,808238,0,844980,38368
2022,61,232335,愛知県,清須市,4,2,決算収支の状況,2,令和3年度,33212460,31398993,1813467,321495,1491972,499893,2274,0,110904,391263
2022,61,232343,愛知県,北名古屋市,4,2,決算収支の状況,2,令和3年度,33539327,31564319,1975008,33053,1941955,610015,539549,0,0,1149564
2022,61,232351,愛知県,弥富市,4,2,決算収支の状況,2,令和3年度,18565493,17768644,796849,10132,786717,132732,314672,0,0,447404
2022,61,232360,愛知県,みよし市,4,2,決算収支の状況,2,令和3年度,33870574,30778705,3091869,727643,2364226,-41033,2224923,0,3224385,-1040495
2022,61,232378,愛知県,あま市,4,2,決算収支の状況,2,令和3年度,36954715,35153727,1800988,309686,1491302,921340,1737367,0,1595411,1063296
2022,61,232386,愛知県,長久手市,4,2,決算収支の状況,2,令和3年度,23582866,22275527,1307339,152115,1155224,778528,188877,0,465830,501575
2022,61,233021,愛知県,東郷町,5,2,決算収支の状況,2,令和3年度,16420873,15402619,1018254,52507,965747,93829,380,0,563780,-469571
2022,61,233421,愛知県,豊山町,5,2,決算収支の状況,2,令和3年度,8438592,7987288,451304,21218,430086,83781,423636,0,237522,269895
2022,61,233617,愛知県,大口町,5,2,決算収支の状況,2,令和3年度,10334816,9802021,532795,349261,183534,3427,90523,0,170000,-76050
2022,61,233625,愛知県,扶桑町,5,2,決算収支の状況,2,令和3年度,12380287,11953346,426941,888,426053,67080,404018,0,0,471098
2022,61,234249,愛知県,大治町,5,2,決算収支の状況,2,令和3年度,11474924,10770013,704911,111633,593278,118778,662101,0,200000,580879
2022,61,234257,愛知県,蟹江町,5,2,決算収支の状況,2,令和3年度,14200759,13570230,630529,129,630400,-29550,737098,0,440000,267548
2022,61,234273,愛知県,飛島村,5,2,決算収支の状況,2,令和3年度,6462671,5814476,648195,278433,369762,-21015,272146,0,272146,-21015
2022,61,234419,愛知県,阿久比町,5,2,決算収支の状況,2,令和3年度,11322797,10791433,531364,9864,521500,185956,168174,0,210000,144130
2022,61,234427,愛知県,東浦町,5,2,決算収支の状況,2,令和3年度,18572003,17219279,1352724,230765,1121959,421128,2231,0,200000,223359
2022,61,234451,愛知県,南知多町,5,2,決算収支の状況,2,令和3年度,9268208,8942977,325231,16356,308875,39596,135386,0,88100,86882
2022,61,234460,愛知県,美浜町,5,2,決算収支の状況,2,令和3年度,9670542,9296793,373749,1337,372412,31048,99673,0,0,130721
2022,61,234478,愛知県,武豊町,5,2,決算収支の状況,2,令和3年度,18253846,17126836,1127010,50603,1076407,594330,1002,0,100000,495332
2022,61,235016,愛知県,幸田町,5,2,決算収支の状況,2,令和3年度,20251930,18872466,1379464,146404,1233060,365062,131597,0,0,496659
2022,61,235610,愛知県,設楽町,5,2,決算収支の状況,2,令和3年度,6087254,5883481,203773,83254,120519,53630,335757,0,0,389387
2022,61,235628,愛知県,東栄町,5,2,決算収支の状況,2,令和3年度,4455470,4171048,284422,55403,229019,52788,303955,0,178710,178033
2022,61,235636,愛知県,豊根村,5,2,決算収支の状況,2,令和3年度,2709548,2602919,106629,153,106476,-18776,989,0,0,-17787
2022,61,238015,愛知県,名古屋港管理組合,6,2,決算収支の状況,2,令和3年度,37531409,35803591,1727818,587622,1140196,-340728,0,0,0,-340728
2022,61,238023,愛知県,愛知県競馬組合,7,2,決算収支の状況,2,令和3年度,0,0,0,0,0,0,0,0,0,0
2022,61,238031,愛知県,名古屋競輪組合,7,2,決算収支の状況,2,令和3年度,0,0,0,0,0,0,0,0,0,0
2022,61,238121,愛知県,岡崎市額田郡模範造林組合,6,2,決算収支の状況,2,令和3年度,12087,9890,2197,0,2197,1605,2,0,0,1607
2022,61,238171,愛知県,海部南部広域事務組合（普通会計分）,6,2,決算収支の状況,2,令和3年度,106095,80807,25288,0,25288,9580,0,0,0,9580
2022,61,238295,愛知県,知多中部広域事務組合（普通会計分）,6,2,決算収支の状況,2,令和3年度,2998102,2956620,41482,0,41482,-1128,0,0,0,-1128
2022,61,238309,愛知県,愛知県市町村職員退職手当組合,6,2,決算収支の状況,2,令和3年度,7808764,7144456,664308,0,664308,-496262,980000,0,0,483738
2022,61,238333,愛知県,愛北広域事務組合,6,2,決算収支の状況,2,令和3年度,567946,539522,28424,0,28424,-4139,0,0,0,-4139
2022,61,238350,愛知県,中部知多衛生組合,6,2,決算収支の状況,2,令和3年度,1446150,1375369,70781,54882,15899,6035,0,0,0,6035
2022,61,238376,愛知県,東部知多衛生組合,6,2,決算収支の状況,2,令和3年度,2298163,2210148,88015,0,88015,6545,0,0,0,6545
2022,61,238384,愛知県,衣浦衛生組合,6,2,決算収支の状況,2,令和3年度,3308216,3212496,95720,0,95720,35724,0,0,0,35724
2022,61,238414,愛知県,常滑武豊衛生組合,6,2,決算収支の状況,2,令和3年度,845365,821584,23781,0,23781,6790,0,0,0,6790
2022,61,238422,愛知県,蒲郡市幸田町衛生組合,6,2,決算収支の状況,2,令和3年度,338090,296142,41948,0,41948,15063,0,0,0,15063
2022,61,238465,愛知県,西知多医療厚生組合,6,2,決算収支の状況,2,令和3年度,4829422,4009070,820352,617637,202715,113434,0,0,0,113434
2022,61,238481,愛知県,尾張東部衛生組合,6,2,決算収支の状況,2,令和3年度,4762917,4620263,142654,1922,140732,41185,0,0,0,41185
2022,61,238490,愛知県,海部地区環境事務組合,6,2,決算収支の状況,2,令和3年度,3507687,3452321,55366,0,55366,11733,22069,0,78540,-44738
2022,61,238511,愛知県,小牧岩倉衛生組合,6,2,決算収支の状況,2,令和3年度,2307036,2227056,79980,0,79980,-30817,0,0,0,-30817
2022,61,238538,愛知県,知多南部衛生組合,6,2,決算収支の状況,2,令和3年度,2027313,1997288,30025,2970,27055,10250,0,0,0,10250
2022,61,238589,愛知県,刈谷知立環境組合,6,2,決算収支の状況,2,令和3年度,2697540,2623287,74253,0,74253,-24178,0,0,0,-24178
2022,61,238597,愛知県,江南丹羽環境管理組合,6,2,決算収支の状況,2,令和3年度,1127484,1086057,41427,0,41427,6414,0,0,0,6414
2022,61,238651,愛知県,新城北設楽交通災害共済組合,7,2,決算収支の状況,2,令和3年度,0,0,0,0,0,0,0,0,0,0
2022,61,238686,愛知県,半田常滑看護専門学校管理組合,6,2,決算収支の状況,2,令和3年度,163742,156194,7548,0,7548,493,0,0,0,493
2022,61,238694,愛知県,北設広域事務組合,6,2,決算収支の状況,2,令和3年度,1440146,1414442,25704,0,25704,13766,50959,0,71033,-6308
2022,61,238708,愛知県,海部東部消防組合（普通会計分）,6,2,決算収支の状況,2,令和3年度,1544926,1491791,53135,0,53135,-4935,27267,0,27000,-4668
2022,61,238724,愛知県,尾三消防組合,6,2,決算収支の状況,2,令和3年度,3971588,3896547,75041,0,75041,11114,41344,0,217243,-164785
2022,61,238741,愛知県,北名古屋衛生組合,6,2,決算収支の状況,2,令和3年度,1987649,1920518,67131,0,67131,-588,65212,0,9600,55024
2022,61,238791,愛知県,海部南部消防組合,6,2,決算収支の状況,2,令和3年度,1144400,1070951,73449,0,73449,-14680,57238,0,0,42558
2022,61,238805,愛知県,海部地区水防事務組合,6,2,決算収支の状況,2,令和3年度,28042,25863,2179,0,2179,-46,3000,0,0,2954
2022,61,238821,愛知県,瀬戸旭看護専門学校組合,6,2,決算収支の状況,2,令和3年度,287008,269731,17277,0,17277,-449,0,0,0,-449
2022,61,238848,愛知県,尾張東部火葬場管理組合,6,2,決算収支の状況,2,令和3年度,232672,190842,41830,0,41830,10996,0,0,0,10996
2022,61,238872,愛知県,尾三衛生組合,6,2,決算収支の状況,2,令和3年度,1392996,1293164,99832,0,99832,32390,67501,0,52847,47044
2022,61,238970,愛知県,知多南部消防組合,6,2,決算収支の状況,2,令和3年度,780574,773230,7344,0,7344,-1943,4645,0,0,2702
2022,61,238988,愛知県,知北平和公園組合,6,2,決算収支の状況,2,令和3年度,364038,357930,6108,0,6108,-2703,0,0,0,-2703
2022,61,238996,愛知県,五条広域事務組合,6,2,決算収支の状況,2,令和3年度,648641,611934,36707,0,36707,3286,0,0,0,3286
2022,61,239046,愛知県,海部地区急病診療所組合,6,2,決算収支の状況,2,令和3年度,105160,71949,33211,0,33211,24311,1,0,0,24312
2022,61,239054,愛知県,春日井小牧看護専門学校管理組合,6,2,決算収支の状況,2,令和3年度,244218,226178,18040,0,18040,1786,0,0,0,1786
2022,61,239178,愛知県,知多北部広域連合,6,2,決算収支の状況,2,令和3年度,3882727,3860783,21944,0,21944,3177,9159,0,105502,-93166
2022,61,239267,愛知県,丹羽広域事務組合（普通会計分）,6,2,決算収支の状況,2,令和3年度,884119,814818,69301,38610,30691,-9084,0,0,0,-9084
2022,61,239283,愛知県,衣浦東部広域連合,6,2,決算収支の状況,2,令和3年度,5987249,5782326,204923,12250,192673,-62923,0,0,0,-62923
2022,61,239291,愛知県,西春日井広域事務組合,6,2,決算収支の状況,2,令和3年度,2178069,2074897,103172,0,103172,-36400,8741,0,0,-27659
2022,61,239305,愛知県,愛知県後期高齢者医療広域連合,7,2,決算収支の状況,2,令和3年度,1381709,1239328,142381,0,142381,27507,0,0,0,27507
2022,61,239321,愛知県,知多南部広域環境組合,6,2,決算収支の状況,2,令和3年度,13045016,13003113,41903,0,41903,36281,0,0,0,36281
2022,61,239330,愛知県,東三河広域連合,6,2,決算収支の状況,2,令和3年度,8727675,8504641,223034,0,223034,63252,0,0,0,63252
2022,61,239348,愛知県,尾張北部環境組合,6,2,決算収支の状況,2,令和3年度,103584,94784,8800,0,8800,4470,0,0,0,4470
2022,61,242012,三重県,津市,3,2,決算収支の状況,2,令和3年度,123652909,120450580,3202329,379657,2822672,424426,1232406,0,0,1656832
2022,61,242021,三重県,四日市市,9,2,決算収支の状況,2,令和3年度,143738517,131958965,11779552,3305989,8473563,3932289,2268659,0,3251558,2949390
2022,61,242039,三重県,伊勢市,3,2,決算収支の状況,2,令和3年度,59407131,58665529,741602,224816,516786,234572,16267,0,0,250839
2022,61,242047,三重県,松阪市,3,2,決算収支の状況,2,令和3年度,80239349,77932803,2306546,274129,2032417,-709581,3409177,0,0,2699596
2022,61,242055,三重県,桑名市,3,2,決算収支の状況,2,令和3年度,63231490,59658017,3573473,502971,3070502,895359,1242557,1017302,0,3155218
2022,61,242071,三重県,鈴鹿市,3,2,決算収支の状況,2,令和3年度,73598603,70150547,3448056,409271,3038785,2439258,254,0,0,2439512
2022,61,242080,三重県,名張市,4,2,決算収支の状況,2,令和3年度,33761072,32490918,1270154,4586,1265568,717401,1029149,0,0,1746550
2022,61,242098,三重県,尾鷲市,4,2,決算収支の状況,2,令和3年度,11759358,11416625,342733,3610,339123,45177,1054864,0,316785,783256
2022,61,242101,三重県,亀山市,4,2,決算収支の状況,2,令和3年度,25167096,23947372,1219724,124720,1095004,198086,2525,0,459795,-259184
2022,61,242110,三重県,鳥羽市,4,2,決算収支の状況,2,令和3年度,13701385,12818080,883305,13277,870028,364432,141446,0,0,505878
2022,61,242128,三重県,熊野市,4,2,決算収支の状況,2,令和3年度,14653902,13731854,922048,77977,844071,-35974,3594,0,0,-32380
2022,61,242144,三重県,いなべ市,4,2,決算収支の状況,2,令和3年度,25688703,23843094,1845609,109942,1735667,204225,1636649,0,1277172,563702
2022,61,242152,三重県,志摩市,4,2,決算収支の状況,2,令和3年度,28421808,27473994,947814,4488,943326,437413,1148915,0,1082509,503819
2022,61,242161,三重県,伊賀市,4,2,決算収支の状況,2,令和3年度,49202920,47227554,1975366,209239,1766127,936470,457592,0,0,1394062
2022,61,243035,三重県,木曽岬町,5,2,決算収支の状況,2,令和3年度,3630191,3352366,277825,5676,272149,156754,5031,0,0,161785
2022,61,243248,三重県,東員町,5,2,決算収支の状況,2,令和3年度,10989019,9472235,1516784,29717,1487067,842854,254593,0,0,1097447
2022,61,243418,三重県,菰野町,5,2,決算収支の状況,2,令和3年度,15908595,15021848,886747,17227,869520,416153,2103,0,140000,278256
2022,61,243434,三重県,朝日町,5,2,決算収支の状況,2,令和3年度,5197158,4982246,214912,2914,211998,116806,302737,0,269482,150061
2022,61,243442,三重県,川越町,5,2,決算収支の状況,2,令和3年度,7703626,7269638,433988,10392,423596,92262,36666,0,493942,-365014
2022,61,244414,三重県,多気町,5,2,決算収支の状況,2,令和3年度,10175537,9774842,400695,31878,368817,20521,615638,0,0,636159
2022,61,244422,三重県,明和町,5,2,決算収支の状況,2,令和3年度,12810233,11596986,1213247,6450,1206797,350535,100000,0,0,450535
2022,61,244431,三重県,大台町,5,2,決算収支の状況,2,令和3年度,8101676,7807565,294111,39199,254912,91791,82577,0,85084,89284
2022,61,244619,三重県,玉城町,5,2,決算収支の状況,2,令和3年度,7543213,7200202,343011,71799,271212,74403,34174,0,0,108577
2022,61,244708,三重県,度会町,5,2,決算収支の状況,2,令和3年度,5021119,4764624,256495,84792,171703,7243,239431,0,0,246674
2022,61,244716,三重県,大紀町,5,2,決算収支の状況,2,令和3年度,8453261,8084477,368784,3097,365687,20051,400772,0,0,420823
2022,61,244724,三重県,南伊勢町,5,2,決算収支の状況,2,令和3年度,11053092,10618631,434461,24987,409474,217082,385660,0,0,602742
2022,61,245437,三重県,紀北町,5,2,決算収支の状況,2,令和3年度,10969507,10372400,597107,25773,571334,23214,294791,0,154165,163840
2022,61,245615,三重県,御浜町,5,2,決算収支の状況,2,令和3年度,6097820,5604598,493222,70281,422941,182733,1049,0,0,183782
2022,61,245623,三重県,紀宝町,5,2,決算収支の状況,2,令和3年度,7739642,7098057,641585,19776,621809,226132,329,0,150000,76461
2022,61,248011,三重県,四日市港管理組合,6,2,決算収支の状況,2,令和3年度,6125059,5998482,126577,92518,34059,-9924,1,0,43984,-53907
2022,61,248274,三重県,三重県多気郡多気町松阪市学校組合,6,2,決算収支の状況,2,令和3年度,606423,603456,2967,0,2967,-21614,0,0,0,-21614
2022,61,248347,三重県,わたらい老人福祉施設組合,6,2,決算収支の状況,2,令和3年度,118322,116558,1764,0,1764,-324,700,0,0,376
2022,61,248355,三重県,宮川福祉施設組合,6,2,決算収支の状況,2,令和3年度,102970,97768,5202,0,5202,1408,2,0,0,1410
2022,61,248371,三重県,紀南社会福祉施設組合,6,2,決算収支の状況,2,令和3年度,168197,162193,6004,0,6004,-9224,4892,0,7000,-11332
2022,61,248398,三重県,三重県三重郡老人福祉施設組合,6,2,決算収支の状況,2,令和3年度,161574,148143,13431,0,13431,1017,0,0,0,1017
2022,61,248533,三重県,朝日町、川越町組合立環境クリーンセンター,6,2,決算収支の状況,2,令和3年度,246210,229642,16568,0,16568,268,8226,0,10000,-1506
2022,61,248592,三重県,奥伊勢広域行政組合,6,2,決算収支の状況,2,令和3年度,158086,137832,20254,0,20254,-5112,0,0,0,-5112
2022,61,248622,三重県,朝明広域衛生組合,6,2,決算収支の状況,2,令和3年度,360899,354349,6550,0,6550,149,0,0,0,149
2022,61,248631,三重県,松阪地区広域衛生組合,6,2,決算収支の状況,2,令和3年度,497624,481911,15713,0,15713,2817,0,0,0,2817
2022,61,248754,三重県,伊賀南部環境衛生組合,6,2,決算収支の状況,2,令和3年度,3442353,3327877,114476,0,114476,26877,0,0,0,26877
2022,61,248771,三重県,三重紀北消防組合,6,2,決算収支の状況,2,令和3年度,1011040,1001736,9304,0,9304,-1672,0,0,0,-1672
2022,61,248789,三重県,南牟婁清掃施設組合,6,2,決算収支の状況,2,令和3年度,398999,343315,55684,0,55684,-15922,0,0,0,-15922
2022,61,248835,三重県,松阪地区広域消防組合,6,2,決算収支の状況,2,令和3年度,2834800,2803693,31107,0,31107,8499,0,0,0,8499
2022,61,248959,三重県,桑名広域清掃事業組合,6,2,決算収支の状況,2,令和3年度,1634184,1584808,49376,0,49376,19895,184160,0,0,204055
2022,61,248967,三重県,志摩広域行政組合,6,2,決算収支の状況,2,令和3年度,244832,235180,9652,0,9652,-3618,11624,0,14550,-6544
2022,61,249106,三重県,三重県市町総合事務組合,6,2,決算収支の状況,2,令和3年度,8188760,7163930,1024830,0,1024830,-733253,2775000,0,0,2041747
2022,61,249149,三重県,紀勢地区広域消防組合,6,2,決算収支の状況,2,令和3年度,827871,807757,20114,0,20114,-9382,110,0,21000,-30272
2022,61,249173,三重県,荷坂やすらぎ苑組合,6,2,決算収支の状況,2,令和3年度,30214,28521,1693,0,1693,-305,0,0,0,-305
2022,61,249181,三重県,香肌奥伊勢資源化広域連合,6,2,決算収支の状況,2,令和3年度,765473,741489,23984,0,23984,16979,0,0,0,16979
2022,61,249203,三重県,鳥羽志勢広域連合,6,2,決算収支の状況,2,令和3年度,2174781,2081397,93384,0,93384,-14587,114982,0,116012,-15617
2022,61,249211,三重県,紀北広域連合,6,2,決算収支の状況,2,令和3年度,402437,385853,16584,0,16584,-5009,0,0,0,-5009
2022,61,249220,三重県,紀南介護保険広域連合,6,2,決算収支の状況,2,令和3年度,1114309,1107030,7279,0,7279,4392,5,0,0,4397
2022,61,249262,三重県,度会広域連合,6,2,決算収支の状況,2,令和3年度,106866,97909,8957,0,8957,3680,5277,0,0,8957
2022,61,249271,三重県,鈴鹿亀山地区広域連合,6,2,決算収支の状況,2,令和3年度,289033,288999,34,0,34,11,0,0,0,11
2022,61,249289,三重県,桑名・員弁広域連合,6,2,決算収支の状況,2,令和3年度,404618,401797,2821,0,2821,51,0,0,0,51
2022,61,249335,三重県,伊勢広域環境組合,6,2,決算収支の状況,2,令和3年度,2380646,2322898,57748,0,57748,7479,111,0,27403,-19813
2022,61,249343,三重県,三重地方税管理回収機構,6,2,決算収支の状況,2,令和3年度,265706,172266,93440,0,93440,9683,0,0,0,9683
2022,61,249351,三重県,三重県後期高齢者医療広域連合,7,2,決算収支の状況,2,令和3年度,76042,72929,3113,0,3113,-1911,2512,0,0,601
2022,61,249360,三重県,東紀州環境施設組合,6,2,決算収支の状況,2,令和3年度,112906,67070,45836,0,45836,45836,0,0,0,45836
2022,61,252018,滋賀県,大津市,8,2,決算収支の状況,2,令和3年度,148846482,143997264,4849218,212241,4636977,1350672,1281625,0,0,2632297
2022,61,252026,滋賀県,彦根市,3,2,決算収支の状況,2,令和3年度,57096887,54733356,2363531,111190,2252341,1586362,2350636,0,2309165,1627833
2022,61,252034,滋賀県,長浜市,3,2,決算収支の状況,2,令和3年度,60762888,58483666,2279222,1040410,1238812,-80479,1481449,1106349,0,2507319
2022,61,252042,滋賀県,近江八幡市,4,2,決算収支の状況,2,令和3年度,43922489,42659982,1262507,151479,1111028,290588,1012429,241166,0,1544183
2022,61,252069,滋賀県,草津市,3,2,決算収支の状況,2,令和3年度,60157969,59024653,1133316,620104,513212,112706,200910,0,0,313616
2022,61,252077,滋賀県,守山市,4,2,決算収支の状況,2,令和3年度,37182617,36155153,1027464,205273,822191,235706,451860,0,0,687566
2022,61,252085,滋賀県,栗東市,4,2,決算収支の状況,2,令和3年度,29592296,28659042,933254,77325,855929,394353,333825,0,0,728178
2022,61,252093,滋賀県,甲賀市,4,2,決算収支の状況,2,令和3年度,46895589,43844474,3051115,575861,2475254,844021,710345,0,0,1554366
2022,61,252107,滋賀県,野洲市,4,2,決算収支の状況,2,令和3年度,25734404,24755294,979110,27952,951158,157670,400778,0,400000,158448
2022,61,252115,滋賀県,湖南市,4,2,決算収支の状況,2,令和3年度,24241449,23318890,922559,53037,869522,270670,488680,341488,0,1100838
2022,61,252123,滋賀県,高島市,4,2,決算収支の状況,2,令和3年度,32150400,31256894,893506,131765,761741,-93347,2239,0,0,-91108
2022,61,252131,滋賀県,東近江市,3,2,決算収支の状況,2,令和3年度,55855604,53550227,2305377,169030,2136347,436626,659214,0,0,1095840
2022,61,252140,滋賀県,米原市,4,2,決算収支の状況,2,令和3年度,23914168,22671037,1243131,193142,1049989,253069,10307,398312,0,661688
2022,61,253839,滋賀県,日野町,5,2,決算収支の状況,2,令和3年度,11089984,10334793,755191,41430,713761,264340,197271,0,0,461611
2022,61,253847,滋賀県,竜王町,5,2,決算収支の状況,2,令和3年度,7197103,6738709,458394,65884,392510,213522,220474,0,0,433996
2022,61,254258,滋賀県,愛荘町,5,2,決算収支の状況,2,令和3年度,11532783,10931084,601699,102482,499217,126587,270709,0,0,397296
2022,61,254410,滋賀県,豊郷町,5,2,決算収支の状況,2,令和3年度,6183511,5979188,204323,30483,173840,-26468,380,233042,215864,-8910
2022,61,254428,滋賀県,甲良町,5,2,決算収支の状況,2,令和3年度,4239079,4070148,168931,37736,131195,-233,198869,0,0,198636
2022,61,254436,滋賀県,多賀町,5,2,決算収支の状況,2,令和3年度,5522624,5219451,303173,62711,240462,-7986,407284,0,0,399298
2022,61,258024,滋賀県,滋賀県市町村職員退職手当組合,6,2,決算収支の状況,2,令和3年度,3147457,2855761,291696,0,291696,263557,126210,0,55605,334162
2022,61,258130,滋賀県,彦根市犬上郡営林組合,6,2,決算収支の状況,2,令和3年度,28174,26049,2125,0,2125,-1290,10731,0,0,9441
2022,61,258148,滋賀県,彦根市米原市山林組合,6,2,決算収支の状況,2,令和3年度,341,171,170,0,170,-138,7,0,0,-131
2022,61,258156,滋賀県,大滝山林組合,6,2,決算収支の状況,2,令和3年度,121747,106585,15162,0,15162,-8368,0,0,1802,-10170
2022,61,258318,滋賀県,湖北広域行政事務センター,6,2,決算収支の状況,2,令和3年度,2961352,2717454,243898,0,243898,-43201,0,0,0,-43201
2022,61,258334,滋賀県,八日市布引ライフ組合,6,2,決算収支の状況,2,令和3年度,549611,524364,25247,0,25247,2293,20543,0,5280,17556
2022,61,258351,滋賀県,滋賀県市町村議会議員公務災害補償等組合,6,2,決算収支の状況,2,令和3年度,32401,31823,578,0,578,-119,2,0,500,-617
2022,61,258415,滋賀県,中部清掃組合,6,2,決算収支の状況,2,令和3年度,1620929,1554485,66444,0,66444,51849,120,0,24268,27701
2022,61,258458,滋賀県,東近江行政組合,6,2,決算収支の状況,2,令和3年度,3662737,3615219,47518,0,47518,-27617,14385,0,40000,-53232
2022,61,258474,滋賀県,甲賀広域行政組合,6,2,決算収支の状況,2,令和3年度,4623034,4573376,49658,1000,48658,6340,0,0,0,6340
2022,61,258580,滋賀県,湖東広域衛生管理組合,6,2,決算収支の状況,2,令和3年度,695349,672964,22385,8477,13908,-4204,15032,0,24629,-13801
2022,61,258598,滋賀県,愛知郡広域行政組合（普通会計分）,6,2,決算収支の状況,2,令和3年度,71276,54404,16872,1650,15222,-23020,18184,0,3270,-8106
2022,61,258679,滋賀県,公立甲賀病院組合（普通会計分）,6,2,決算収支の状況,2,令和3年度,907499,906668,831,0,831,-181,0,0,0,-181
2022,61,258695,滋賀県,守山野洲行政事務組合,6,2,決算収支の状況,2,令和3年度,187969,154588,33381,0,33381,5161,0,0,0,5161
2022,61,258717,滋賀県,湖南広域行政組合,6,2,決算収支の状況,2,令和3年度,4691516,4646018,45498,3140,42358,-15545,19,0,0,-15526
2022,61,258741,滋賀県,彦根愛知犬上広域行政組合,6,2,決算収支の状況,2,令和3年度,648646,603999,44647,29686,14961,4910,7785,0,17068,-4373
2022,61,258750,滋賀県,滋賀県市町村職員研修センター,6,2,決算収支の状況,2,令和3年度,74829,70044,4785,0,4785,-1710,1,0,0,-1709
2022,61,258768,滋賀県,湖北地域消防組合,6,2,決算収支の状況,2,令和3年度,2536355,2462608,73747,0,73747,-14414,1,0,0,-14413
2022,61,258776,滋賀県,滋賀県後期高齢者医療広域連合,7,2,決算収支の状況,2,令和3年度,173620,164173,9447,0,9447,23,0,0,0,23
2022,61,258784,滋賀県,草津栗東行政事務組合,6,2,決算収支の状況,2,令和3年度,0,0,0,0,0,0,0,0,0,0
2022,61,261009,京都府,京都市,1,2,決算収支の状況,2,令和3年度,1056768646,1054162743,2605903,2217975,387928,704744,9451553,0,0,10156297
2022,61,262013,京都府,福知山市,4,2,決算収支の状況,2,令和3年度,46506790,44940120,1566670,562563,1004107,-47305,4949,516094,412704,61034
2022,61,262021,京都府,舞鶴市,4,2,決算収支の状況,2,令和3年度,42512332,40938914,1573418,95134,1478284,1175985,475180,0,0,1651165
2022,61,262030,京都府,綾部市,4,2,決算収支の状況,2,令和3年度,18689955,18584257,105698,59242,46456,7708,68785,0,0,76493
2022,61,262048,京都府,宇治市,3,2,決算収支の状況,2,令和3年度,72379983,71322746,1057237,224431,832806,163706,471263,523700,0,1158669
2022,61,262056,京都府,宮津市,4,2,決算収支の状況,2,令和3年度,12419565,11899308,520257,37110,483147,352495,79500,0,0,431995
2022,61,262064,京都府,亀岡市,4,2,決算収支の状況,2,令和3年度,45118425,43247703,1870722,83853,1786869,1041077,370554,0,0,1411631
2022,61,262072,京都府,城陽市,4,2,決算収支の状況,2,令和3年度,34275009,33897570,377439,302668,74771,1660,253005,0,0,254665
2022,61,262081,京都府,向日市,4,2,決算収支の状況,2,令和3年度,25314728,23580899,1733829,73017,1660812,909380,848101,0,0,1757481
2022,61,262099,京都府,長岡京市,4,2,決算収支の状況,2,令和3年度,38238184,35817220,2420964,384593,2036371,483658,1054865,0,0,1538523
2022,61,262102,京都府,八幡市,4,2,決算収支の状況,2,令和3年度,31031706,30157778,873928,44390,829538,-53560,2214,386940,112400,223194
2022,61,262111,京都府,京田辺市,4,2,決算収支の状況,2,令和3年度,29881653,28710449,1171204,333897,837307,96549,370332,0,0,466881
2022,61,262129,京都府,京丹後市,4,2,決算収支の状況,2,令和3年度,38612778,37420626,1192152,165721,1026431,146846,650775,0,0,797621
2022,61,262137,京都府,南丹市,4,2,決算収支の状況,2,令和3年度,26710813,25668526,1042287,95243,947044,353585,294559,69506,200734,516916
2022,61,262145,京都府,木津川市,4,2,決算収支の状況,2,令和3年度,35002152,33536199,1465953,497303,968650,424664,281543,0,5234,700973
2022,61,263036,京都府,大山崎町,5,2,決算収支の状況,2,令和3年度,7932713,7733347,199366,73312,126054,-7350,283379,0,90199,185830
2022,61,263222,京都府,久御山町,5,2,決算収支の状況,2,令和3年度,8595579,8147317,448262,45871,402391,99567,370998,0,0,470565
2022,61,263435,京都府,井手町,5,2,決算収支の状況,2,令和3年度,6225357,5838398,386959,17892,369067,4991,6436,660468,0,671895
2022,61,263443,京都府,宇治田原町,5,2,決算収支の状況,2,令和3年度,5739111,5513011,226100,24166,201934,34920,90146,0,70000,55066
2022,61,263648,京都府,笠置町,5,2,決算収支の状況,2,令和3年度,1750773,1638749,112024,9171,102853,92057,10013,0,0,102070
2022,61,263656,京都府,和束町,5,2,決算収支の状況,2,令和3年度,3838790,3781490,57300,16957,40343,-2755,21561,0,0,18806
2022,61,263664,京都府,精華町,5,2,決算収支の状況,2,令和3年度,15803929,15464211,339718,113308,226410,101982,100092,0,0,202074
2022,61,263672,京都府,南山城村,5,2,決算収支の状況,2,令和3年度,2872748,2790166,82582,17104,65478,15638,96626,1575,0,113839
2022,61,264075,京都府,京丹波町,5,2,決算収支の状況,2,令和3年度,14017791,13620348,397443,31700,365743,218607,80196,199861,0,498664
2022,61,264636,京都府,伊根町,5,2,決算収支の状況,2,令和3年度,3730947,3413828,317119,114040,203079,-3304,104173,98782,46704,152947
2022,61,264652,京都府,与謝野町,5,2,決算収支の状況,2,令和3年度,13433552,13110725,322827,306698,16129,3644,709,5574,0,9927
2022,61,268020,京都府,与謝野町宮津市中学校組合,6,2,決算収支の状況,2,令和3年度,180548,169713,10835,0,10835,951,0,0,0,951
2022,61,268038,京都府,加茂笠置組合,7,2,決算収支の状況,2,令和3年度,0,0,0,0,0,0,0,0,0,0
2022,61,268160,京都府,亀岡市及び南丹市財産区組合,7,2,決算収支の状況,2,令和3年度,0,0,0,0,0,0,0,0,0,0
2022,61,268178,京都府,船井郡衛生管理組合,6,2,決算収支の状況,2,令和3年度,1744579,1703461,41118,1800,39318,-2562,4000,0,0,1438
2022,61,268208,京都府,城南衛生管理組合,6,2,決算収支の状況,2,令和3年度,4533559,4473294,60265,2382,57883,-4369,31188,0,0,26819
2022,61,268216,京都府,木津川市精華町環境施設組合,6,2,決算収支の状況,2,令和3年度,531590,524879,6711,0,6711,734,81,0,0,815
2022,61,268224,京都府,京都府市町村職員退職手当組合,6,2,決算収支の状況,2,令和3年度,3965804,3752064,213740,0,213740,83687,0,0,0,83687
2022,61,268283,京都府,乙訓環境衛生組合,6,2,決算収支の状況,2,令和3年度,1635095,1616848,18247,0,18247,-1432,78944,0,56100,21412
2022,61,268305,京都府,桂川・小畑川水防事務組合,6,2,決算収支の状況,2,令和3年度,20359,14979,5380,0,5380,2221,1001,0,0,3222
2022,61,268313,京都府,澱川右岸水防事務組合,6,2,決算収支の状況,2,令和3年度,23489,19963,3526,0,3526,1356,601,0,0,1957
2022,61,268348,京都府,淀川・木津川水防事務組合,6,2,決算収支の状況,2,令和3年度,13799,8848,4951,0,4951,1130,1000,0,0,2130
2022,61,268364,京都府,京都府市町村議会議員公務災害補償等組合,6,2,決算収支の状況,2,令和3年度,2730,1024,1706,0,1706,-62,0,0,0,-62
2022,61,268411,京都府,相楽中部消防組合,6,2,決算収支の状況,2,令和3年度,1440943,1400357,40586,0,40586,-8694,0,0,0,-8694
2022,61,268445,京都府,乙訓福祉施設事務組合,6,2,決算収支の状況,2,令和3年度,470221,450345,19876,0,19876,3715,0,0,0,3715
2022,61,268470,京都府,宮津与謝消防組合,6,2,決算収支の状況,2,令和3年度,861441,826834,34607,0,34607,-1480,0,0,0,-1480
2022,61,268496,京都府,相楽郡広域事務組合,6,2,決算収支の状況,2,令和3年度,291838,282513,9325,0,9325,-4725,0,0,0,-4725
2022,61,268500,京都府,京都中部広域消防組合,6,2,決算収支の状況,2,令和3年度,2221930,2205128,16802,0,16802,-11564,17,0,0,-11547
2022,61,268542,京都府,京都府自治会館管理組合,6,2,決算収支の状況,2,令和3年度,97277,93704,3573,0,3573,-2753,0,0,0,-2753
2022,61,268569,京都府,京都府住宅新築資金等貸付事業管理組合,6,2,決算収支の状況,2,令和3年度,833601,258355,575246,0,575246,-136074,0,0,0,-136074
2022,61,268577,京都府,乙訓消防組合,6,2,決算収支の状況,2,令和3年度,2617757,2521705,96052,0,96052,81804,11,0,0,81815
2022,61,268585,京都府,京都府後期高齢者医療広域連合,7,2,決算収支の状況,2,令和3年度,1476185,1261351,214834,0,214834,130286,16,0,470907,-340605
2022,61,268593,京都府,相楽東部広域連合,6,2,決算収支の状況,2,令和3年度,822815,800279,22536,0,22536,15794,0,0,0,15794
2022,61,268607,京都府,京都地方税機構,6,2,決算収支の状況,2,令和3年度,2494766,2493791,975,0,975,-288,0,0,0,-288
2022,61,268615,京都府,宮津与謝環境組合,6,2,決算収支の状況,2,令和3年度,504124,475487,28637,0,28637,-3150,0,0,0,-3150
2022,61,271004,大阪府,大阪市,1,2,決算収支の状況,2,令和3年度,2003680509,1962155183,41525326,10728862,30796464,17755435,46706101,0,357640,64103896
2022,61,271403,大阪府,堺市,1,2,決算収支の状況,2,令和3年度,469487091,461227663,8259428,967248,7292180,5862344,10241007,0,2633520,13469831
2022,61,272027,大阪府,岸和田市,9,2,決算収支の状況,2,令和3年度,87757768,85320446,2437322,160975,2276347,1476636,1770365,0,0,3247001
2022,61,272035,大阪府,豊中市,8,2,決算収支の状況,2,令和3年度,182548599,176619691,5928908,402821,5526087,1722724,4700880,0,0,6423604
2022,61,272043,大阪府,池田市,3,2,決算収支の状況,2,令和3年度,43631137,42864482,766655,255843,510812,280128,1704,0,0,281832
2022,61,272051,大阪府,吹田市,8,2,決算収支の状況,2,令和3年度,154367159,151237056,3130103,516460,2613643,2178739,220822,0,0,2399561
2022,61,272060,大阪府,泉大津市,4,2,決算収支の状況,2,令和3年度,35384350,34708413,675937,331397,344540,-3914,974260,0,0,970346
2022,61,272078,大阪府,高槻市,8,2,決算収支の状況,2,令和3年度,150325713,145995891,4329822,1755185,2574637,1954599,2855828,0,0,4810427
2022,61,272086,大阪府,貝塚市,4,2,決算収支の状況,2,令和3年度,43137302,42894217,243085,86906,156179,62555,1024760,27650,0,1114965
2022,61,272094,大阪府,守口市,3,2,決算収支の状況,2,令和3年度,73641180,71534127,2107053,22212,2084841,187146,110452,2044925,0,2342523
2022,61,272108,大阪府,枚方市,8,2,決算収支の状況,2,令和3年度,166805294,162745824,4059470,1601894,2457576,763901,936405,289560,0,1989866
2022,61,272116,大阪府,茨木市,9,2,決算収支の状況,2,令和3年度,112299867,110093054,2206813,1261069,945744,-168375,600560,0,300000,132185
2022,61,272124,大阪府,八尾市,8,2,決算収支の状況,2,令和3年度,122733969,121856292,877677,327826,549851,132955,426248,172165,0,731368
2022,61,272132,大阪府,泉佐野市,3,2,決算収支の状況,2,令和3年度,70520926,70068150,452776,67775,385001,249289,68050,0,0,317339
2022,61,272141,大阪府,富田林市,3,2,決算収支の状況,2,令和3年度,48565721,47591131,974590,118362,856228,153037,812320,686067,0,1651424
2022,61,272159,大阪府,寝屋川市,8,2,決算収支の状況,2,令和3年度,104492094,103209266,1282828,148103,1134725,-578162,1656472,0,1466725,-388415
2022,61,272167,大阪府,河内長野市,3,2,決算収支の状況,2,令和3年度,40509972,40448230,61742,42261,19481,2619,24800,0,0,27419
2022,61,272175,大阪府,松原市,3,2,決算収支の状況,2,令和3年度,50925438,49877058,1048380,2411,1045969,383281,1829976,0,6925,2206332
2022,61,272183,大阪府,大東市,3,2,決算収支の状況,2,令和3年度,54005151,52567840,1437311,8964,1428347,340982,241336,0,0,582318
2022,61,272191,大阪府,和泉市,3,2,決算収支の状況,2,令和3年度,76179579,75426109,753470,107182,646288,362541,150640,0,0,513181
2022,61,272205,大阪府,箕面市,3,2,決算収支の状況,2,令和3年度,83658839,77209335,6449504,4983096,1466408,-901882,35683,0,0,-866199
2022,61,272213,大阪府,柏原市,4,2,決算収支の状況,2,令和3年度,30750306,29562106,1188200,19169,1169031,679519,251007,150,13298,917378
2022,61,272221,大阪府,羽曳野市,3,2,決算収支の状況,2,令和3年度,45884969,45315757,569212,0,569212,466573,922326,0,0,1388899
2022,61,272230,大阪府,門真市,3,2,決算収支の状況,2,令和3年度,63129487,62397626,731861,242766,489095,138886,547327,0,0,686213
2022,61,272248,大阪府,摂津市,4,2,決算収支の状況,2,令和3年度,45401657,44750128,651529,117216,534313,215514,1452891,0,0,1668405
2022,61,272256,大阪府,高石市,4,2,決算収支の状況,2,令和3年度,28542338,27306762,1235576,49975,1185601,872758,170591,0,9036,1034313
2022,61,272264,大阪府,藤井寺市,4,2,決算収支の状況,2,令和3年度,26436000,26006336,429664,12525,417139,355220,857,0,0,356077
2022,61,272272,大阪府,東大阪市,8,2,決算収支の状況,2,令和3年度,233182226,229635436,3546790,254745,3292045,98657,4095700,22,3000000,1194379
2022,61,272281,大阪府,泉南市,4,2,決算収支の状況,2,令和3年度,27297488,26577405,720083,14322,705761,321530,321884,0,0,643414
2022,61,272299,大阪府,四條畷市,4,2,決算収支の状況,2,令和3年度,23367906,22950914,416992,125086,291906,118024,310247,0,0,428271
2022,61,272302,大阪府,交野市,4,2,決算収支の状況,2,令和3年度,31703468,31093828,609640,158634,451006,72579,193858,352928,3396,615969
2022,61,272311,大阪府,大阪狭山市,4,2,決算収支の状況,2,令和3年度,23200352,22365988,834364,11559,822805,662101,1149,0,0,663250
2022,61,272329,大阪府,阪南市,4,2,決算収支の状況,2,令和3年度,21547054,21119573,427481,7943,419538,46187,273658,0,0,319845
2022,61,273015,大阪府,島本町,5,2,決算収支の状況,2,令和3年度,14044562,13661952,382610,102628,279982,226956,238614,0,38299,427271
2022,61,273210,大阪府,豊能町,5,2,決算収支の状況,2,令和3年度,8484819,7843760,641059,235955,405104,216995,195505,0,300000,112500
2022,61,273228,大阪府,能勢町,5,2,決算収支の状況,2,令和3年度,6246187,5865440,380747,67785,312962,142157,380210,0,200000,322367
2022,61,273414,大阪府,忠岡町,5,2,決算収支の状況,2,令和3年度,8062512,7496811,565701,17658,548043,537913,66981,0,0,604894
2022,61,273619,大阪府,熊取町,5,2,決算収支の状況,2,令和3年度,18231728,17355711,876017,261738,614279,563483,26000,0,0,589483
2022,61,273627,大阪府,田尻町,5,2,決算収支の状況,2,令和3年度,6694441,6097947,596494,44709,551785,148940,507073,0,0,656013
2022,61,273660,大阪府,岬町,5,2,決算収支の状況,2,令和3年度,7944031,7845986,98045,26262,71783,4362,96029,0,0,100391
2022,61,273813,大阪府,太子町,5,2,決算収支の状況,2,令和3年度,6480563,6272491,208072,26673,181399,126953,27704,0,0,154657
2022,61,273821,大阪府,河南町,5,2,決算収支の状況,2,令和3年度,6949224,6766335,182889,6001,176888,56047,281,0,0,56328
2022,61,273830,大阪府,千早赤阪村,5,2,決算収支の状況,2,令和3年度,3463339,3343672,119667,13953,105714,83405,153021,0,0,236426
2022,61,278084,大阪府,恩智川水防事務組合,6,2,決算収支の状況,2,令和3年度,22801,20209,2592,0,2592,430,0,0,0,430
2022,61,278092,大阪府,淀川左岸水防事務組合,6,2,決算収支の状況,2,令和3年度,161955,159026,2929,0,2929,136,0,0,0,136
2022,61,278106,大阪府,大和川右岸水防事務組合,6,2,決算収支の状況,2,令和3年度,97672,94386,3286,0,3286,-850,3605,0,0,2755
2022,61,278122,大阪府,淀川右岸水防事務組合,6,2,決算収支の状況,2,令和3年度,131067,126488,4579,0,4579,445,0,0,0,445
2022,61,278149,大阪府,守口市門真市消防組合,6,2,決算収支の状況,2,令和3年度,3957015,3937521,19494,6530,12964,-9746,0,0,0,-9746
2022,61,278157,大阪府,枚方寝屋川消防組合,6,2,決算収支の状況,2,令和3年度,7253200,7201972,51228,0,51228,-41741,0,0,0,-41741
2022,61,278165,大阪府,柏原羽曳野藤井寺消防組合,6,2,決算収支の状況,2,令和3年度,3123000,3116649,6351,0,6351,-12891,0,0,0,-12891
2022,61,278246,大阪府,八尾市柏原市火葬場組合,6,2,決算収支の状況,2,令和3年度,1119,930,189,0,189,21,0,0,0,21
2022,61,278254,大阪府,泉大津市、和泉市墓地組合,6,2,決算収支の状況,2,令和3年度,39180,33879,5301,0,5301,1913,3388,0,10132,-4831
2022,61,278262,大阪府,高石市泉大津市墓地組合,6,2,決算収支の状況,2,令和3年度,91006,69486,21520,0,21520,6594,0,0,0,6594
2022,61,278271,大阪府,豊中市伊丹市クリーンランド,6,2,決算収支の状況,2,令和3年度,4411057,3646579,764478,0,764478,108315,0,0,0,108315
2022,61,278289,大阪府,泉北環境整備施設組合,6,2,決算収支の状況,2,令和3年度,2856512,2692874,163638,0,163638,25958,0,0,0,25958
2022,61,278319,大阪府,柏羽藤環境事業組合,6,2,決算収支の状況,2,令和3年度,2711804,2505583,206221,98630,107591,45164,0,0,0,45164
2022,61,278327,大阪府,飯盛霊園組合,6,2,決算収支の状況,2,令和3年度,983377,850226,133151,4708,128443,21684,0,0,0,21684
2022,61,278335,大阪府,泉佐野市田尻町清掃施設組合,6,2,決算収支の状況,2,令和3年度,1466748,1466748,0,0,0,0,0,0,0,0
2022,61,278343,大阪府,東大阪都市清掃施設組合,6,2,決算収支の状況,2,令和3年度,4340127,4214824,125303,0,125303,36161,0,0,0,36161
2022,61,278351,大阪府,四條畷市交野市清掃施設組合,6,2,決算収支の状況,2,令和3年度,1771949,1657400,114549,75900,38649,10036,0,0,0,10036
2022,61,278360,大阪府,岸和田市貝塚市清掃施設組合,6,2,決算収支の状況,2,令和3年度,3625723,3552519,73204,40665,32539,-2644,0,0,0,-2644
2022,61,278378,大阪府,南河内環境事業組合,6,2,決算収支の状況,2,令和3年度,4073459,3931678,141781,0,141781,18585,0,0,0,18585
2022,61,278386,大阪府,泉南清掃事務組合,6,2,決算収支の状況,2,令和3年度,1296366,1217113,79253,0,79253,40302,0,0,0,40302
2022,61,278408,大阪府,大阪府都市競艇企業団,7,2,決算収支の状況,2,令和3年度,0,0,0,0,0,0,0,0,0,0
2022,61,278530,大阪府,藤井寺市柏原市学校給食組合,6,2,決算収支の状況,2,令和3年度,654523,648223,6300,0,6300,465,0,0,0,465
2022,61,278599,大阪府,豊能郡環境施設組合,6,2,決算収支の状況,2,令和3年度,79078,47685,31393,0,31393,25280,0,0,0,25280
2022,61,278645,大阪府,くすのき広域連合,7,2,決算収支の状況,2,令和3年度,0,0,0,0,0,0,0,0,0,0
2022,61,278661,大阪府,北河内４市リサイクル施設組合,6,2,決算収支の状況,2,令和3年度,404143,399092,5051,0,5051,228,0,0,0,228
2022,61,278670,大阪府,大阪府後期高齢者医療広域連合,7,2,決算収支の状況,2,令和3年度,218828,194581,24247,0,24247,9681,0,0,0,9681
2022,61,278696,大阪府,関西広域連合,6,2,決算収支の状況,2,令和3年度,2566407,2493345,73062,0,73062,11304,30880,0,30880,11304
2022,61,278700,大阪府,泉州南消防組合,6,2,決算収支の状況,2,令和3年度,3870496,3870496,0,0,0,0,0,0,0,0
2022,61,278718,大阪府,大東四條畷消防組合,6,2,決算収支の状況,2,令和3年度,2077665,2056615,21050,0,21050,-2492,0,0,0,-2492
2022,61,278726,大阪府,大阪広域環境施設組合,6,2,決算収支の状況,2,令和3年度,19239873,19239873,0,0,0,0,0,0,0,0
2022,61,278734,大阪府,枚方京田辺環境施設組合,6,2,決算収支の状況,2,令和3年度,125497,125447,50,0,50,-116,0,0,0,-116
2022,61,281000,兵庫県,神戸市,1,2,決算収支の状況,2,令和3年度,977468532,963657618,13810914,12774382,1036532,736585,6300101,0,0,7036686
2022,61,282014,兵庫県,姫路市,8,2,決算収支の状況,2,令和3年度,242696192,233327010,9369182,3873153,5496029,640188,1004333,1018240,0,2662761
2022,61,282022,兵庫県,尼崎市,8,2,決算収支の状況,2,令和3年度,230541291,227038270,3503021,643736,2859285,2401547,2084776,5890500,0,10376823
2022,61,282031,兵庫県,明石市,8,2,決算収支の状況,2,令和3年度,130967862,128443773,2524089,930761,1593328,-432304,862718,0,0,430414
2022,61,282049,兵庫県,西宮市,8,2,決算収支の状況,2,令和3年度,210263509,204699404,5564105,301612,5262493,513957,2372575,0,0,2886532
2022,61,282057,兵庫県,洲本市,4,2,決算収支の状況,2,令和3年度,39552937,38883260,669677,82241,587436,484850,60770,372927,0,918547
2022,61,282065,兵庫県,芦屋市,4,2,決算収支の状況,2,令和3年度,48164431,44187138,3977293,385914,3591379,1989885,1171760,0,0,3161645
2022,61,282073,兵庫県,伊丹市,3,2,決算収支の状況,2,令和3年度,96044530,93970500,2074030,969017,1105013,-67815,1036337,720300,113921,1574901
2022,61,282081,兵庫県,相生市,4,2,決算収支の状況,2,令和3年度,14775951,14263105,512846,46507,466339,95514,508750,0,100000,504264
2022,61,282090,兵庫県,豊岡市,4,2,決算収支の状況,2,令和3年度,54719711,52885783,1833928,138019,1695909,485846,1074590,0,810960,749476
2022,61,282103,兵庫県,加古川市,9,2,決算収支の状況,2,令和3年度,106412628,105551892,860736,564079,296657,22386,104547,0,0,126933
2022,61,282120,兵庫県,赤穂市,4,2,決算収支の状況,2,令和3年度,23378898,22606676,772222,40641,731581,462494,268577,0,0,731071
2022,61,282138,兵庫県,西脇市,4,2,決算収支の状況,2,令和3年度,22631459,21796446,835013,61073,773940,603132,1776,0,0,604908
2022,61,282146,兵庫県,宝塚市,9,2,決算収支の状況,2,令和3年度,93911813,91020766,2891047,507685,2383362,870836,757794,0,0,1628630
2022,61,282154,兵庫県,三木市,4,2,決算収支の状況,2,令和3年度,37044106,36050823,993283,55809,937474,845292,46002,0,0,891294
2022,61,282162,兵庫県,高砂市,4,2,決算収支の状況,2,令和3年度,52442192,50287985,2154207,87609,2066598,952625,557071,0,158017,1351679
2022,61,282171,兵庫県,川西市,3,2,決算収支の状況,2,令和3年度,63635833,62221485,1414348,54769,1359579,603305,89601,0,0,692906
2022,61,282189,兵庫県,小野市,4,2,決算収支の状況,2,令和3年度,23283281,22177690,1105591,320015,785576,393241,11500,0,0,404741
2022,61,282197,兵庫県,三田市,3,2,決算収支の状況,2,令和3年度,43480443,41664455,1815988,919531,896457,424616,375962,0,0,800578
2022,61,282201,兵庫県,加西市,4,2,決算収支の状況,2,令和3年度,28928717,27860286,1068431,79794,988637,293602,1235774,0,0,1529376
2022,61,282219,兵庫県,丹波篠山市,4,2,決算収支の状況,2,令和3年度,24027827,23460470,567357,66473,500884,61449,46,2433,0,63928
2022,61,282227,兵庫県,養父市,4,2,決算収支の状況,2,令和3年度,21397641,20183903,1213738,117121,1096617,337794,2527,212321,0,552642
2022,61,282235,兵庫県,丹波市,4,2,決算収支の状況,2,令和3年度,39002738,36836472,2166266,223815,1942451,310517,10540,650000,0,971057
2022,61,282243,兵庫県,南あわじ市,4,2,決算収支の状況,2,令和3年度,31802923,30539268,1263655,92144,1171511,510432,7705,453120,0,971257
2022,61,282251,兵庫県,朝来市,4,2,決算収支の状況,2,令和3年度,22607618,21458603,1149015,192262,956753,173176,2378,694593,0,870147
2022,61,282260,兵庫県,淡路市,4,2,決算収支の状況,2,令和3年度,34039463,33024450,1015013,116745,898268,680081,114155,0,0,794236
2022,61,282278,兵庫県,宍粟市,4,2,決算収支の状況,2,令和3年度,26053324,25186557,866767,43240,823527,-16021,3110,1210694,0,1197783
2022,61,282286,兵庫県,加東市,4,2,決算収支の状況,2,令和3年度,26432419,25795623,636796,69312,567484,-50736,8093,0,0,-42643
2022,61,282294,兵庫県,たつの市,4,2,決算収支の状況,2,令和3年度,41789337,40056861,1732476,244068,1488408,285786,823000,351981,36637,1424130
2022,61,283011,兵庫県,猪名川町,5,2,決算収支の状況,2,令和3年度,12927129,12489505,437624,42828,394796,60202,464565,0,326184,198583
2022,61,283657,兵庫県,多可町,5,2,決算収支の状況,2,令和3年度,13122904,12909755,213149,51620,161529,-210367,3099,102708,0,-104560
2022,61,283819,兵庫県,稲美町,5,2,決算収支の状況,2,令和3年度,14650927,13625953,1024974,81999,942975,373372,542098,0,0,915470
2022,61,283827,兵庫県,播磨町,5,2,決算収支の状況,2,令和3年度,16210526,15184888,1025638,178933,846705,144807,231473,0,0,376280
2022,61,284424,兵庫県,市川町,5,2,決算収支の状況,2,令和3年度,7256830,7101339,155491,5078,150413,-985,238419,0,0,237434
2022,61,284432,兵庫県,福崎町,5,2,決算収支の状況,2,令和3年度,9712828,9412908,299920,47858,252062,5863,323600,0,0,329463
2022,61,284467,兵庫県,神河町,5,2,決算収支の状況,2,令和3年度,9116071,8913123,202948,26145,176803,-100945,379988,0,350,278693
2022,61,284645,兵庫県,太子町,5,2,決算収支の状況,2,令和3年度,13893328,13317874,575454,68601,506853,-85406,482529,0,0,397123
2022,61,284815,兵庫県,上郡町,5,2,決算収支の状況,2,令和3年度,9044349,8682765,361584,7723,353861,194224,72539,108317,0,375080
2022,61,285013,兵庫県,佐用町,5,2,決算収支の状況,2,令和3年度,13163394,13022533,140861,8105,132756,-21955,5006,1157881,30565,1110367
2022,61,285854,兵庫県,香美町,5,2,決算収支の状況,2,令和3年度,15832400,15106794,725606,182648,542958,224092,361742,338,122940,463232
2022,61,285862,兵庫県,新温泉町,5,2,決算収支の状況,2,令和3年度,12269967,11339416,930551,186748,743803,267921,1741,0,120000,149662
2022,61,288012,兵庫県,兵庫県市町村職員退職手当組合,6,2,決算収支の状況,2,令和3年度,12683267,10354994,2328273,0,2328273,-147039,0,0,0,-147039
2022,61,288101,兵庫県,北播衛生事務組合,6,2,決算収支の状況,2,令和3年度,735766,698661,37105,0,37105,21912,0,0,0,21912
2022,61,288128,兵庫県,北播磨こども発達支援センター事務組合わかあゆ園,6,2,決算収支の状況,2,令和3年度,113693,107509,6184,0,6184,-2467,87,0,0,-2380
2022,61,288179,兵庫県,揖龍保健衛生施設事務組合,6,2,決算収支の状況,2,令和3年度,1792862,1738372,54490,0,54490,-26218,24691,0,20000,-21527
2022,61,288195,兵庫県,加古川市外２市共有公会堂事務組合,6,2,決算収支の状況,2,令和3年度,5550,0,5550,0,5550,2586,0,0,0,2586
2022,61,288209,兵庫県,市川町外三ヶ市町共有財産事務組合,6,2,決算収支の状況,2,令和3年度,23575,22661,914,0,914,-40,4611,0,7972,-3401
2022,61,288268,兵庫県,洲本市・南あわじ市山林事務組合,6,2,決算収支の状況,2,令和3年度,2265,1637,628,0,628,-15,0,0,0,-15
2022,61,288284,兵庫県,南あわじ市・洲本市小中学校組合,6,2,決算収支の状況,2,令和3年度,163381,156957,6424,585,5839,-5947,0,0,0,-5947
2022,61,288535,兵庫県,中播衛生施設事務組合,6,2,決算収支の状況,2,令和3年度,235883,225340,10543,0,10543,2175,15,0,0,2190
2022,61,288691,兵庫県,氷上多可衛生事務組合,6,2,決算収支の状況,2,令和3年度,212653,203130,9523,0,9523,-5502,10290,0,0,4788
2022,61,288811,兵庫県,兵庫県町議会議員公務災害補償組合,6,2,決算収支の状況,2,令和3年度,12071,10960,1111,0,1111,7,0,0,0,7
2022,61,288900,兵庫県,洲本市・南あわじ市衛生事務組合,6,2,決算収支の状況,2,令和3年度,404940,395429,9511,0,9511,201,0,0,0,201
2022,61,289027,兵庫県,加古郡衛生事務組合,6,2,決算収支の状況,2,令和3年度,511855,476431,35424,0,35424,350,0,0,0,350
2022,61,289035,兵庫県,播磨内陸医務事業組合,6,2,決算収支の状況,2,令和3年度,147293,140507,6786,0,6786,916,39,0,0,955
2022,61,289043,兵庫県,淡路広域行政事務組合,6,2,決算収支の状況,2,令和3年度,332790,304487,28303,0,28303,1175,13400,0,0,14575
2022,61,289051,兵庫県,南但広域行政事務組合,6,2,決算収支の状況,2,令和3年度,2288280,2250700,37580,6600,30980,-6429,1,0,5428,-11856
2022,61,289060,兵庫県,淡路広域消防事務組合,6,2,決算収支の状況,2,令和3年度,2032350,2006226,26124,0,26124,-3735,324,19982,0,16571
2022,61,289191,兵庫県,丹波少年自然の家事務組合,6,2,決算収支の状況,2,令和3年度,169300,158683,10617,0,10617,-396,0,0,0,-396
2022,61,289205,兵庫県,西脇多可行政事務組合,6,2,決算収支の状況,2,令和3年度,1379043,1329251,49792,5439,44353,-15284,87,0,0,-15197
2022,61,289221,兵庫県,兵庫県競馬組合,7,2,決算収支の状況,2,令和3年度,0,0,0,0,0,0,0,0,0,0
2022,61,289230,兵庫県,美方郡広域事務組合,6,2,決算収支の状況,2,令和3年度,776947,769826,7121,0,7121,-122,36,0,0,-86
2022,61,289256,兵庫県,中播北部行政事務組合,6,2,決算収支の状況,2,令和3年度,607275,574059,33216,8497,24719,-3185,0,0,0,-3185
2022,61,289264,兵庫県,姫路福崎斎苑施設事務組合,6,2,決算収支の状況,2,令和3年度,44216,40771,3445,0,3445,-316,0,0,0,-316
2022,61,289329,兵庫県,小野加東加西環境施設事務組合,6,2,決算収支の状況,2,令和3年度,662127,648166,13961,0,13961,-9092,0,0,0,-9092
2022,61,289515,兵庫県,くれさか環境事務組合,6,2,決算収支の状況,2,令和3年度,946875,893513,53362,0,53362,11648,90062,0,260000,-158290
2022,61,289558,兵庫県,北但行政事務組合,6,2,決算収支の状況,2,令和3年度,741341,712859,28482,0,28482,12302,0,0,0,12302
2022,61,289566,兵庫県,但馬広域行政事務組合,6,2,決算収支の状況,2,令和3年度,124652,121973,2679,0,2679,546,998,0,0,1544
2022,61,289591,兵庫県,小野加東広域事務組合,6,2,決算収支の状況,2,令和3年度,100114,76681,23433,0,23433,10863,0,0,0,10863
2022,61,289612,兵庫県,播磨高原広域事務組合（普通会計分）,6,2,決算収支の状況,2,令和3年度,403835,384013,19822,0,19822,-354,0,0,0,-354
2022,61,289671,兵庫県,猪名川上流広域ごみ処理施設組合,6,2,決算収支の状況,2,令和3年度,2791996,2673407,118589,1085,117504,2926,0,0,0,2926
2022,61,289701,兵庫県,にしはりま環境事務組合,6,2,決算収支の状況,2,令和3年度,1463271,1441487,21784,0,21784,-16318,0,0,0,-16318
2022,61,289710,兵庫県,兵庫県後期高齢者医療広域連合（普通会計分）,6,2,決算収支の状況,2,令和3年度,661221,535213,126008,0,126008,-247119,0,0,0,-247119
2022,61,289728,兵庫県,兵庫県後期高齢者医療広域連合（事業会計分）,7,2,決算収支の状況,2,令和3年度,0,0,0,0,0,0,0,0,0,0
2022,61,289752,兵庫県,北はりま消防組合,6,2,決算収支の状況,2,令和3年度,2703588,2675967,27621,0,27621,-1760,11,0,0,-1749
2022,61,289761,兵庫県,西はりま消防組合,6,2,決算収支の状況,2,令和3年度,2792171,2730419,61752,0,61752,-36405,0,0,0,-36405
2022,61,292010,奈良県,奈良市,8,2,決算収支の状況,2,令和3年度,158144190,151594071,6550119,1050123,5499996,3209200,67,0,0,3209267
2022,61,292028,奈良県,大和高田市,4,2,決算収支の状況,2,令和3年度,32391509,30909488,1482021,73090,1408931,1372834,10,5073,0,1377917
2022,61,292036,奈良県,大和郡山市,4,2,決算収支の状況,2,令和3年度,42263329,41421927,841402,41142,800260,358622,500428,0,0,859050
2022,61,292044,奈良県,天理市,4,2,決算収支の状況,2,令和3年度,31977154,29884551,2092603,105421,1987182,848399,31,0,548942,299488
2022,61,292052,奈良県,橿原市,3,2,決算収支の状況,2,令和3年度,49371557,46473641,2897916,375009,2522907,1302123,610571,0,0,1912694
2022,61,292061,奈良県,桜井市,4,2,決算収支の状況,2,令和3年度,26874455,25755117,1119338,16819,1102519,550065,800000,0,212970,1137095
2022,61,292079,奈良県,五條市,4,2,決算収支の状況,2,令和3年度,24479975,23745849,734126,64899,669227,-93831,382094,290983,0,579246
2022,61,292087,奈良県,御所市,4,2,決算収支の状況,2,令和3年度,17407439,16251171,1156268,5638,1150630,805379,175262,0,0,980641
2022,61,292095,奈良県,生駒市,3,2,決算収支の状況,2,令和3年度,46539959,43291233,3248726,68707,3180019,1369148,615,0,0,1369763
2022,61,292109,奈良県,香芝市,4,2,決算収支の状況,2,令和3年度,30883052,29868617,1014435,176454,837981,-108498,19333,128091,0,38926
2022,61,292117,奈良県,葛城市,4,2,決算収支の状況,2,令和3年度,17873359,17107565,765794,48055,717739,627156,45137,0,0,672293
2022,61,292125,奈良県,宇陀市,4,2,決算収支の状況,2,令和3年度,19755536,19318292,437244,43605,393639,263156,345775,0,0,608931
2022,61,293229,奈良県,山添村,5,2,決算収支の状況,2,令和3年度,3801596,3582103,219493,31487,188006,-45522,138837,0,0,93315
2022,61,293423,奈良県,平群町,5,2,決算収支の状況,2,令和3年度,8205132,7743294,461838,49483,412355,196216,112000,289431,0,597647
2022,61,293431,奈良県,三郷町,5,2,決算収支の状況,2,令和3年度,10949702,10103312,846390,44010,802380,224683,41698,0,0,266381
2022,61,293440,奈良県,斑鳩町,5,2,決算収支の状況,2,令和3年度,11281358,10433195,848163,52560,795603,279512,304737,0,1314,582935
2022,61,293458,奈良県,安堵町,5,2,決算収支の状況,2,令和3年度,3902686,3624873,277813,23763,254050,107518,98405,0,0,205923
2022,61,293610,奈良県,川西町,5,2,決算収支の状況,2,令和3年度,5580825,5236434,344391,47240,297151,48551,401,174566,0,223518
2022,61,293628,奈良県,三宅町,5,2,決算収支の状況,2,令和3年度,4393979,4168603,225376,730,224646,74151,20585,0,0,94736
2022,61,293636,奈良県,田原本町,5,2,決算収支の状況,2,令和3年度,14909620,14047320,862300,64850,797450,298112,557,0,0,298669
2022,61,293857,奈良県,曽爾村,5,2,決算収支の状況,2,令和3年度,2537269,2413840,123429,20209,103220,6424,651,0,0,7075
2022,61,293865,奈良県,御杖村,5,2,決算収支の状況,2,令和3年度,2972366,2794737,177629,9865,167764,-33046,412195,0,0,379149
2022,61,294012,奈良県,高取町,5,2,決算収支の状況,2,令和3年度,4423003,4369280,53723,20668,33055,1089,16018,0,0,17107
2022,61,294021,奈良県,明日香村,5,2,決算収支の状況,2,令和3年度,5236072,4837951,398121,300,397821,117135,50124,0,0,167259
2022,61,294241,奈良県,上牧町,5,2,決算収支の状況,2,令和3年度,9892038,9303676,588362,233800,354562,138181,188263,121912,159946,288410
2022,61,294250,奈良県,王寺町,5,2,決算収支の状況,2,令和3年度,17032719,16502301,530418,19528,510890,189381,574682,0,0,764063
2022,61,294268,奈良県,広陵町,5,2,決算収支の状況,2,令和3年度,15711111,15156764,554347,94286,460061,123716,439350,0,425989,137077
2022,61,294276,奈良県,河合町,5,2,決算収支の状況,2,令和3年度,7535236,7173276,361960,4666,357294,131621,450107,755,0,582483
2022,61,294411,奈良県,吉野町,5,2,決算収支の状況,2,令和3年度,7047463,6452184,595279,8297,586982,275111,180168,0,0,455279
2022,61,294420,奈良県,大淀町,5,2,決算収支の状況,2,令和3年度,9680993,9000368,680625,617823,62802,1194,16504,0,0,17698
2022,61,294438,奈良県,下市町,5,2,決算収支の状況,2,令和3年度,5437382,5077899,359483,37423,322060,60899,218077,0,0,278976
2022,61,294446,奈良県,黒滝村,5,2,決算収支の状況,2,令和3年度,1542530,1448361,94169,4311,89858,54496,116359,0,0,170855
2022,61,294462,奈良県,天川村,5,2,決算収支の状況,2,令和3年度,2672167,2446397,225770,1733,224037,21529,1355,0,0,22884
2022,61,294471,奈良県,野迫川村,5,2,決算収支の状況,2,令和3年度,1537179,1412568,124611,22606,102005,73912,4,0,0,73916
2022,61,294497,奈良県,十津川村,5,2,決算収支の状況,2,令和3年度,6691927,6127607,564320,147413,416907,350764,365,0,0,351129
2022,61,294501,奈良県,下北山村,5,2,決算収支の状況,2,令和3年度,2100331,2011723,88608,526,88082,-12236,61189,0,0,48953
2022,61,294519,奈良県,上北山村,5,2,決算収支の状況,2,令和3年度,1842525,1560041,282484,21634,260850,-3938,120000,0,0,116062
2022,61,294527,奈良県,川上村,5,2,決算収支の状況,2,令和3年度,3515767,3169048,346719,19215,327504,89180,10057,0,0,99237
2022,61,294535,奈良県,東吉野村,5,2,決算収支の状況,2,令和3年度,2788978,2484528,304450,13043,291407,150975,19,0,0,150994
2022,61,298026,奈良県,川西町・三宅町式下中学校組合,6,2,決算収支の状況,2,令和3年度,200622,150371,50251,677,49574,12749,0,0,0,12749
2022,61,298085,奈良県,老人福祉施設三室園組合,6,2,決算収支の状況,2,令和3年度,311113,282834,28279,0,28279,-5195,49,0,0,-5146
2022,61,298093,奈良県,奈良県葛城地区清掃事務組合,6,2,決算収支の状況,2,令和3年度,1379134,1379134,0,0,0,0,7535,0,7136,399
2022,61,298107,奈良県,宇陀衛生一部事務組合,6,2,決算収支の状況,2,令和3年度,115910,109735,6175,0,6175,998,5185,0,6898,-715
2022,61,298131,奈良県,奥山組合,7,2,決算収支の状況,2,令和3年度,0,0,0,0,0,0,0,0,0,0
2022,61,298140,奈良県,青葉山組合,7,2,決算収支の状況,2,令和3年度,0,0,0,0,0,0,0,0,0,0
2022,61,298166,奈良県,神野山組合,7,2,決算収支の状況,2,令和3年度,0,0,0,0,0,0,0,0,0,0
2022,61,298182,奈良県,奈良県市町村総合事務組合,6,2,決算収支の状況,2,令和3年度,4794943,4781359,13584,0,13584,-2240,0,0,0,-2240
2022,61,298239,奈良県,上・下北山衛生一部事務組合,6,2,決算収支の状況,2,令和3年度,131978,110760,21218,0,21218,-7784,0,0,0,-7784
2022,61,298280,奈良県,香芝・王寺環境施設組合,6,2,決算収支の状況,2,令和3年度,2586517,2552950,33567,0,33567,-23631,0,0,0,-23631
2022,61,298310,奈良県,王寺周辺広域休日応急診療施設組合,6,2,決算収支の状況,2,令和3年度,177076,155194,21882,0,21882,9910,3103,0,22729,-9716
2022,61,298344,奈良県,吉野広域行政組合,6,2,決算収支の状況,2,令和3年度,398710,337862,60848,0,60848,-7171,5004,0,0,-2167
2022,61,298352,奈良県,山辺環境衛生組合,6,2,決算収支の状況,2,令和3年度,119227,114094,5133,0,5133,-1147,1,0,0,-1146
2022,61,298361,奈良県,曽爾御杖行政一部事務組合,6,2,決算収支の状況,2,令和3年度,31084,29580,1504,0,1504,-1445,0,0,0,-1445
2022,61,298433,奈良県,南和広域衛生組合,6,2,決算収支の状況,2,令和3年度,438943,425123,13820,0,13820,-1524,0,0,0,-1524
2022,61,298441,奈良県,東宇陀環境衛生組合,6,2,決算収支の状況,2,令和3年度,205807,194343,11464,0,11464,-1075,1,0,0,-1074
2022,61,298450,奈良県,奈良広域水質検査センター組合,6,2,決算収支の状況,2,令和3年度,127243,120161,7082,0,7082,672,151,0,28000,-27177
2022,61,298468,奈良県,飛鳥広域行政事務組合,6,2,決算収支の状況,2,令和3年度,24546,13892,10654,0,10654,3185,0,0,0,3185
2022,61,298484,奈良県,桜井宇陀広域連合,6,2,決算収支の状況,2,令和3年度,83024,70068,12956,0,12956,-889,0,0,0,-889
2022,61,298492,奈良県,静香苑環境施設組合,6,2,決算収支の状況,2,令和3年度,243296,233026,10270,0,10270,-826,11096,0,10000,270
2022,61,298506,奈良県,奈良県住宅新築資金等貸付金回収管理組合,6,2,決算収支の状況,2,令和3年度,161627,157128,4499,0,4499,522,4000,0,0,4522
2022,61,298514,奈良県,奈良県後期高齢者医療広域連合,7,2,決算収支の状況,2,令和3年度,132054,87470,44584,0,44584,2618,0,0,0,2618
2022,61,298522,奈良県,やまと広域環境衛生事務組合,6,2,決算収支の状況,2,令和3年度,909244,909244,0,0,0,0,94907,0,24815,70092
2022,61,298549,奈良県,奈良県広域消防組合,6,2,決算収支の状況,2,令和3年度,15803050,14948342,854708,0,854708,340005,135137,0,1473247,-998105
2022,61,298557,奈良県,山辺・県北西部広域環境衛生組合,6,2,決算収支の状況,2,令和3年度,449393,420593,28800,0,28800,4778,2,0,35071,-30291
2022,61,298565,奈良県,さくら広域環境衛生組合,6,2,決算収支の状況,2,令和3年度,472164,343236,128928,0,128928,-59472,0,0,0,-59472
2022,61,298573,奈良県,まほろば環境衛生組合,6,2,決算収支の状況,2,令和3年度,300517,195840,104677,91454,13223,-804,0,0,0,-804
2022,61,302015,和歌山県,和歌山市,8,2,決算収支の状況,2,令和3年度,175561963,169535769,6026194,3607348,2418846,993503,3882229,40,0,4875772
2022,61,302023,和歌山県,海南市,4,2,決算収支の状況,2,令和3年度,26961912,25991995,969917,207820,762097,178321,307225,0,0,485546
2022,61,302031,和歌山県,橋本市,4,2,決算収支の状況,2,令和3年度,30580565,28995150,1585415,354804,1230611,106679,731,0,0,107410
2022,61,302040,和歌山県,有田市,4,2,決算収支の状況,2,令和3年度,22314561,21728977,585584,128505,457079,222929,201,0,0,223130
2022,61,302058,和歌山県,御坊市,4,2,決算収支の状況,2,令和3年度,16033496,14853620,1179876,148174,1031702,697778,175449,0,0,873227
2022,61,302066,和歌山県,田辺市,4,2,決算収支の状況,2,令和3年度,50423983,47680686,2743297,414163,2329134,654769,500127,1297,0,1156193
2022,61,302074,和歌山県,新宮市,4,2,決算収支の状況,2,令和3年度,23846020,22254792,1591228,68257,1522971,118723,100000,490000,0,708723
2022,61,302082,和歌山県,紀の川市,4,2,決算収支の状況,2,令和3年度,32986441,31323224,1663217,547385,1115832,198875,9069,0,113756,94188
2022,61,302091,和歌山県,岩出市,4,2,決算収支の状況,2,令和3年度,21291119,20650894,640225,138147,502078,264,587201,111841,120604,578702
2022,61,303046,和歌山県,紀美野町,5,2,決算収支の状況,2,令和3年度,8682674,7906340,776334,62167,714167,195732,279482,249747,158627,566334
2022,61,303411,和歌山県,かつらぎ町,5,2,決算収支の状況,2,令和3年度,12203344,11811617,391727,15663,376064,91927,554065,0,0,645992
2022,61,303437,和歌山県,九度山町,5,2,決算収支の状況,2,令和3年度,4135694,4049817,85877,7371,78506,-23350,300086,0,0,276736
2022,61,303445,和歌山県,高野町,5,2,決算収支の状況,2,令和3年度,5434362,5196491,237871,110836,127035,-405,465329,0,13600,451324
2022,61,303615,和歌山県,湯浅町,5,2,決算収支の状況,2,令和3年度,12694986,12118445,576541,115573,460968,-17465,515836,0,0,498371
2022,61,303623,和歌山県,広川町,5,2,決算収支の状況,2,令和3年度,5971763,5648783,322980,232862,90118,-4110,151611,125722,0,273223
2022,61,303666,和歌山県,有田川町,5,2,決算収支の状況,2,令和3年度,18351318,17713590,637728,165287,472441,110603,5587,0,0,116190
2022,61,303810,和歌山県,美浜町,5,2,決算収支の状況,2,令和3年度,5127400,4778731,348669,12353,336316,134039,432340,0,270000,296379
2022,61,303828,和歌山県,日高町,5,2,決算収支の状況,2,令和3年度,5685445,5162253,523192,144433,378759,95015,77340,0,133417,38938
2022,61,303836,和歌山県,由良町,5,2,決算収支の状況,2,令和3年度,4395381,4092228,303153,10844,292309,103578,282875,0,0,386453
2022,61,303909,和歌山県,印南町,5,2,決算収支の状況,2,令和3年度,7086739,6767391,319348,115959,203389,20618,99818,0,0,120436
2022,61,303917,和歌山県,みなべ町,5,2,決算収支の状況,2,令和3年度,10642568,9435748,1206820,198403,1008417,388830,402,0,0,389232
2022,61,303925,和歌山県,日高川町,5,2,決算収支の状況,2,令和3年度,10095085,9786342,308743,72669,236074,68761,159709,0,0,228470
2022,61,304018,和歌山県,白浜町,5,2,決算収支の状況,2,令和3年度,14383165,13794755,588410,117211,471199,430527,19019,0,0,449546
2022,61,304042,和歌山県,上富田町,5,2,決算収支の状況,2,令和3年度,7814575,7403339,411236,80601,330635,262000,54372,0,0,316372
2022,61,304069,和歌山県,すさみ町,5,2,決算収支の状況,2,令和3年度,5315393,5185125,130268,22007,108261,27985,81000,0,0,108985
2022,61,304212,和歌山県,那智勝浦町,5,2,決算収支の状況,2,令和3年度,10464473,10232153,232320,39668,192652,127342,100122,0,0,227464
2022,61,304221,和歌山県,太地町,5,2,決算収支の状況,2,令和3年度,3645955,3514795,131160,75,131085,8608,210000,0,210000,8608
2022,61,304247,和歌山県,古座川町,5,2,決算収支の状況,2,令和3年度,4095294,3511646,583648,33672,549976,154148,566,0,0,154714
2022,61,304271,和歌山県,北山村,5,2,決算収支の状況,2,令和3年度,2287914,2209159,78755,27196,51559,34542,81000,0,0,115542
2022,61,304280,和歌山県,串本町,5,2,決算収支の状況,2,令和3年度,13165865,12722342,443523,24129,419394,182115,326022,0,0,508137
2022,61,308013,和歌山県,和歌山県市町村総合事務組合,6,2,決算収支の状況,2,令和3年度,6462303,5924483,537820,0,537820,-418538,0,0,500,-419038
2022,61,308072,和歌山県,那賀児童福祉施設組合,6,2,決算収支の状況,2,令和3年度,83197,81408,1789,0,1789,-2026,0,0,0,-2026
2022,61,308102,和歌山県,那賀広域事務組合,6,2,決算収支の状況,2,令和3年度,9203,8436,767,0,767,192,0,0,0,192
2022,61,308111,和歌山県,那賀衛生環境整備組合,6,2,決算収支の状況,2,令和3年度,354737,350405,4332,0,4332,-9389,0,0,0,-9389
2022,61,308137,和歌山県,橋本伊都衛生施設組合,6,2,決算収支の状況,2,令和3年度,173930,171305,2625,0,2625,-2116,11000,0,0,8884
2022,61,308145,和歌山県,伊都郡町村及び橋本市老人福祉施設事務組合,6,2,決算収支の状況,2,令和3年度,394846,365356,29490,0,29490,600,20000,0,0,20600
2022,61,308161,和歌山県,有田衛生施設事務組合,6,2,決算収支の状況,2,令和3年度,577288,521402,55886,0,55886,7286,0,0,0,7286
2022,61,308170,和歌山県,有田聖苑事務組合,6,2,決算収支の状況,2,令和3年度,56758,50271,6487,0,6487,-2734,0,0,0,-2734
2022,61,308251,和歌山県,御坊市日高川町中学校組合,6,2,決算収支の状況,2,令和3年度,91671,83192,8479,450,8029,2275,0,0,0,2275
2022,61,308293,和歌山県,御坊日高老人福祉施設事務組合,6,2,決算収支の状況,2,令和3年度,430123,414566,15557,0,15557,5031,12936,0,0,17967
2022,61,308412,和歌山県,紀南地方老人福祉施設組合,6,2,決算収支の状況,2,令和3年度,438726,416865,21861,0,21861,-8131,46,0,0,-8085
2022,61,308447,和歌山県,富田川治水組合,6,2,決算収支の状況,2,令和3年度,10665,8682,1983,0,1983,1439,0,0,0,1439
2022,61,308455,和歌山県,串本町古座川町衛生施設事務組合,6,2,決算収支の状況,2,令和3年度,741047,732743,8304,0,8304,323,0,0,0,323
2022,61,308463,和歌山県,大辺路衛生施設組合,6,2,決算収支の状況,2,令和3年度,111422,110155,1267,0,1267,428,0,0,0,428
2022,61,308480,和歌山県,紀南学園事務組合,6,2,決算収支の状況,2,令和3年度,141326,138859,2467,0,2467,-191,12000,0,9900,1909
2022,61,308501,和歌山県,紀南環境衛生施設事務組合,6,2,決算収支の状況,2,令和3年度,178633,165218,13415,0,13415,-5964,10027,0,0,4063
2022,61,308510,和歌山県,東牟婁郡町村新宮市老人福祉施設事務組合,6,2,決算収支の状況,2,令和3年度,110546,110315,231,0,231,164,11290,0,3000,8454
2022,61,308561,和歌山県,那智勝浦町太地町環境衛生施設一部事務組合,6,2,決算収支の状況,2,令和3年度,110549,110549,0,0,0,0,0,0,0,0
2022,61,308617,和歌山県,紀南地方児童福祉施設組合,6,2,決算収支の状況,2,令和3年度,43258,34512,8746,0,8746,6118,1511,0,0,7629
2022,61,308633,和歌山県,新宮周辺広域市町村圏事務組合,6,2,決算収支の状況,2,令和3年度,6924,5926,998,0,998,192,0,0,0,192
2022,61,308641,和歌山県,御坊広域行政事務組合,6,2,決算収支の状況,2,令和3年度,3284712,3141919,142793,0,142793,514,0,0,0,514
2022,61,308668,和歌山県,田辺周辺広域市町村圏組合,6,2,決算収支の状況,2,令和3年度,130720,107494,23226,0,23226,2446,0,0,0,2446
2022,61,308684,和歌山県,上大中清掃施設組合,6,2,決算収支の状況,2,令和3年度,67469,56070,11399,0,11399,-28278,0,0,0,-28278
2022,61,308722,和歌山県,有田郡老人福祉施設事務組合,6,2,決算収支の状況,2,令和3年度,263513,256014,7499,0,7499,3208,0,0,13000,-9792
2022,61,308773,和歌山県,那賀消防組合,6,2,決算収支の状況,2,令和3年度,1358090,1316118,41972,0,41972,6114,0,0,0,6114
2022,61,308781,和歌山県,那賀休日急患診療所経営事務組合,6,2,決算収支の状況,2,令和3年度,128748,126375,2373,0,2373,570,0,0,0,570
2022,61,308803,和歌山県,有田周辺広域圏事務組合,6,2,決算収支の状況,2,令和3年度,2255297,2177154,78143,0,78143,38861,29310,0,0,68171
2022,61,308811,和歌山県,田辺市周辺衛生施設組合,6,2,決算収支の状況,2,令和3年度,251792,236293,15499,0,15499,-4969,0,0,0,-4969
2022,61,308838,和歌山県,伊都郡町村及び橋本市児童福祉施設事務組合,6,2,決算収支の状況,2,令和3年度,65273,61636,3637,0,3637,-2146,1,0,8000,-10145
2022,61,308846,和歌山県,富田川衛生施設組合,6,2,決算収支の状況,2,令和3年度,240804,231524,9280,0,9280,-6649,0,0,0,-6649
2022,61,308862,和歌山県,海南海草環境衛生施設組合,6,2,決算収支の状況,2,令和3年度,715612,640105,75507,7060,68447,22647,0,0,0,22647
2022,61,308871,和歌山県,伊都消防組合,6,2,決算収支の状況,2,令和3年度,596630,579453,17177,0,17177,420,0,0,0,420
2022,61,308889,和歌山県,湯浅広川消防組合,6,2,決算収支の状況,2,令和3年度,471476,459535,11941,0,11941,-8998,0,0,0,-8998
2022,61,308897,和歌山県,五色台広域施設組合,6,2,決算収支の状況,2,令和3年度,169179,161947,7232,0,7232,5304,0,0,0,5304
2022,61,308901,和歌山県,日高広域消防事務組合,6,2,決算収支の状況,2,令和3年度,910380,890314,20066,0,20066,-5963,40212,0,0,34249
2022,61,308935,和歌山県,橋本周辺広域市町村圏組合,6,2,決算収支の状況,2,令和3年度,1497400,1367570,129830,0,129830,16881,1267,0,58576,-40428
2022,61,308943,和歌山県,和歌山地方税回収機構,6,2,決算収支の状況,2,令和3年度,126356,110859,15497,0,15497,12802,0,0,0,12802
2022,61,308951,和歌山県,和歌山県後期高齢者医療広域連合,7,2,決算収支の状況,2,令和3年度,118159,108886,9273,0,9273,910,8367,0,15000,-5723
2022,61,308960,和歌山県,和歌山県住宅新築資金等貸付金回収管理組合,6,2,決算収支の状況,2,令和3年度,242310,223741,18569,0,18569,-7869,26456,0,14198,4389
2022,61,308978,和歌山県,紀の海広域施設組合,6,2,決算収支の状況,2,令和3年度,830665,813481,17184,0,17184,10141,0,0,0,10141
2022,61,308986,和歌山県,紀南環境広域施設組合,6,2,決算収支の状況,2,令和3年度,108526,97572,10954,2726,8228,-110,0,0,0,-110
2022,61,312011,鳥取県,鳥取市,8,2,決算収支の状況,2,令和3年度,124172132,120402245,3769887,702994,3066893,947230,248646,0,0,1195876
2022,61,312029,鳥取県,米子市,3,2,決算収支の状況,2,令和3年度,82701245,80495732,2205513,624344,1581169,465156,547852,647080,853879,806209
2022,61,312037,鳥取県,倉吉市,4,2,決算収支の状況,2,令和3年度,32469845,31081464,1388381,428202,960179,500064,349417,0,0,849481
2022,61,312045,鳥取県,境港市,4,2,決算収支の状況,2,令和3年度,21785284,20852589,932695,442213,490482,350278,0,0,0,350278
2022,61,313025,鳥取県,岩美町,5,2,決算収支の状況,2,令和3年度,7917888,7745065,172823,17883,154940,23306,210286,0,403,233189
2022,61,313254,鳥取県,若桜町,5,2,決算収支の状況,2,令和3年度,4217149,3970517,246632,22458,224174,-42086,239000,0,0,196914
2022,61,313289,鳥取県,智頭町,5,2,決算収支の状況,2,令和3年度,7374209,7200509,173700,41718,131982,-43975,350524,0,0,306549
2022,61,313297,鳥取県,八頭町,5,2,決算収支の状況,2,令和3年度,13434890,12308468,1126422,143997,982425,278565,3140,0,0,281705
2022,61,313645,鳥取県,三朝町,5,2,決算収支の状況,2,令和3年度,5884455,5696944,187511,134909,52602,-36408,1310,0,39000,-74098
2022,61,313700,鳥取県,湯梨浜町,5,2,決算収支の状況,2,令和3年度,11140932,10759547,381385,74604,306781,37430,148,254545,0,292123
2022,61,313718,鳥取県,琴浦町,5,2,決算収支の状況,2,令和3年度,12539569,11891321,648248,191451,456797,55282,612094,108497,460800,315073
2022,61,313726,鳥取県,北栄町,5,2,決算収支の状況,2,令和3年度,11347035,10808344,538691,160901,377790,137356,297430,0,0,434786
2022,61,313840,鳥取県,日吉津村,5,2,決算収支の状況,2,令和3年度,3515529,3387875,127654,11514,116140,-71610,351407,0,0,279797
2022,61,313866,鳥取県,大山町,5,2,決算収支の状況,2,令和3年度,13013763,12168629,845134,394726,450408,67149,5542,0,0,72691
2022,61,313891,鳥取県,南部町,5,2,決算収支の状況,2,令和3年度,8652329,8278156,374173,8503,365670,172581,443,0,0,173024
2022,61,313904,鳥取県,伯耆町,5,2,決算収支の状況,2,令和3年度,8417337,7834799,582538,261138,321400,-88903,210,0,0,-88693
2022,61,314013,鳥取県,日南町,5,2,決算収支の状況,2,令和3年度,7819028,7524667,294361,73080,221281,-107997,348463,0,0,240466
2022,61,314021,鳥取県,日野町,5,2,決算収支の状況,2,令和3年度,4391294,4268491,122803,4920,117883,-71318,22386,0,0,-48932
2022,61,314030,鳥取県,江府町,5,2,決算収支の状況,2,令和3年度,4905633,4456665,448968,8320,440648,241102,172,0,0,241274
2022,61,318051,鳥取県,米子市日吉津村中学校組合,6,2,決算収支の状況,2,令和3年度,117427,114898,2529,842,1687,1254,1,0,854,401
2022,61,318086,鳥取県,鳥取県町村総合事務組合,6,2,決算収支の状況,2,令和3年度,1889177,1868900,20277,0,20277,-174277,1080,0,0,-173197
2022,61,318124,鳥取県,日野町江府町日南町衛生施設組合,6,2,決算収支の状況,2,令和3年度,188496,172644,15852,0,15852,1250,0,0,0,1250
2022,61,318213,鳥取県,境港管理組合,6,2,決算収支の状況,2,令和3年度,2913975,2714475,199500,0,199500,17151,0,0,0,17151
2022,61,318256,鳥取県,南部町・伯耆町清掃施設管理組合,6,2,決算収支の状況,2,令和3年度,230889,220917,9972,0,9972,-23943,0,0,0,-23943
2022,61,318272,鳥取県,鳥取県東部広域行政管理組合,6,2,決算収支の状況,2,令和3年度,16498465,16422961,75504,9615,65889,16009,1,0,0,16010
2022,61,318299,鳥取県,鳥取県西部広域行政管理組合,6,2,決算収支の状況,2,令和3年度,4750039,4708235,41804,5603,36201,-31209,33711,0,29947,-27445
2022,61,318337,鳥取県,玉井斎場管理組合,6,2,決算収支の状況,2,令和3年度,273165,263461,9704,0,9704,1540,0,0,0,1540
2022,61,318353,鳥取県,鳥取中部ふるさと広域連合（普通会計分）,6,2,決算収支の状況,2,令和3年度,2733877,2727149,6728,1126,5602,1706,1524,0,0,3230
2022,61,318361,鳥取県,鳥取中部ふるさと広域連合（事業会計分）,7,2,決算収支の状況,2,令和3年度,0,0,0,0,0,0,0,0,0,0
2022,61,318370,鳥取県,南部箕蚊屋広域連合,6,2,決算収支の状況,2,令和3年度,535092,530299,4793,0,4793,675,0,0,0,675
2022,61,318388,鳥取県,鳥取県後期高齢者医療広域連合,7,2,決算収支の状況,2,令和3年度,121145,119407,1738,0,1738,-102,0,0,0,-102
2022,61,322016,島根県,松江市,8,2,決算収支の状況,2,令和3年度,111124775,107859245,3265530,720485,2545045,-130683,1105818,902991,0,1878126
2022,61,322024,島根県,浜田市,4,2,決算収支の状況,2,令和3年度,42372365,40962909,1409456,323682,1085774,420483,344778,815044,0,1580305
2022,61,322032,島根県,出雲市,3,2,決算収支の状況,2,令和3年度,101138632,98574182,2564450,1007341,1557109,896782,491,579191,5654,1470810
2022,61,322041,島根県,益田市,4,2,決算収支の状況,2,令和3年度,30969600,28936387,2033213,271942,1761271,1133505,461697,0,0,1595202
2022,61,322059,島根県,大田市,4,2,決算収支の状況,2,令和3年度,28932284,27947404,984880,157417,827463,533722,56,0,0,533778
2022,61,322067,島根県,安来市,4,2,決算収支の状況,2,令和3年度,27895999,26877734,1018265,97095,921170,528859,450083,258667,300000,937609
2022,61,322075,島根県,江津市,4,2,決算収支の状況,2,令和3年度,18637775,17840449,797326,170930,626396,77890,4,1070904,2351,1146447
2022,61,322091,島根県,雲南市,4,2,決算収支の状況,2,令和3年度,32829573,32132436,697137,242433,454704,95370,10,0,0,95380
2022,61,323438,島根県,奥出雲町,5,2,決算収支の状況,2,令和3年度,15249476,14886695,362781,241103,121678,-28092,56361,344880,0,373149
2022,61,323861,島根県,飯南町,5,2,決算収支の状況,2,令和3年度,8815132,8576871,238261,54836,183425,73172,0,157708,0,230880
2022,61,324418,島根県,川本町,5,2,決算収支の状況,2,令和3年度,5030656,4895769,134887,72912,61975,4150,2250,0,0,6400
2022,61,324485,島根県,美郷町,5,2,決算収支の状況,2,令和3年度,8460313,8235195,225118,36982,188136,96077,8,0,0,96085
2022,61,324493,島根県,邑南町,5,2,決算収支の状況,2,令和3年度,13849247,13586503,262744,50334,212410,5819,107075,110239,0,223133
2022,61,325015,島根県,津和野町,5,2,決算収支の状況,2,令和3年度,10852280,10651253,201027,78685,122342,38933,124108,168691,0,331732
2022,61,325058,島根県,吉賀町,5,2,決算収支の状況,2,令和3年度,8043792,7763689,280103,20011,260092,120324,412,62640,0,183376
2022,61,325252,島根県,海士町,5,2,決算収支の状況,2,令和3年度,7118987,6740946,378041,6868,371173,203695,4,0,0,203699
2022,61,325261,島根県,西ノ島町,5,2,決算収支の状況,2,令和3年度,6434992,6249638,185354,37431,147923,-37249,18563,64547,0,45861
2022,61,325279,島根県,知夫村,5,2,決算収支の状況,2,令和3年度,2457747,2344486,113261,938,112323,50912,71300,80012,0,202224
2022,61,325287,島根県,隠岐の島町,5,2,決算収支の状況,2,令和3年度,18050741,17727554,323187,71817,251370,6338,37,0,0,6375
2022,61,328413,島根県,鹿足郡事務組合,6,2,決算収支の状況,2,令和3年度,380768,356583,24185,0,24185,7491,0,0,0,7491
2022,61,328421,島根県,鹿足郡養護老人ホーム組合,6,2,決算収支の状況,2,令和3年度,157311,157264,47,0,47,-707,1,0,2198,-2904
2022,61,328456,島根県,島前町村組合（普通会計分）,6,2,決算収支の状況,2,令和3年度,772150,747827,24323,0,24323,2505,0,0,0,2505
2022,61,328529,島根県,益田地区広域市町村圏事務組合,6,2,決算収支の状況,2,令和3年度,3207953,3147455,60498,0,60498,24228,0,0,0,24228
2022,61,328553,島根県,江津邑智消防組合,6,2,決算収支の状況,2,令和3年度,1229398,1216409,12989,0,12989,1019,11975,0,46982,-33988
2022,61,328740,島根県,鹿足郡不燃物処理組合,6,2,決算収支の状況,2,令和3年度,206779,192483,14296,0,14296,5765,0,0,0,5765
2022,61,328766,島根県,雲南市・飯南町事務組合,6,2,決算収支の状況,2,令和3年度,4261849,4143497,118352,0,118352,-21119,0,0,0,-21119
2022,61,328847,島根県,島根県市町村総合事務組合,6,2,決算収支の状況,2,令和3年度,5032414,5011830,20584,0,20584,1666,5455,0,0,7121
2022,61,328880,島根県,邑智郡総合事務組合,6,2,決算収支の状況,2,令和3年度,5113395,3007399,2105996,2072516,33480,-1242,0,0,0,-1242
2022,61,328910,島根県,浜田地区広域行政組合,6,2,決算収支の状況,2,令和3年度,1085408,1063094,22314,0,22314,816,0,0,0,816
2022,61,328936,島根県,雲南広域連合（普通会計分）,6,2,決算収支の状況,2,令和3年度,1393613,1377159,16454,0,16454,508,1,0,0,509
2022,61,328944,島根県,隠岐広域連合（普通会計分）,6,2,決算収支の状況,2,令和3年度,1167999,1155803,12196,638,11558,411,2,0,0,413
2022,61,328961,島根県,島根県後期高齢者医療広域連合,7,2,決算収支の状況,2,令和3年度,300590,267820,32770,0,32770,-6644,0,0,0,-6644
2022,61,331007,岡山県,岡山市,1,2,決算収支の状況,2,令和3年度,402822136,383657449,19164687,5780890,13383797,1454856,5193,14857304,5377824,10939529
2022,61,332020,岡山県,倉敷市,8,2,決算収支の状況,2,令和3年度,226103905,215647884,10456021,1040490,9415531,1993158,4304857,750000,3930000,3118015
2022,61,332038,岡山県,津山市,4,2,決算収支の状況,2,令和3年度,53434778,51326657,2108121,103348,2004773,894274,2682,0,100000,796956
2022,61,332046,岡山県,玉野市,4,2,決算収支の状況,2,令和3年度,27927051,25657814,2269237,275671,1993566,472639,770896,149456,0,1392991
2022,61,332054,岡山県,笠岡市,4,2,決算収支の状況,2,令和3年度,27275011,26388381,886630,72447,814183,354861,250886,30364,0,636111
2022,61,332071,岡山県,井原市,4,2,決算収支の状況,2,令和3年度,25063283,23810024,1253259,65860,1187399,1098896,67030,8265,305272,868919
2022,61,332089,岡山県,総社市,4,2,決算収支の状況,2,令和3年度,32566345,30431486,2134859,258484,1876375,996095,931099,0,0,1927194
2022,61,332097,岡山県,高梁市,4,2,決算収支の状況,2,令和3年度,27947182,26937125,1010057,150864,859193,155127,302455,0,0,457582
2022,61,332101,岡山県,新見市,4,2,決算収支の状況,2,令和3年度,28878010,26851562,2026448,446772,1579676,7869,194,380540,426486,-37883
2022,61,332119,岡山県,備前市,4,2,決算収支の状況,2,令和3年度,21404730,20306011,1098719,220281,878438,394118,10458,1259568,170000,1494144
2022,61,332127,岡山県,瀬戸内市,4,2,決算収支の状況,2,令和3年度,24390122,23620257,769865,124027,645838,-251129,456595,794394,200000,799860
2022,61,332135,岡山県,赤磐市,4,2,決算収支の状況,2,令和3年度,23038430,21600677,1437753,98059,1339694,-178335,4181,0,577480,-751634
2022,61,332143,岡山県,真庭市,4,2,決算収支の状況,2,令和3年度,36137035,34575952,1561083,116125,1444958,536699,18207,788742,0,1343648
2022,61,332151,岡山県,美作市,4,2,決算収支の状況,2,令和3年度,23846547,22127396,1719151,79153,1639998,470935,41110,252565,0,764610
2022,61,332160,岡山県,浅口市,4,2,決算収支の状況,2,令和3年度,17090799,15748389,1342410,76254,1266156,168364,18213,0,672580,-486003
2022,61,333468,岡山県,和気町,5,2,決算収支の状況,2,令和3年度,8999285,8065338,933947,56721,877226,462535,1980,0,0,464515
2022,61,334235,岡山県,早島町,5,2,決算収支の状況,2,令和3年度,6254993,6041671,213322,22027,191295,17348,87004,0,0,104352
2022,61,334456,岡山県,里庄町,5,2,決算収支の状況,2,令和3年度,6229927,5814250,415677,32771,382906,143472,205378,0,96584,252266
2022,61,334618,岡山県,矢掛町,5,2,決算収支の状況,2,令和3年度,10113331,9669415,443916,27030,416886,75389,23584,280000,0,378973
2022,61,335860,岡山県,新庄村,5,2,決算収支の状況,2,令和3年度,2008982,1899928,109054,4625,104429,17244,33505,0,0,50749
2022,61,336068,岡山県,鏡野町,5,2,決算収支の状況,2,令和3年度,12889086,12162695,726391,82642,643749,-167642,21114,0,153000,-299528
2022,61,336220,岡山県,勝央町,5,2,決算収支の状況,2,令和3年度,7121269,6578759,542510,125848,416662,-4314,394544,0,40000,350230
2022,61,336238,岡山県,奈義町,5,2,決算収支の状況,2,令和3年度,5588345,5155928,432417,13560,418857,126165,3543,185730,35704,279734
2022,61,336432,岡山県,西粟倉村,5,2,決算収支の状況,2,令和3年度,4101938,3911276,190662,16175,174487,84480,1021,0,55900,29601
2022,61,336637,岡山県,久米南町,5,2,決算収支の状況,2,令和3年度,4972843,4651625,321218,0,321218,168719,97536,0,0,266255
2022,61,336661,岡山県,美咲町,5,2,決算収支の状況,2,令和3年度,14426423,13928207,498216,13396,484820,-296528,117,752171,0,455760
2022,61,336815,岡山県,吉備中央町,5,2,決算収支の状況,2,令和3年度,12154532,11293819,860713,109468,751245,234984,268294,0,0,503278
2022,61,338028,岡山県,八ヶ郷合同用水組合,6,2,決算収支の状況,2,令和3年度,42747,38023,4724,0,4724,-1281,0,0,0,-1281
2022,61,338036,岡山県,高梁川東西用水組合,6,2,決算収支の状況,2,令和3年度,38815,36582,2233,0,2233,-150,10,0,8654,-8794
2022,61,338052,岡山県,旭東用排水組合,6,2,決算収支の状況,2,令和3年度,53720,50107,3613,0,3613,-51,0,0,0,-51
2022,61,338141,岡山県,湛井十二箇郷組合,6,2,決算収支の状況,2,令和3年度,28010,16743,11267,0,11267,641,0,0,0,641
2022,61,338168,岡山県,大正池水利組合,6,2,決算収支の状況,2,令和3年度,6983,4161,2822,0,2822,-22,0,0,0,-22
2022,61,338176,岡山県,田原用水組合,6,2,決算収支の状況,2,令和3年度,21312,13224,8088,0,8088,2452,0,0,0,2452
2022,61,338184,岡山県,六ヶ郷組合,6,2,決算収支の状況,2,令和3年度,9065,7139,1926,0,1926,1388,0,0,0,1388
2022,61,338192,岡山県,四ヶ郷組合,6,2,決算収支の状況,2,令和3年度,2278,1573,705,0,705,169,0,0,0,169
2022,61,338206,岡山県,西一郷半組合,6,2,決算収支の状況,2,令和3年度,2054,733,1321,0,1321,3,0,0,0,3
2022,61,338214,岡山県,三ヶ村組合,6,2,決算収支の状況,2,令和3年度,1099,711,388,0,388,-128,0,0,0,-128
2022,61,338290,岡山県,岡山県笠岡市矢掛町中学校組合,6,2,決算収支の状況,2,令和3年度,56539,55853,686,0,686,-322,0,0,0,-322
2022,61,338460,岡山県,神崎衛生施設組合,6,2,決算収支の状況,2,令和3年度,356393,342447,13946,0,13946,-7386,0,0,0,-7386
2022,61,338478,岡山県,備南衛生施設組合,6,2,決算収支の状況,2,令和3年度,190194,144328,45866,0,45866,782,0,0,0,782
2022,61,338494,岡山県,勝英衛生施設組合,6,2,決算収支の状況,2,令和3年度,110116,89824,20292,0,20292,207,5000,0,0,5207
2022,61,338508,岡山県,岡山県西部衛生施設組合,6,2,決算収支の状況,2,令和3年度,3565206,3549556,15650,0,15650,-3332,0,0,0,-3332
2022,61,338516,岡山県,旭川中部衛生施設組合,6,2,決算収支の状況,2,令和3年度,103864,99546,4318,0,4318,-3737,0,0,0,-3737
2022,61,338524,岡山県,和気・赤磐し尿処理施設一部事務組合,6,2,決算収支の状況,2,令和3年度,226910,198911,27999,0,27999,-5888,0,0,0,-5888
2022,61,338559,岡山県,岡山県西部環境整備施設組合,6,2,決算収支の状況,2,令和3年度,946534,876605,69929,34960,34969,11163,0,0,0,11163
2022,61,338567,岡山県,和気北部衛生施設組合,6,2,決算収支の状況,2,令和3年度,55512,47114,8398,0,8398,1734,0,0,0,1734
2022,61,338591,岡山県,倉敷西部清掃施設組合,6,2,決算収支の状況,2,令和3年度,734867,653961,80906,0,80906,-17139,0,0,0,-17139
2022,61,338800,岡山県,和気老人ホーム組合,6,2,決算収支の状況,2,令和3年度,118397,110569,7828,0,7828,2358,1,0,1668,691
2022,61,338869,岡山県,岡山県市町村税整理組合,6,2,決算収支の状況,2,令和3年度,106744,84878,21866,0,21866,428,21438,0,33000,-11134
2022,61,338958,岡山県,岡山市久米南町衛生施設組合,6,2,決算収支の状況,2,令和3年度,171098,150532,20566,0,20566,8962,0,0,0,8962
2022,61,338966,岡山県,岡山県中部環境施設組合,6,2,決算収支の状況,2,令和3年度,331307,297760,33547,0,33547,-8489,0,0,0,-8489
2022,61,338974,岡山県,岡山県井原地区清掃施設組合,6,2,決算収支の状況,2,令和3年度,399477,389518,9959,0,9959,311,0,0,0,311
2022,61,338982,岡山県,津山圏域衛生処理組合,6,2,決算収支の状況,2,令和3年度,494884,436218,58666,0,58666,534,0,0,0,534
2022,61,339083,岡山県,笠岡地区消防組合,6,2,決算収支の状況,2,令和3年度,1367753,1360101,7652,0,7652,-695,0,0,0,-695
2022,61,339121,岡山県,久米老人ホーム組合,6,2,決算収支の状況,2,令和3年度,177192,171964,5228,0,5228,1774,1346,0,9316,-6196
2022,61,339130,岡山県,総社広域環境施設組合,6,2,決算収支の状況,2,令和3年度,1423997,1326179,97818,0,97818,-30,0,0,0,-30
2022,61,339156,岡山県,井原地区消防組合,6,2,決算収支の状況,2,令和3年度,1077924,1056567,21357,0,21357,1405,0,0,0,1405
2022,61,339164,岡山県,津山圏域消防組合,6,2,決算収支の状況,2,令和3年度,3455495,3336034,119461,0,119461,410,0,0,0,410
2022,61,339172,岡山県,勝田郡老人福祉施設組合,6,2,決算収支の状況,2,令和3年度,38091,33816,4275,0,4275,2142,0,0,0,2142
2022,61,339199,岡山県,東備消防組合,6,2,決算収支の状況,2,令和3年度,1009795,912833,96962,0,96962,27557,0,0,0,27557
2022,61,339202,岡山県,岡山県西部地区養護老人ホーム組合,6,2,決算収支の状況,2,令和3年度,127867,124986,2881,0,2881,-1060,0,0,0,-1060
2022,61,339253,岡山県,備南競艇事業組合,7,2,決算収支の状況,2,令和3年度,0,0,0,0,0,0,0,0,0,0
2022,61,339270,岡山県,柵原、吉井、英田火葬場施設組合,6,2,決算収支の状況,2,令和3年度,16163,14027,2136,0,2136,-366,0,0,0,-366
2022,61,339326,岡山県,柵原吉井特別養護老人ホーム組合,6,2,決算収支の状況,2,令和3年度,117242,85025,32217,0,32217,-170,542,0,0,372
2022,61,339385,岡山県,津山広域事務組合,6,2,決算収支の状況,2,令和3年度,44745,31069,13676,0,13676,1517,0,0,0,1517
2022,61,339466,岡山県,高梁地域事務組合（普通会計）,6,2,決算収支の状況,2,令和3年度,618366,609124,9242,0,9242,-10875,0,0,0,-10875
2022,61,339555,岡山県,岡山県市町村総合事務組合,6,2,決算収支の状況,2,令和3年度,7461907,7007860,454047,0,454047,-281336,7577,0,0,-273759
2022,61,339571,岡山県,岡山県後期高齢者医療広域連合,7,2,決算収支の状況,2,令和3年度,82724,79202,3522,0,3522,318,3208,0,0,3526
2022,61,339598,岡山県,津山圏域資源循環施設組合,6,2,決算収支の状況,2,令和3年度,1823202,1763062,60140,0,60140,-53449,0,0,0,-53449
2022,61,341002,広島県,広島市,1,2,決算収支の状況,2,令和3年度,726457881,714072933,12384948,9429687,2955261,300362,6916044,0,0,7216406
2022,61,342025,広島県,呉市,8,2,決算収支の状況,2,令和3年度,113276304,107830324,5445980,975344,4470636,1984761,1244895,148855,0,3378511
2022,61,342033,広島県,竹原市,4,2,決算収支の状況,2,令和3年度,15476894,14487465,989429,177172,812257,705158,541633,0,0,1246791
2022,61,342041,広島県,三原市,4,2,決算収支の状況,2,令和3年度,56353235,53328894,3024341,562341,2462000,2349951,583633,194193,0,3127777
2022,61,342050,広島県,尾道市,3,2,決算収支の状況,2,令和3年度,69485677,68051087,1434590,501989,932601,644850,140043,0,0,784893
2022,61,342076,広島県,福山市,8,2,決算収支の状況,2,令和3年度,211359604,203252941,8106663,2927318,5179345,1806193,1740210,2034320,3765000,1815723
2022,61,342084,広島県,府中市,4,2,決算収支の状況,2,令和3年度,25624265,24567982,1056283,270637,785646,375369,1457,0,130000,246826
2022,61,342092,広島県,三次市,4,2,決算収支の状況,2,令和3年度,41368190,39669071,1699119,388598,1310521,609894,2162,1000416,0,1612472
2022,61,342106,広島県,庄原市,4,2,決算収支の状況,2,令和3年度,35693474,34118299,1575175,330842,1244333,751049,171123,261854,0,1184026
2022,61,342114,広島県,大竹市,4,2,決算収支の状況,2,令和3年度,18212649,16870944,1341705,921994,419711,385809,2423,0,0,388232
2022,61,342122,広島県,東広島市,3,2,決算収支の状況,2,令和3年度,101442260,95727832,5714428,3272175,2442253,-19811,8837,0,0,-10974
2022,61,342131,広島県,廿日市市,3,2,決算収支の状況,2,令和3年度,61290921,59745125,1545796,625986,919810,781774,928293,0,0,1710067
2022,61,342149,広島県,安芸高田市,4,2,決算収支の状況,2,令和3年度,23027430,21792642,1234788,305754,929034,395974,413,0,229000,167387
2022,61,342157,広島県,江田島市,4,2,決算収支の状況,2,令和3年度,16565487,15867553,697934,369848,328086,100212,422939,0,0,523151
2022,61,343021,広島県,府中町,5,2,決算収支の状況,2,令和3年度,21523211,21198782,324429,30450,293979,-14600,155882,0,0,141282
2022,61,343048,広島県,海田町,5,2,決算収支の状況,2,令和3年度,13835571,13067968,767603,249749,517854,-38149,458,588575,97137,453747
2022,61,343072,広島県,熊野町,5,2,決算収支の状況,2,令和3年度,10974825,10487715,487110,27188,459922,366796,224371,0,0,591167
2022,61,343099,広島県,坂町,5,2,決算収支の状況,2,令和3年度,8356478,7202178,1154300,924500,229800,-37202,134075,0,0,96873
2022,61,343684,広島県,安芸太田町,5,2,決算収支の状況,2,令和3年度,9006371,8558459,447912,88751,359161,-23178,447342,0,0,424164
2022,61,343692,広島県,北広島町,5,2,決算収支の状況,2,令和3年度,17694153,17139095,555058,126744,428314,343817,44401,0,0,388218
2022,61,344311,広島県,大崎上島町,5,2,決算収支の状況,2,令和3年度,8035738,7737148,298590,78378,220212,96245,69948,0,0,166193
2022,61,344621,広島県,世羅町,5,2,決算収支の状況,2,令和3年度,13939684,13319660,620024,251856,368168,99295,43722,0,0,143017
2022,61,345458,広島県,神石高原町,5,2,決算収支の状況,2,令和3年度,13692647,12564875,1127772,423109,704663,86763,14173,0,37000,63936
2022,61,348392,広島県,安芸地区衛生施設管理組合,6,2,決算収支の状況,2,令和3年度,1943209,1879617,63592,0,63592,-22493,16758,0,50000,-55735
2022,61,348546,広島県,広島県海田高等学校財産組合,6,2,決算収支の状況,2,令和3年度,116,0,116,0,116,0,0,0,0,0
2022,61,348562,広島県,広島県市町総合事務組合,6,2,決算収支の状況,2,令和3年度,4747872,4459811,288061,0,288061,141204,0,0,0,141204
2022,61,348597,広島県,宮島ボートレース企業団,7,2,決算収支の状況,2,令和3年度,0,0,0,0,0,0,0,0,0,0
2022,61,348660,広島県,備北地区消防組合,6,2,決算収支の状況,2,令和3年度,1986555,1967297,19258,0,19258,-57,0,0,0,-57
2022,61,348767,広島県,三原広域市町村圏事務組合,6,2,決算収支の状況,2,令和3年度,241465,183241,58224,0,58224,23584,0,0,0,23584
2022,61,349054,広島県,福山地区消防組合,6,2,決算収支の状況,2,令和3年度,7201440,7025979,175461,50000,125461,4901,0,0,0,4901
2022,61,349089,広島県,芸北広域環境施設組合,6,2,決算収支の状況,2,令和3年度,746516,724054,22462,5500,16962,-2907,49010,0,100000,-53897
2022,61,349135,広島県,広島中部台地土地改良施設管理組合,6,2,決算収支の状況,2,令和3年度,88574,83062,5512,4296,1216,-975,0,0,0,-975
2022,61,349178,広島県,広島県後期高齢者医療広域連合,7,2,決算収支の状況,2,令和3年度,521771,367882,153889,0,153889,-4568,158466,0,0,153898
2022,61,349186,広島県,広島中央環境衛生組合,6,2,決算収支の状況,2,令和3年度,9224834,9224834,0,0,0,0,0,0,0,0
2022,61,352012,山口県,下関市,8,2,決算収支の状況,2,令和3年度,134443855,129605584,4838271,443932,4394339,1858289,1331899,0,500000,2690188
2022,61,352021,山口県,宇部市,3,2,決算収支の状況,2,令和3年度,84527726,81868468,2659258,390287,2268971,723365,3130342,524307,773159,3604855
2022,61,352039,山口県,山口市,3,2,決算収支の状況,2,令和3年度,95233402,93706624,1526778,806524,720254,-66867,358292,0,300000,-8575
2022,61,352047,山口県,萩市,4,2,決算収支の状況,2,令和3年度,33556630,32041810,1514820,217421,1297399,717887,291602,0,0,1009489
2022,61,352063,山口県,防府市,3,2,決算収支の状況,2,令和3年度,49827300,47860183,1967117,318247,1648870,-267941,992562,0,600000,124621
2022,61,352071,山口県,下松市,4,2,決算収支の状況,2,令和3年度,25734372,24522104,1212268,155704,1056564,195922,440328,9735,200000,445985
2022,61,352080,山口県,岩国市,3,2,決算収支の状況,2,令和3年度,74505919,71531950,2973969,593719,2380250,1191593,607999,14929,0,1814521
2022,61,352101,山口県,光市,4,2,決算収支の状況,2,令和3年度,24129849,23049480,1080369,137087,943282,177996,851000,0,325500,703496
2022,61,352110,山口県,長門市,4,2,決算収支の状況,2,令和3年度,23048177,21358449,1689728,143090,1546638,741205,406297,0,0,1147502
2022,61,352128,山口県,柳井市,4,2,決算収支の状況,2,令和3年度,18839582,18088075,751507,122523,628984,399718,216266,0,0,615984
2022,61,352136,山口県,美祢市,4,2,決算収支の状況,2,令和3年度,17551672,16866092,685580,40937,644643,271006,273823,0,0,544829
2022,61,352152,山口県,周南市,3,2,決算収支の状況,2,令和3年度,77407144,73341819,4065325,139855,3925470,2128773,3909493,0,1942018,4096248
2022,61,352161,山口県,山陽小野田市,4,2,決算収支の状況,2,令和3年度,33409252,32102809,1306443,117178,1189265,736671,200829,0,0,937500
2022,61,353051,山口県,周防大島町,5,2,決算収支の状況,2,令和3年度,15264930,14371133,893797,85472,808325,603272,270850,0,0,874122
2022,61,353213,山口県,和木町,5,2,決算収支の状況,2,令和3年度,4805533,4527519,278014,501,277513,102422,143419,0,0,245841
2022,61,353418,山口県,上関町,5,2,決算収支の状況,2,令和3年度,4419006,4115795,303211,15161,288050,115549,140039,0,0,255588
2022,61,353434,山口県,田布施町,5,2,決算収支の状況,2,令和3年度,7162018,6934168,227850,16220,211630,25319,314497,0,63998,275818
2022,61,353442,山口県,平生町,5,2,決算収支の状況,2,令和3年度,7578331,7238719,339612,131381,208231,102086,397039,0,128791,370334
2022,61,355020,山口県,阿武町,5,2,決算収支の状況,2,令和3年度,4529305,3808624,720681,20697,699984,255445,100000,0,0,355445
2022,61,358045,山口県,周南地区福祉施設組合,6,2,決算収支の状況,2,令和3年度,496741,470989,25752,0,25752,6662,0,0,0,6662
2022,61,358126,山口県,玖珂地方老人福祉施設組合,6,2,決算収支の状況,2,令和3年度,402095,381093,21002,0,21002,6325,0,0,0,6325
2022,61,358304,山口県,周東環境衛生組合,6,2,決算収支の状況,2,令和3年度,702845,693466,9379,0,9379,3587,2906,0,11000,-4507
2022,61,358347,山口県,熊南総合事務組合,6,2,決算収支の状況,2,令和3年度,279811,247538,32273,0,32273,15800,0,0,0,15800
2022,61,358371,山口県,周南地区衛生施設組合,6,2,決算収支の状況,2,令和3年度,2546683,2265111,281572,0,281572,-41980,0,0,0,-41980
2022,61,358436,山口県,柳井地区広域消防組合,6,2,決算収支の状況,2,令和3年度,1496888,1458198,38690,0,38690,12020,0,0,0,12020
2022,61,358461,山口県,光地区消防組合,6,2,決算収支の状況,2,令和3年度,1257511,1218400,39111,0,39111,-3185,0,0,0,-3185
2022,61,358487,山口県,岩国地区消防組合,6,2,決算収支の状況,2,令和3年度,2402968,2239682,163286,134035,29251,-31863,60116,0,0,28253
2022,61,358517,山口県,周陽環境整備組合,6,2,決算収支の状況,2,令和3年度,205051,203611,1440,0,1440,-205,0,0,0,-205
2022,61,358592,山口県,周南東部環境施設組合,6,2,決算収支の状況,2,令和3年度,744036,689552,54484,0,54484,34777,0,0,0,34777
2022,61,358690,山口県,山口県市町総合事務組合,6,2,決算収支の状況,2,令和3年度,1279818,1230647,49171,0,49171,-4452,0,0,5000,-9452
2022,61,358703,山口県,山口県後期高齢者医療広域連合,7,2,決算収支の状況,2,令和3年度,66384,60782,5602,0,5602,1262,2170,0,0,3432
2022,61,358738,山口県,萩・長門清掃一部事務組合,6,2,決算収支の状況,2,令和3年度,418386,407381,11005,0,11005,-9367,0,0,0,-9367
2022,61,358746,山口県,宇部・山陽小野田消防組合,6,2,決算収支の状況,2,令和3年度,2896023,2872191,23832,0,23832,-5483,0,0,0,-5483
2022,61,362018,徳島県,徳島市,3,2,決算収支の状況,2,令和3年度,116536273,111981451,4554822,452397,4102425,3345703,4025,6800,0,3356528
2022,61,362026,徳島県,鳴門市,4,2,決算収支の状況,2,令和3年度,35732895,34504209,1228686,345554,883132,28977,1810081,0,300000,1539058
2022,61,362034,徳島県,小松島市,4,2,決算収支の状況,2,令和3年度,18888849,18099005,789844,200305,589539,263672,251832,0,0,515504
2022,61,362042,徳島県,阿南市,4,2,決算収支の状況,2,令和3年度,37732106,36266832,1465274,167865,1297409,1171137,893918,0,0,2065055
2022,61,362051,徳島県,吉野川市,4,2,決算収支の状況,2,令和3年度,23158666,22251934,906732,86685,820047,164104,1261,396473,0,561838
2022,61,362069,徳島県,阿波市,4,2,決算収支の状況,2,令和3年度,22492664,21498708,993956,101344,892612,377539,212150,0,100803,488886
2022,61,362077,徳島県,美馬市,4,2,決算収支の状況,2,令和3年度,21667164,21092227,574937,79122,495815,-94067,268672,52668,0,227273
2022,61,362085,徳島県,三好市,4,2,決算収支の状況,2,令和3年度,26097403,24626116,1471287,338322,1132965,474344,393163,219360,0,1086867
2022,61,363014,徳島県,勝浦町,5,2,決算収支の状況,2,令和3年度,4552882,4127884,424998,104116,320882,205735,603,0,0,206338
2022,61,363022,徳島県,上勝町,5,2,決算収支の状況,2,令和3年度,3356721,3087102,269619,91734,177885,85910,51000,0,41000,95910
2022,61,363219,徳島県,佐那河内村,5,2,決算収支の状況,2,令和3年度,3986513,3721692,264821,97085,167736,68489,1059,40951,0,110499
2022,61,363413,徳島県,石井町,5,2,決算収支の状況,2,令和3年度,10823706,10290152,533554,71361,462193,99029,417000,0,200000,316029
2022,61,363421,徳島県,神山町,5,2,決算収支の状況,2,令和3年度,7877866,7542395,335471,67080,268391,91365,5252,0,0,96617
2022,61,363685,徳島県,那賀町,5,2,決算収支の状況,2,令和3年度,12975246,11608395,1366851,509521,857330,175022,2321,0,0,177343
2022,61,363839,徳島県,牟岐町,5,2,決算収支の状況,2,令和3年度,3854202,3459843,394359,36481,357878,78323,149290,0,0,227613
2022,61,363871,徳島県,美波町,5,2,決算収支の状況,2,令和3年度,7067563,6700908,366655,82047,284608,-13913,6791,0,0,-7122
2022,61,363880,徳島県,海陽町,5,2,決算収支の状況,2,令和3年度,8945344,8396135,549209,16264,532945,6340,121048,143416,0,270804
2022,61,364011,徳島県,松茂町,5,2,決算収支の状況,2,令和3年度,7470622,7313603,157019,16630,140389,6136,359378,0,300000,65514
2022,61,364029,徳島県,北島町,5,2,決算収支の状況,2,令和3年度,9663065,9146909,516156,7166,508990,338266,285385,0,0,623651
2022,61,364037,徳島県,藍住町,5,2,決算収支の状況,2,令和3年度,14392498,13391691,1000807,66359,934448,302947,580879,0,0,883826
2022,61,364045,徳島県,板野町,5,2,決算収支の状況,2,令和3年度,6752710,6444356,308354,30943,277411,19766,150200,0,0,169966
2022,61,364053,徳島県,上板町,5,2,決算収支の状況,2,令和3年度,5845779,5528517,317262,20941,296321,34185,327160,0,0,361345
2022,61,364681,徳島県,つるぎ町,5,2,決算収支の状況,2,令和3年度,8534858,8278708,256150,16357,239793,87281,2902,0,0,90183
2022,61,364894,徳島県,東みよし町,5,2,決算収支の状況,2,令和3年度,10061693,9204818,856875,77657,779218,246685,500613,0,500000,247298
2022,61,368032,徳島県,西阿老人ホーム組合,6,2,決算収支の状況,2,令和3年度,256151,236326,19825,0,19825,6606,0,0,0,6606
2022,61,368121,徳島県,海部老人ホーム町村組合,6,2,決算収支の状況,2,令和3年度,165862,143254,22608,0,22608,7312,0,0,0,7312
2022,61,368148,徳島県,老人ホーム福寿荘組合,6,2,決算収支の状況,2,令和3年度,161330,152243,9087,0,9087,-2540,8072,0,3719,1813
2022,61,368156,徳島県,美馬西部共立火葬場組合,6,2,決算収支の状況,2,令和3年度,34510,29854,4656,0,4656,-457,0,0,0,-457
2022,61,368181,徳島県,吉野川環境整備組合,6,2,決算収支の状況,2,令和3年度,256944,241464,15480,0,15480,-13833,0,0,0,-13833
2022,61,368199,徳島県,海部郡衛生処理事務組合,6,2,決算収支の状況,2,令和3年度,601531,544193,57338,0,57338,10488,20020,0,0,30508
2022,61,368229,徳島県,阿北火葬場管理組合,6,2,決算収支の状況,2,令和3年度,87676,76333,11343,0,11343,-661,1,0,0,-660
2022,61,368245,徳島県,阿北環境整備組合,6,2,決算収支の状況,2,令和3年度,288499,267943,20556,0,20556,5469,2,0,0,5471
2022,61,368261,徳島県,美馬環境整備組合,6,2,決算収支の状況,2,令和3年度,1156436,1073035,83401,0,83401,8829,0,0,0,8829
2022,61,368270,徳島県,三好東部火葬場管理組合,6,2,決算収支の状況,2,令和3年度,97513,96149,1364,0,1364,-961,0,0,0,-961
2022,61,368296,徳島県,徳島県市町村議会議員公務災害補償等組合,6,2,決算収支の状況,2,令和3年度,2379,636,1743,0,1743,172,1,0,0,173
2022,61,368318,徳島県,美馬西部消防組合,6,2,決算収支の状況,2,令和3年度,532677,450046,82631,0,82631,-11613,0,0,0,-11613
2022,61,368334,徳島県,松茂町ほか二町競艇事業組合,7,2,決算収支の状況,2,令和3年度,0,0,0,0,0,0,0,0,0,0
2022,61,368415,徳島県,板野東部消防組合,6,2,決算収支の状況,2,令和3年度,1092599,1056425,36174,0,36174,3917,0,0,0,3917
2022,61,368423,徳島県,板野東部青少年育成センター組合,6,2,決算収支の状況,2,令和3年度,39145,34617,4528,0,4528,-834,0,0,0,-834
2022,61,368466,徳島県,美馬地区広域行政組合,6,2,決算収支の状況,2,令和3年度,59442,53811,5631,0,5631,3322,0,0,0,3322
2022,61,368512,徳島県,板野西部消防組合,6,2,決算収支の状況,2,令和3年度,371299,356144,15155,0,15155,-1768,0,0,0,-1768
2022,61,368571,徳島県,小松島市外三町村衛生組合,6,2,決算収支の状況,2,令和3年度,439213,388781,50432,0,50432,-9264,47702,0,0,38438
2022,61,368601,徳島県,中央広域環境施設組合,6,2,決算収支の状況,2,令和3年度,1739686,1666441,73245,0,73245,-30579,1056,0,2089,-31612
2022,61,368636,徳島県,名西消防組合,6,2,決算収支の状況,2,令和3年度,572881,560601,12280,0,12280,-369,0,0,0,-369
2022,61,368644,徳島県,徳島県市町村総合事務組合,6,2,決算収支の状況,2,令和3年度,5046031,4543080,502951,0,502951,-325759,278430,0,26833,-74162
2022,61,369055,徳島県,那賀川北岸地域湛水防除施設組合,6,2,決算収支の状況,2,令和3年度,38397,35138,3259,0,3259,-83,4341,0,16800,-12542
2022,61,369063,徳島県,海部消防組合,6,2,決算収支の状況,2,令和3年度,608545,562481,46064,0,46064,-691,0,0,0,-691
2022,61,369080,徳島県,徳島中央広域連合,6,2,決算収支の状況,2,令和3年度,1308320,1267202,41118,0,41118,-45751,5311,0,4635,-45075
2022,61,369101,徳島県,みよし広域連合,6,2,決算収支の状況,2,令和3年度,1986394,1865987,120407,0,120407,3421,0,0,0,3421
2022,61,369110,徳島県,徳島県後期高齢者医療広域連合,7,2,決算収支の状況,2,令和3年度,73346,69105,4241,0,4241,2042,1,0,11151,-9108
2022,61,372013,香川県,高松市,8,2,決算収支の状況,2,令和3年度,187318575,182753513,4565062,767695,3797367,734174,4119,0,0,738293
2022,61,372021,香川県,丸亀市,3,2,決算収支の状況,2,令和3年度,59477561,58357355,1120206,311791,808415,577859,2382185,0,602000,2358044
2022,61,372030,香川県,坂出市,4,2,決算収支の状況,2,令和3年度,26310730,25425396,885334,113474,771860,470966,154991,0,0,625957
2022,61,372048,香川県,善通寺市,4,2,決算収支の状況,2,令和3年度,18606699,17287529,1319170,347806,971364,273843,101315,0,229134,146024
2022,61,372056,香川県,観音寺市,4,2,決算収支の状況,2,令和3年度,33755281,32066431,1688850,168917,1519933,381035,1527,34087,500000,-83351
2022,61,372064,香川県,さぬき市,4,2,決算収支の状況,2,令和3年度,28553095,27104272,1448823,227311,1221512,347719,408833,0,500000,256552
2022,61,372072,香川県,東かがわ市,4,2,決算収支の状況,2,令和3年度,19839727,18493400,1346327,108055,1238272,320957,463446,0,0,784403
2022,61,372081,香川県,三豊市,4,2,決算収支の状況,2,令和3年度,39335313,38106681,1228632,305535,923097,-260220,613592,0,1167458,-814086
2022,61,373222,香川県,土庄町,5,2,決算収支の状況,2,令和3年度,11319252,9999072,1320180,98192,1221988,130961,1465,0,350000,-217574
2022,61,373249,香川県,小豆島町,5,2,決算収支の状況,2,令和3年度,11985301,11057283,928018,79678,848340,435386,2233,0,0,437619
2022,61,373419,香川県,三木町,5,2,決算収支の状況,2,令和3年度,14060260,13193258,867002,42176,824826,271565,1633290,0,1417511,487344
2022,61,373648,香川県,直島町,5,2,決算収支の状況,2,令和3年度,4202360,4007252,195108,5896,189212,-18936,286100,0,286200,-19036
2022,61,373869,香川県,宇多津町,5,2,決算収支の状況,2,令和3年度,8691750,8090898,600852,8747,592105,141737,386537,0,0,528274
2022,61,373877,香川県,綾川町,5,2,決算収支の状況,2,令和3年度,11583530,10659785,923745,260942,662803,169236,23223,0,0,192459
2022,61,374032,香川県,琴平町,5,2,決算収支の状況,2,令和3年度,5115611,4760478,355133,28647,326486,211273,46484,0,0,257757
2022,61,374041,香川県,多度津町,5,2,決算収支の状況,2,令和3年度,14399965,13479004,920961,285783,635178,113271,32,0,500000,-386697
2022,61,374067,香川県,まんのう町,5,2,決算収支の状況,2,令和3年度,12526641,12103110,423531,86520,337011,-30437,294916,0,0,264479
2022,61,378046,香川県,まんのう町外二ヶ市町（十郷地区）山林組合,6,2,決算収支の状況,2,令和3年度,8134,5918,2216,0,2216,958,0,0,0,958
2022,61,378054,香川県,まんのう町外三ヶ市町山林組合,6,2,決算収支の状況,2,令和3年度,516,361,155,0,155,-33,300,0,0,267
2022,61,378062,香川県,まんのう町外三ヶ市町（七箇地区）山林組合,6,2,決算収支の状況,2,令和3年度,8851,5384,3467,0,3467,-188,500,0,0,312
2022,61,378097,香川県,伝法川防災溜池事業組合,6,2,決算収支の状況,2,令和3年度,2211,2028,183,0,183,-21,0,0,0,-21
2022,61,378381,香川県,香川県三豊市観音寺市学校組合,6,2,決算収支の状況,2,令和3年度,182596,174359,8237,0,8237,5197,0,0,0,5197
2022,61,378488,香川県,香川県市町総合事務組合,6,2,決算収支の状況,2,令和3年度,3996167,3590623,405544,0,405544,-46526,0,0,0,-46526
2022,61,378526,香川県,香川県中部広域競艇事業組合,7,2,決算収支の状況,2,令和3年度,0,0,0,0,0,0,0,0,0,0
2022,61,378542,香川県,仲多度南部消防組合,6,2,決算収支の状況,2,令和3年度,666772,660730,6042,0,6042,622,349,0,2300,-1329
2022,61,378585,香川県,大川広域行政組合,6,2,決算収支の状況,2,令和3年度,1870188,1855931,14257,0,14257,-9203,21464,0,18403,-6142
2022,61,378607,香川県,さぬき市・三木町山林組合,6,2,決算収支の状況,2,令和3年度,4939,4774,165,0,165,-712,2828,0,1234,882
2022,61,378615,香川県,東かがわ市外一市一町組合,6,2,決算収支の状況,2,令和3年度,801,424,377,0,377,-24,0,0,0,-24
2022,61,378640,香川県,三観広域行政組合,6,2,決算収支の状況,2,令和3年度,2887161,2817724,69437,0,69437,-42738,0,0,0,-42738
2022,61,378666,香川県,小豆地区広域行政事務組合,6,2,決算収支の状況,2,令和3年度,1315768,1297085,18683,0,18683,-342,13211,0,0,12869
2022,61,378674,香川県,中讃広域行政事務組合,6,2,決算収支の状況,2,令和3年度,3144086,3091112,52974,0,52974,-7408,123038,0,96535,19095
2022,61,378691,香川県,坂出、宇多津広域行政事務組合,6,2,決算収支の状況,2,令和3年度,775235,775231,4,0,4,-3,0,0,0,-3
2022,61,378828,香川県,香川県東部清掃施設組合,6,2,決算収支の状況,2,令和3年度,967776,930158,37618,0,37618,8439,28181,0,30377,6243
2022,61,378836,香川県,三木・長尾葬斎組合,6,2,決算収支の状況,2,令和3年度,91160,88412,2748,0,2748,-988,0,0,1000,-1988
2022,61,378861,香川県,香川県後期高齢者医療広域連合,7,2,決算収支の状況,2,令和3年度,194850,158165,36685,0,36685,48,0,0,0,48
2022,61,382019,愛媛県,松山市,8,2,決算収支の状況,2,令和3年度,231637722,226541635,5096087,1545814,3550273,661722,100000,0,1500000,-738278
2022,61,382027,愛媛県,今治市,3,2,決算収支の状況,2,令和3年度,85821615,79896349,5925266,321146,5604120,1608500,1874458,0,0,3482958
2022,61,382035,愛媛県,宇和島市,4,2,決算収支の状況,2,令和3年度,54169252,50926348,3242904,1074999,2167905,380912,2100,0,0,383012
2022,61,382043,愛媛県,八幡浜市,4,2,決算収支の状況,2,令和3年度,26353627,25075380,1278247,123385,1154862,1088945,33350,0,0,1122295
2022,61,382051,愛媛県,新居浜市,3,2,決算収支の状況,2,令和3年度,58143712,57052076,1091636,107718,983918,82341,889577,0,1400000,-428082
2022,61,382060,愛媛県,西条市,3,2,決算収支の状況,2,令和3年度,57661953,53822004,3839949,41559,3798390,741094,2501268,0,1411348,1831014
2022,61,382078,愛媛県,大洲市,4,2,決算収支の状況,2,令和3年度,35545358,31584148,3961210,238073,3723137,1432954,340,79492,0,1512786
2022,61,382108,愛媛県,伊予市,4,2,決算収支の状況,2,令和3年度,20542748,18880194,1662554,22175,1640379,785511,238,0,0,785749
2022,61,382132,愛媛県,四国中央市,4,2,決算収支の状況,2,令和3年度,46740340,42211058,4529282,351228,4178054,954890,313,0,0,955203
2022,61,382141,愛媛県,西予市,4,2,決算収支の状況,2,令和3年度,34289187,32427295,1861892,313393,1548499,520386,851859,0,1098412,273833
2022,61,382159,愛媛県,東温市,4,2,決算収支の状況,2,令和3年度,19098321,17910584,1187737,39177,1148560,276874,612336,0,230000,659210
2022,61,383562,愛媛県,上島町,5,2,決算収支の状況,2,令和3年度,7210984,7047098,163886,29985,133901,86965,317,0,0,87282
2022,61,383864,愛媛県,久万高原町,5,2,決算収支の状況,2,令和3年度,11474271,10470488,1003783,176783,827000,147895,22044,0,300000,-130061
2022,61,384011,愛媛県,松前町,5,2,決算収支の状況,2,令和3年度,13575925,12825451,750474,12490,737984,329990,204009,0,55988,478011
2022,61,384020,愛媛県,砥部町,5,2,決算収支の状況,2,令和3年度,10115038,8814129,1300909,75316,1225593,149891,115,0,100000,50006
2022,61,384224,愛媛県,内子町,5,2,決算収支の状況,2,令和3年度,12188111,11735623,452488,163573,288915,-73048,89275,0,0,16227
2022,61,384429,愛媛県,伊方町,5,2,決算収支の状況,2,令和3年度,11462882,10128924,1333958,126381,1207577,462660,876569,0,0,1339229
2022,61,384844,愛媛県,松野町,5,2,決算収支の状況,2,令和3年度,5539096,5302419,236677,10630,226047,159889,639,0,0,160528
2022,61,384887,愛媛県,鬼北町,5,2,決算収支の状況,2,令和3年度,9081763,8716976,364787,32593,332194,168937,1103,0,8600,161440
2022,61,385069,愛媛県,愛南町,5,2,決算収支の状況,2,令和3年度,17443149,16566543,876606,107069,769537,130738,217300,0,0,348038
2022,61,388262,愛媛県,松山衛生事務組合,6,2,決算収支の状況,2,令和3年度,728628,651333,77295,0,77295,16353,0,0,0,16353
2022,61,388289,愛媛県,愛媛県市町総合事務組合,6,2,決算収支の状況,2,令和3年度,9432718,9112704,320014,0,320014,-204622,136000,0,135825,-204447
2022,61,388327,愛媛県,松山市、東温市共有山林組合,6,2,決算収支の状況,2,令和3年度,71202,7220,63982,0,63982,3068,0,0,0,3068
2022,61,388343,愛媛県,松山養護老人ホーム事務組合,6,2,決算収支の状況,2,令和3年度,502277,433411,68866,0,68866,-3352,0,0,0,-3352
2022,61,388408,愛媛県,伊予市・松前町共立衛生組合,6,2,決算収支の状況,2,令和3年度,183734,178424,5310,0,5310,-907,0,0,0,-907
2022,61,388416,愛媛県,伊予市・伊予郡養護老人ホーム組合,6,2,決算収支の状況,2,令和3年度,282678,270239,12439,0,12439,-1783,0,0,0,-1783
2022,61,388424,愛媛県,大洲・喜多衛生事務組合,6,2,決算収支の状況,2,令和3年度,215124,182234,32890,0,32890,-29142,0,0,0,-29142
2022,61,388599,愛媛県,高知県宿毛市愛媛県南宇和郡愛南町篠山小中学校組合,6,2,決算収支の状況,2,令和3年度,37251,35336,1915,0,1915,-109,0,0,0,-109
2022,61,388629,愛媛県,八幡浜地区施設事務組合,6,2,決算収支の状況,2,令和3年度,1287778,1237868,49910,0,49910,7782,0,0,0,7782
2022,61,388653,愛媛県,伊予地区ごみ処理施設管理組合,6,2,決算収支の状況,2,令和3年度,471393,410195,61198,0,61198,855,0,0,0,855
2022,61,388696,愛媛県,大洲喜多特別養護老人ホーム事務組合,6,2,決算収支の状況,2,令和3年度,348042,249161,98881,0,98881,31134,0,0,0,31134
2022,61,388858,愛媛県,伊予消防等事務組合,6,2,決算収支の状況,2,令和3年度,1638728,1604257,34471,314,34157,-9012,0,0,0,-9012
2022,61,388882,愛媛県,宇和島地区広域事務組合,6,2,決算収支の状況,2,令和3年度,3692636,3233192,459444,4730,454714,14287,0,0,0,14287
2022,61,388891,愛媛県,伊予市外二町共有物組合,6,2,決算収支の状況,2,令和3年度,10053,5958,4095,0,4095,-52,2650,0,0,2598
2022,61,388963,愛媛県,大洲地区広域消防事務組合,6,2,決算収支の状況,2,令和3年度,980217,959456,20761,0,20761,-13093,0,0,0,-13093
2022,61,388980,愛媛県,松山広域福祉施設事務組合,6,2,決算収支の状況,2,令和3年度,485340,402249,83091,0,83091,-6899,0,0,0,-6899
2022,61,389048,愛媛県,八幡浜・大洲地区広域市町村圏組合（普通会計分）,6,2,決算収支の状況,2,令和3年度,428191,419396,8795,0,8795,-7181,0,0,0,-7181
2022,61,389111,愛媛県,愛媛地方税滞納整理機構,6,2,決算収支の状況,2,令和3年度,163186,95608,67578,0,67578,-5230,0,0,0,-5230
2022,61,389129,愛媛県,愛媛県後期高齢者医療広域連合,7,2,決算収支の状況,2,令和3年度,82090,68095,13995,0,13995,3867,0,0,0,3867
2022,61,392014,高知県,高知市,8,2,決算収支の状況,2,令和3年度,168628997,161151284,7477713,2590930,4886783,4341637,65,60,0,4341762
2022,61,392022,高知県,室戸市,4,2,決算収支の状況,2,令和3年度,16541017,15757270,783747,215881,567866,160477,438245,0,0,598722
2022,61,392031,高知県,安芸市,4,2,決算収支の状況,2,令和3年度,18779481,17867704,911777,447234,464543,236477,606,425451,0,662534
2022,61,392049,高知県,南国市,4,2,決算収支の状況,2,令和3年度,28749406,27513511,1235895,217451,1018444,480197,665,0,300000,180862
2022,61,392057,高知県,土佐市,4,2,決算収支の状況,2,令和3年度,17153799,16422118,731681,218760,512921,388897,981,370978,0,760856
2022,61,392065,高知県,須崎市,4,2,決算収支の状況,2,令和3年度,18945082,17999302,945780,24928,920852,635008,495,0,0,635503
2022,61,392081,高知県,宿毛市,4,2,決算収支の状況,2,令和3年度,18918580,17797832,1120748,337592,783156,459339,1264,0,0,460603
2022,61,392090,高知県,土佐清水市,4,2,決算収支の状況,2,令和3年度,11539180,11165534,373646,62951,310695,159838,80088,0,0,239926
2022,61,392103,高知県,四万十市,4,2,決算収支の状況,2,令和3年度,26035343,25166451,868892,487117,381775,-11044,779,0,0,-10265
2022,61,392111,高知県,香南市,4,2,決算収支の状況,2,令和3年度,20862531,20210573,651958,241346,410612,82772,165533,0,0,248305
2022,61,392120,高知県,香美市,4,2,決算収支の状況,2,令和3年度,19473391,18742196,731195,178342,552853,392008,7856,0,0,399864
2022,61,393011,高知県,東洋町,5,2,決算収支の状況,2,令和3年度,3815908,3768070,47838,31521,16317,188,10100,0,0,10288
2022,61,393029,高知県,奈半利町,5,2,決算収支の状況,2,令和3年度,3457995,3344628,113367,70211,43156,10112,327260,1,0,337373
2022,61,393037,高知県,田野町,5,2,決算収支の状況,2,令和3年度,4609877,4555780,54097,8647,45450,-7770,4803,0,0,-2967
2022,61,393045,高知県,安田町,5,2,決算収支の状況,2,令和3年度,3655125,3566040,89085,7096,81989,35392,98210,0,0,133602
2022,61,393053,高知県,北川村,5,2,決算収支の状況,2,令和3年度,2513034,2312281,200753,25773,174980,155620,17308,13900,0,186828
2022,61,393061,高知県,馬路村,5,2,決算収支の状況,2,令和3年度,2578757,2450476,128281,45487,82794,-4432,18005,0,30000,-16427
2022,61,393070,高知県,芸西村,5,2,決算収支の状況,2,令和3年度,6027077,5821722,205355,28533,176822,42322,388,0,0,42710
2022,61,393410,高知県,本山町,5,2,決算収支の状況,2,令和3年度,5399594,5290673,108921,39500,69421,42791,100,0,0,42891
2022,61,393444,高知県,大豊町,5,2,決算収支の状況,2,令和3年度,7466592,7173272,293320,194527,98793,-94124,1854,0,0,-92270
2022,61,393631,高知県,土佐町,5,2,決算収支の状況,2,令和3年度,4969267,4890687,78580,39765,38815,-11712,500000,0,200000,288288
2022,61,393649,高知県,大川村,5,2,決算収支の状況,2,令和3年度,1516239,1457810,58429,5994,52435,-8678,68918,0,13911,46329
2022,61,393860,高知県,いの町,5,2,決算収支の状況,2,令和3年度,16229989,15904017,325972,89473,236499,46598,1942,0,0,48540
2022,61,393878,高知県,仁淀川町,5,2,決算収支の状況,2,令和3年度,8418841,7862434,556407,117285,439122,72708,976,942741,15926,1000499
2022,61,394017,高知県,中土佐町,5,2,決算収支の状況,2,令和3年度,8412792,7884858,527934,54674,473260,31172,2386,588500,0,622058
2022,61,394025,高知県,佐川町,5,2,決算収支の状況,2,令和3年度,9379503,9222445,157058,46335,110723,-117135,3628,0,0,-113507
2022,61,394033,高知県,越知町,5,2,決算収支の状況,2,令和3年度,5723067,5585724,137343,51546,85797,84384,981,0,0,85365
2022,61,394050,高知県,梼原町,5,2,決算収支の状況,2,令和3年度,7001431,6912008,89423,46166,43257,12628,244221,74696,0,331545
2022,61,394106,高知県,日高村,5,2,決算収支の状況,2,令和3年度,6358572,6037360,321212,288066,33146,-873,70220,267600,0,336947
2022,61,394114,高知県,津野町,5,2,決算収支の状況,2,令和3年度,8194511,7990481,204030,32630,171400,-17751,3690,945241,0,931180
2022,61,394122,高知県,四万十町,5,2,決算収支の状況,2,令和3年度,20725538,19919052,806486,229226,577260,182082,6573,393825,0,582480
2022,61,394246,高知県,大月町,5,2,決算収支の状況,2,令和3年度,5445644,5119930,325714,84489,241225,204520,91445,0,0,295965
2022,61,394271,高知県,三原村,5,2,決算収支の状況,2,令和3年度,2204837,2109240,95597,46514,49083,20490,80645,0,0,101135
2022,61,394289,高知県,黒潮町,5,2,決算収支の状況,2,令和3年度,11674010,11127854,546156,217072,329084,75059,676,0,0,75735
2022,61,398055,高知県,香美郡殖林組合,6,2,決算収支の状況,2,令和3年度,1026,461,565,0,565,-461,0,0,0,-461
2022,61,398209,高知県,香南香美衛生組合,6,2,決算収支の状況,2,令和3年度,155815,147994,7821,0,7821,-9191,0,0,8000,-17191
2022,61,398225,高知県,仁淀川下流衛生事務組合,6,2,決算収支の状況,2,令和3年度,305811,277929,27882,0,27882,-13296,0,0,0,-13296
2022,61,398233,高知県,高吾北広域町村事務組合,6,2,決算収支の状況,2,令和3年度,1450320,1131293,319027,0,319027,-3496,54,0,0,-3442
2022,61,398250,高知県,香南斎場組合,6,2,決算収支の状況,2,令和3年度,313535,307367,6168,0,6168,642,2814,0,0,3456
2022,61,398284,高知県,香南香美老人ホーム組合,6,2,決算収支の状況,2,令和3年度,211833,209778,2055,0,2055,-7909,4984,0,0,-2925
2022,61,398331,高知県,日高村佐川町学校組合,6,2,決算収支の状況,2,令和3年度,167870,158795,9075,0,9075,-11969,17045,0,0,5076
2022,61,398357,高知県,高知県競馬組合,7,2,決算収支の状況,2,令和3年度,0,0,0,0,0,0,0,0,0,0
2022,61,398403,高知県,香南清掃組合,6,2,決算収支の状況,2,令和3年度,934289,891888,42401,0,42401,12515,0,0,0,12515
2022,61,398446,高知県,幡多広域市町村圏事務組合,6,2,決算収支の状況,2,令和3年度,1133591,1125944,7647,0,7647,-1824,0,0,0,-1824
2022,61,398462,高知県,高幡消防組合,6,2,決算収支の状況,2,令和3年度,1400450,1400450,0,0,0,0,0,0,0,0
2022,61,398489,高知県,幡多中央環境施設組合,6,2,決算収支の状況,2,令和3年度,60805,60805,0,0,0,0,0,0,0,0
2022,61,398501,高知県,津野山養護老人ホーム組合,6,2,決算収支の状況,2,令和3年度,134218,133929,289,0,289,-108,0,0,0,-108
2022,61,398519,高知県,高陵特別養護老人ホーム組合,6,2,決算収支の状況,2,令和3年度,15459,15459,0,0,0,0,0,0,0,0
2022,61,398535,高知県,津野山広域事務組合,6,2,決算収支の状況,2,令和3年度,70912,57842,13070,0,13070,-347,0,0,0,-347
2022,61,398543,高知県,高幡東部清掃組合,6,2,決算収支の状況,2,令和3年度,827958,763711,64247,48400,15847,15847,158,0,146227,-130222
2022,61,398608,高知県,仁淀消防組合,6,2,決算収支の状況,2,令和3年度,718151,703869,14282,0,14282,-9190,0,0,0,-9190
2022,61,398624,高知県,幡多中央消防組合,6,2,決算収支の状況,2,令和3年度,911984,911984,0,0,0,0,0,0,0,0
2022,61,398675,高知県,幡多西部消防組合,6,2,決算収支の状況,2,令和3年度,616519,616519,0,0,0,0,0,0,0,0
2022,61,398705,高知県,高知県広域食肉センター事務組合,6,2,決算収支の状況,2,令和3年度,16601,16121,480,0,480,-1557,0,0,0,-1557
2022,61,398713,高知県,嶺北広域行政事務組合,6,2,決算収支の状況,2,令和3年度,805772,781181,24591,0,24591,4823,0,0,0,4823
2022,61,398721,高知県,高幡障害者支援施設組合,6,2,決算収支の状況,2,令和3年度,25696,25606,90,0,90,0,0,0,0,0
2022,61,398730,高知県,安芸広域市町村圏事務組合,6,2,決算収支の状況,2,令和3年度,825125,788025,37100,0,37100,-11672,7837,0,574,-4409
2022,61,398748,高知県,高幡広域市町村圏事務組合,6,2,決算収支の状況,2,令和3年度,144384,144384,0,0,0,0,0,0,0,0
2022,61,398764,高知県,仁淀川広域市町村圏事務組合,6,2,決算収支の状況,2,令和3年度,20825,12213,8612,0,8612,-6641,0,0,0,-6641
2022,61,398781,高知県,中芸広域連合,6,2,決算収支の状況,2,令和3年度,1413471,1335560,77911,1375,76536,19918,0,0,0,19918
2022,61,398802,高知県,高知中央西部焼却処理事務組合,6,2,決算収支の状況,2,令和3年度,591378,550167,41211,0,41211,-6835,0,0,0,-6835
2022,61,398811,高知県,こうち人づくり広域連合,6,2,決算収支の状況,2,令和3年度,131259,122415,8844,0,8844,-3111,0,0,0,-3111
2022,61,398829,高知県,高知県市町村総合事務組合,6,2,決算収支の状況,2,令和3年度,5084224,4696209,388015,0,388015,-555304,2,0,1,-555303
2022,61,398845,高知県,高知県後期高齢者医療広域連合,7,2,決算収支の状況,2,令和3年度,60706,50544,10162,0,10162,2163,4000,0,4000,2163
2022,61,398853,高知県,南国・香南・香美租税債権管理機構,6,2,決算収支の状況,2,令和3年度,55340,55340,0,0,0,0,0,0,0,0
2022,61,401005,福岡県,北九州市,1,2,決算収支の状況,2,令和3年度,651472746,643026372,8446374,3350286,5096088,2165170,6592100,0,0,8757270
2022,61,401307,福岡県,福岡市,1,2,決算収支の状況,2,令和3年度,1177937693,1161028164,16909529,6002679,10906850,2274971,4426550,0,5700000,1001521
2022,61,402028,福岡県,大牟田市,3,2,決算収支の状況,2,令和3年度,65645640,64730605,915035,365886,549149,491020,562053,0,0,1053073
2022,61,402036,福岡県,久留米市,8,2,決算収支の状況,2,令和3年度,158053036,156685656,1367380,371734,995646,6494,895073,0,0,901567
2022,61,402044,福岡県,直方市,4,2,決算収支の状況,2,令和3年度,31665200,29542604,2122596,120945,2001651,988806,9746,0,0,998552
2022,61,402052,福岡県,飯塚市,3,2,決算収支の状況,2,令和3年度,86199683,82318386,3881297,503261,3378036,2250852,63348,0,0,2314200
2022,61,402061,福岡県,田川市,4,2,決算収支の状況,2,令和3年度,35857474,34724073,1133401,136991,996410,587785,21,0,0,587806
2022,61,402079,福岡県,柳川市,4,2,決算収支の状況,2,令和3年度,38303848,36546541,1757307,78891,1678416,904119,31259,0,0,935378
2022,61,402109,福岡県,八女市,4,2,決算収支の状況,2,令和3年度,46757171,44350643,2406528,1071442,1335086,770585,19053,231650,0,1021288
2022,61,402117,福岡県,筑後市,4,2,決算収支の状況,2,令和3年度,24095256,22050362,2044894,281490,1763404,891184,3778,0,0,894962
2022,61,402125,福岡県,大川市,4,2,決算収支の状況,2,令和3年度,19883941,18760756,1123185,130595,992590,876126,1013,0,0,877139
2022,61,402133,福岡県,行橋市,4,2,決算収支の状況,2,令和3年度,34781333,34017703,763630,209037,554593,-31742,1049653,0,0,1017911
2022,61,402141,福岡県,豊前市,4,2,決算収支の状況,2,令和3年度,13702940,13220380,482560,39802,442758,281786,1145,748,40000,243679
2022,61,402150,福岡県,中間市,4,2,決算収支の状況,2,令和3年度,22109469,21090165,1019304,510,1018794,294011,1427150,0,0,1721161
2022,61,402168,福岡県,小郡市,4,2,決算収支の状況,2,令和3年度,24951515,24576048,375467,53926,321541,71298,1475885,0,0,1547183
2022,61,402176,福岡県,筑紫野市,3,2,決算収支の状況,2,令和3年度,40104105,38231549,1872556,400065,1472491,471342,1135070,0,0,1606412
2022,61,402184,福岡県,春日市,3,2,決算収支の状況,2,令和3年度,44000150,41520814,2479336,239377,2239959,1015954,74000,4152,73826,1020280
2022,61,402192,福岡県,大野城市,3,2,決算収支の状況,2,令和3年度,43729205,41947189,1782016,16804,1765212,776435,135260,1530193,597742,1844146
2022,61,402206,福岡県,宗像市,4,2,決算収支の状況,2,令和3年度,43060045,40541851,2518194,399999,2118195,1156981,23543,0,0,1180524
2022,61,402214,福岡県,太宰府市,4,2,決算収支の状況,2,令和3年度,30651443,28169896,2481547,345426,2136121,845024,29757,0,0,874781
2022,61,402231,福岡県,古賀市,4,2,決算収支の状況,2,令和3年度,27390338,25185265,2205073,92969,2112104,613440,758636,0,0,1372076
2022,61,402249,福岡県,福津市,4,2,決算収支の状況,2,令和3年度,30438652,29585719,852933,337359,515574,-167266,20488,0,0,-146778
2022,61,402257,福岡県,うきは市,4,2,決算収支の状況,2,令和3年度,18721121,17693579,1027542,137906,889636,199171,268227,0,0,467398
2022,61,402265,福岡県,宮若市,4,2,決算収支の状況,2,令和3年度,22620810,21212360,1408450,153523,1254927,702955,1146,0,0,704101
2022,61,402273,福岡県,嘉麻市,4,2,決算収支の状況,2,令和3年度,28328538,27463754,864784,270393,594391,15456,5556,0,0,21012
2022,61,402281,福岡県,朝倉市,4,2,決算収支の状況,2,令和3年度,42420072,40707843,1712229,753602,958627,-4360,23258,1480817,0,1499715
2022,61,402290,福岡県,みやま市,4,2,決算収支の状況,2,令和3年度,25841254,24832406,1008848,205048,803800,205586,303115,0,100000,408701
2022,61,402303,福岡県,糸島市,4,2,決算収支の状況,2,令和3年度,46968080,45447688,1520392,104204,1416188,551615,1720642,0,0,2272257
2022,61,402311,福岡県,那珂川市,4,2,決算収支の状況,2,令和3年度,22961041,22250365,710676,52044,658632,402325,405663,574689,0,1382677
2022,61,403415,福岡県,宇美町,5,2,決算収支の状況,2,令和3年度,15347518,14568462,779056,141750,637306,181525,392269,0,131283,442511
2022,61,403423,福岡県,篠栗町,5,2,決算収支の状況,2,令和3年度,13185060,11589999,1595061,303,1594758,963614,509734,0,0,1473348
2022,61,403431,福岡県,志免町,5,2,決算収支の状況,2,令和3年度,18838917,17524315,1314602,0,1314602,465863,747312,0,0,1213175
2022,61,403440,福岡県,須恵町,5,2,決算収支の状況,2,令和3年度,11864801,11480015,384786,2686,382100,-34207,607526,0,1000,572319
2022,61,403458,福岡県,新宮町,5,2,決算収支の状況,2,令和3年度,19012125,18263881,748244,136265,611979,258631,301286,0,0,559917
2022,61,403482,福岡県,久山町,5,2,決算収支の状況,2,令和3年度,6613537,6067014,546523,17048,529475,205565,580325,0,0,785890
2022,61,403491,福岡県,粕屋町,5,2,決算収支の状況,2,令和3年度,20354178,19413268,940910,63903,877007,329450,934869,0,528963,735356
2022,61,403814,福岡県,芦屋町,5,2,決算収支の状況,2,令和3年度,9808282,9448079,360203,30843,329360,-41290,612087,0,710,570087
2022,61,403822,福岡県,水巻町,5,2,決算収支の状況,2,令和3年度,12638020,11993397,644623,25675,618948,224866,899,0,0,225765
2022,61,403831,福岡県,岡垣町,5,2,決算収支の状況,2,令和3年度,12829386,12159384,670002,0,670002,219502,2333,0,0,221835
2022,61,403849,福岡県,遠賀町,5,2,決算収支の状況,2,令和3年度,9919497,9398015,521482,159434,362048,170746,28210,0,0,198956
2022,61,404012,福岡県,小竹町,5,2,決算収支の状況,2,令和3年度,5654263,5390412,263851,33549,230302,106951,0,0,0,106951
2022,61,404021,福岡県,鞍手町,5,2,決算収支の状況,2,令和3年度,14126449,13523949,602500,27005,575495,503078,512,0,0,503590
2022,61,404217,福岡県,桂川町,5,2,決算収支の状況,2,令和3年度,7122357,6735831,386526,4802,381724,30941,1052,0,0,31993
2022,61,404471,福岡県,筑前町,5,2,決算収支の状況,2,令和3年度,14366298,13752641,613657,8407,605250,301560,150869,0,0,452429
2022,61,404489,福岡県,東峰村,5,2,決算収支の状況,2,令和3年度,4580297,4348375,231922,113985,117937,49687,1744,0,0,51431
2022,61,405035,福岡県,大刀洗町,5,2,決算収支の状況,2,令和3年度,9251691,8505370,746321,107737,638584,199217,58416,0,0,257633
2022,61,405221,福岡県,大木町,5,2,決算収支の状況,2,令和3年度,7521875,6913338,608537,94428,514109,26813,159000,0,0,185813
2022,61,405442,福岡県,広川町,5,2,決算収支の状況,2,令和3年度,9673170,9166700,506470,29744,476726,301767,5857,0,0,307624
2022,61,406015,福岡県,香春町,5,2,決算収支の状況,2,令和3年度,7645556,7086648,558908,5210,553698,195451,407,0,0,195858
2022,61,406023,福岡県,添田町,5,2,決算収支の状況,2,令和3年度,8388154,7844485,543669,40763,502906,184368,119380,0,0,303748
2022,61,406040,福岡県,糸田町,5,2,決算収支の状況,2,令和3年度,7733601,7217349,516252,93309,422943,17747,13930,80099,0,111776
2022,61,406058,福岡県,川崎町,5,2,決算収支の状況,2,令和3年度,11992707,11702274,290433,122977,167456,115763,250000,0,0,365763
2022,61,406082,福岡県,大任町,5,2,決算収支の状況,2,令和3年度,8143600,7555895,587705,185,587520,-217908,439480,269286,23527,467331
2022,61,406091,福岡県,赤村,5,2,決算収支の状況,2,令和3年度,3717418,3673536,43882,3257,40625,2486,17176,240615,16196,244081
2022,61,406104,福岡県,福智町,5,2,決算収支の状況,2,令和3年度,21503033,19841062,1661971,6629,1655342,468081,22213,0,0,490294
2022,61,406210,福岡県,苅田町,5,2,決算収支の状況,2,令和3年度,17450892,16546104,904788,67244,837544,99100,32,0,216000,-116868
2022,61,406252,福岡県,みやこ町,5,2,決算収支の状況,2,令和3年度,13847489,12252844,1594645,556527,1038118,484473,461,0,0,484934
2022,61,406422,福岡県,吉富町,5,2,決算収支の状況,2,令和3年度,4372656,4117743,254913,28171,226742,26434,614,0,0,27048
2022,61,406465,福岡県,上毛町,5,2,決算収支の状況,2,令和3年度,7213188,6779753,433435,12007,421428,30849,201960,0,202050,30759
2022,61,406473,福岡県,築上町,5,2,決算収支の状況,2,令和3年度,13551520,12736336,815184,138880,676304,142213,115755,0,0,257968
2022,61,408026,福岡県,粕屋郡粕屋町外１市水利組合,6,2,決算収支の状況,2,令和3年度,10857,8053,2804,0,2804,-43,0,0,0,-43
2022,61,408034,福岡県,直方市・北九州市岡森用水組合,6,2,決算収支の状況,2,令和3年度,38624,36578,2046,0,2046,-2315,2201,0,0,-114
2022,61,408042,福岡県,柳川みやま土木組合,6,2,決算収支の状況,2,令和3年度,231607,214829,16778,7800,8978,-6265,7700,0,11200,-9765
2022,61,408051,福岡県,花宗太田土木組合,6,2,決算収支の状況,2,令和3年度,176322,168337,7985,0,7985,-1532,22,0,0,-1510
2022,61,408069,福岡県,花宗用水組合,6,2,決算収支の状況,2,令和3年度,85712,67649,18063,16550,1513,1264,1,0,16550,-15285
2022,61,408077,福岡県,山の井用水組合,6,2,決算収支の状況,2,令和3年度,11340,10305,1035,0,1035,-192,0,0,4322,-4514
2022,61,408085,福岡県,福岡県中間市外二ケ町山田川水利組合,6,2,決算収支の状況,2,令和3年度,69380,37557,31823,0,31823,17469,63,0,0,17532
2022,61,408107,福岡県,堀川水利組合,6,2,決算収支の状況,2,令和3年度,1650,730,920,0,920,94,0,0,0,94
2022,61,408123,福岡県,上毛町外一市一町矢方池土木組合,6,2,決算収支の状況,2,令和3年度,3632,2538,1094,0,1094,-30,907,0,0,877
2022,61,408247,福岡県,吉富町外１町環境衛生事務組合,6,2,決算収支の状況,2,令和3年度,79325,75454,3871,0,3871,-1309,0,0,0,-1309
2022,61,408379,福岡県,玄界環境組合,6,2,決算収支の状況,2,令和3年度,3344133,3290117,54016,0,54016,9062,7358,0,273108,-256688
2022,61,408395,福岡県,大川柳川衛生組合,6,2,決算収支の状況,2,令和3年度,216758,190103,26655,0,26655,3075,1,0,0,3076
2022,61,408409,福岡県,うきは久留米環境施設組合,6,2,決算収支の状況,2,令和3年度,953144,809961,143183,0,143183,33761,0,0,0,33761
2022,61,408468,福岡県,両筑衛生施設組合,6,2,決算収支の状況,2,令和3年度,191636,148058,43578,0,43578,-19847,0,0,0,-19847
2022,61,408573,福岡県,吉富町外一市中学校組合,6,2,決算収支の状況,2,令和3年度,118313,110003,8310,0,8310,-3548,1,0,0,-3547
2022,61,408620,福岡県,久留米市外三市町高等学校組合,6,2,決算収支の状況,2,令和3年度,329928,321129,8799,0,8799,824,1,0,7510,-6685
2022,61,408638,福岡県,古賀高等学校組合,6,2,決算収支の状況,2,令和3年度,622592,615144,7448,0,7448,-3555,5505,0,29563,-27613
2022,61,408697,福岡県,福岡県市町村消防団員等公務災害補償組合,6,2,決算収支の状況,2,令和3年度,85971,82917,3054,0,3054,990,0,0,0,990
2022,61,408719,福岡県,福岡県市町村職員退職手当組合,6,2,決算収支の状況,2,令和3年度,10524453,10507497,16956,0,16956,-10042,0,0,0,-10042
2022,61,408727,福岡県,福岡県自治会館管理組合,6,2,決算収支の状況,2,令和3年度,189319,181845,7474,0,7474,-2687,32918,0,0,30231
2022,61,408735,福岡県,糟屋郡自治会館組合,6,2,決算収支の状況,2,令和3年度,21165,19886,1279,0,1279,746,0,0,0,746
2022,61,408751,福岡県,筑紫自治振興組合,6,2,決算収支の状況,2,令和3年度,46641,42784,3857,0,3857,307,0,0,0,307
2022,61,408778,福岡県,糟屋郡篠栗町外一市五町財産組合,6,2,決算収支の状況,2,令和3年度,111380,81871,29509,0,29509,-2911,65,0,10394,-13240
2022,61,408808,福岡県,豊前市外二町財産組合,6,2,決算収支の状況,2,令和3年度,6321,1465,4856,0,4856,535,0,0,0,535
2022,61,408891,福岡県,八女地区消防組合,6,2,決算収支の状況,2,令和3年度,1332432,1304478,27954,0,27954,-20354,0,0,0,-20354
2022,61,408913,福岡県,中間市行橋市競艇組合,7,2,決算収支の状況,2,令和3年度,0,0,0,0,0,0,0,0,0,0
2022,61,408921,福岡県,筑紫野太宰府消防組合,6,2,決算収支の状況,2,令和3年度,1794863,1782506,12357,0,12357,-6329,6,0,0,-6323
2022,61,408930,福岡県,飯塚地区消防組合,6,2,決算収支の状況,2,令和3年度,2879365,2838144,41221,0,41221,-29543,514075,0,165142,319390
2022,61,408956,福岡県,春日・大野城・那珂川消防組合,6,2,決算収支の状況,2,令和3年度,2645477,2600582,44895,0,44895,-22313,0,0,0,-22313
2022,61,408964,福岡県,福岡県田川地区消防組合,6,2,決算収支の状況,2,令和3年度,1916144,1895492,20652,0,20652,2156,96922,0,41188,57890
2022,61,408972,福岡県,北筑昇華苑組合,6,2,決算収支の状況,2,令和3年度,395687,347789,47898,0,47898,-30370,40000,0,0,9630
2022,61,408981,福岡県,久留米広域市町村圏事務組合,6,2,決算収支の状況,2,令和3年度,5269425,4538906,730519,0,730519,84638,1,0,0,84639
2022,61,408999,福岡県,京築広域市町村圏事務組合,6,2,決算収支の状況,2,令和3年度,1717458,1670615,46843,0,46843,3343,30243,0,139892,-106306
2022,61,409006,福岡県,宮若市外二町じん芥処理施設組合,6,2,決算収支の状況,2,令和3年度,486379,451817,34562,0,34562,4722,25193,0,0,29915
2022,61,409022,福岡県,八女西部広域事務組合,6,2,決算収支の状況,2,令和3年度,1612917,1537511,75406,4400,71006,-19751,30,0,0,-19721
2022,61,409031,福岡県,築上郡自治会館等資産管理組合,6,2,決算収支の状況,2,令和3年度,2462,1333,1129,0,1129,592,0,0,0,592
2022,61,409111,福岡県,直方・鞍手広域市町村圏事務組合,6,2,決算収支の状況,2,令和3年度,898477,852303,46174,0,46174,-6312,11175,0,0,4863
2022,61,409120,福岡県,甘木・朝倉広域市町村圏事務組合,6,2,決算収支の状況,2,令和3年度,1407907,1365697,42210,0,42210,-3138,0,0,0,-3138
2022,61,409146,福岡県,田川郡東部環境衛生施設組合,6,2,決算収支の状況,2,令和3年度,316222,265841,50381,23000,27381,-12150,39531,0,0,27381
2022,61,409154,福岡県,粕屋南部消防組合,6,2,決算収支の状況,2,令和3年度,2151196,2121249,29947,0,29947,-15262,0,0,0,-15262
2022,61,409227,福岡県,田川地区斎場組合,6,2,決算収支の状況,2,令和3年度,155618,146177,9441,0,9441,3347,1150,0,0,4497
2022,61,409251,福岡県,宗像地区事務組合,6,2,決算収支の状況,2,令和3年度,2342198,2229192,113006,67089,45917,-47891,5,0,14574,-62460
2022,61,409278,福岡県,豊前市外二町清掃施設組合,6,2,決算収支の状況,2,令和3年度,528577,514670,13907,0,13907,-12236,20000,0,0,7764
2022,61,409294,福岡県,行橋市・みやこ町清掃施設組合,6,2,決算収支の状況,2,令和3年度,910926,851247,59679,0,59679,34446,0,0,0,34446
2022,61,409308,福岡県,大野城太宰府環境施設組合,6,2,決算収支の状況,2,令和3年度,300995,273130,27865,0,27865,-2152,0,0,0,-2152
2022,61,409324,福岡県,甘木・朝倉・三井環境施設組合,6,2,決算収支の状況,2,令和3年度,1640762,1541761,99001,0,99001,26865,0,0,0,26865
2022,61,409332,福岡県,粕屋北部消防組合,6,2,決算収支の状況,2,令和3年度,1182535,1160080,22455,0,22455,-1206,10727,0,31424,-21903
2022,61,409341,福岡県,有明生活環境施設組合,6,2,決算収支の状況,2,令和3年度,7350458,7248141,102317,495,101822,22473,0,0,0,22473
2022,61,409359,福岡県,須恵町外二ヶ町清掃施設組合,6,2,決算収支の状況,2,令和3年度,1923900,1602494,321406,56000,265406,90058,10,0,0,90068
2022,61,409367,福岡県,遠賀・中間地域広域行政事務組合,6,2,決算収支の状況,2,令和3年度,4329095,4285079,44016,0,44016,18485,0,0,0,18485
2022,61,409375,福岡県,筑紫野・小郡・基山清掃施設組合,6,2,決算収支の状況,2,令和3年度,2170514,2124043,46471,0,46471,-15537,0,0,0,-15537
2022,61,409391,福岡県,福岡県自治振興組合,6,2,決算収支の状況,2,令和3年度,441779,433447,8332,0,8332,427,0,0,0,427
2022,61,409405,福岡県,春日大野城衛生施設組合,6,2,決算収支の状況,2,令和3年度,586975,535696,51279,0,51279,9844,0,0,0,9844
2022,61,409413,福岡県,田川地区清掃施設組合,6,2,決算収支の状況,2,令和3年度,654409,636708,17701,0,17701,-7005,0,0,0,-7005
2022,61,409448,福岡県,大牟田・荒尾清掃施設組合,6,2,決算収支の状況,2,令和3年度,1046352,1033956,12396,0,12396,1917,4,0,0,1921
2022,61,409456,福岡県,筑慈苑施設組合,6,2,決算収支の状況,2,令和3年度,274622,266229,8393,0,8393,-5007,0,0,0,-5007
2022,61,409464,福岡県,八女中部衛生施設事務組合,6,2,決算収支の状況,2,令和3年度,410242,374187,36055,0,36055,-10406,0,0,0,-10406
2022,61,409511,福岡県,福岡都市圏広域行政事業組合（普通会計分）,6,2,決算収支の状況,2,令和3年度,321054,248400,72654,0,72654,13127,4908,0,0,18035
2022,61,409537,福岡県,宇美町・志免町衛生施設組合,6,2,決算収支の状況,2,令和3年度,447357,440655,6702,0,6702,-2697,0,0,0,-2697
2022,61,409545,福岡県,福岡県介護保険広域連合,6,2,決算収支の状況,2,令和3年度,1825366,1781044,44322,0,44322,-3053,0,0,0,-3053
2022,61,409553,福岡県,福岡都市圏南部環境事業組合,6,2,決算収支の状況,2,令和3年度,3226002,2951190,274812,0,274812,-82819,357777,0,374789,-99831
2022,61,409561,福岡県,福岡県後期高齢者医療広域連合,7,2,決算収支の状況,2,令和3年度,194117,161467,32650,0,32650,11281,0,0,0,11281
2022,61,409570,福岡県,福岡都市圏広域行政事業組合（事業会計分）,7,2,決算収支の状況,2,令和3年度,0,0,0,0,0,0,0,0,0,0
2022,61,409588,福岡県,下田川清掃施設組合,6,2,決算収支の状況,2,令和3年度,593411,496249,97162,0,97162,53987,193467,0,0,247454
2022,61,409596,福岡県,ふくおか県央環境広域施設組合,6,2,決算収支の状況,2,令和3年度,3567776,3383276,184500,935,183565,-46193,258762,0,62921,149648
2022,61,409600,福岡県,田川地区広域環境衛生施設組合,6,2,決算収支の状況,2,令和3年度,395082,289532,105550,0,105550,105550,0,0,0,105550
2022,61,409618,福岡県,行橋京都メディカルセンター組合,6,2,決算収支の状況,2,令和3年度,0,0,0,0,0,0,0,0,0,0
2022,61,412015,佐賀県,佐賀市,9,2,決算収支の状況,2,令和3年度,118726278,114767392,3958886,818926,3139960,1595842,1612215,0,0,3208057
2022,61,412023,佐賀県,唐津市,3,2,決算収支の状況,2,令和3年度,88171278,86011095,2160183,633760,1526423,-51386,1175393,0,0,1124007
2022,61,412031,佐賀県,鳥栖市,4,2,決算収支の状況,2,令和3年度,35170654,33634140,1536514,258583,1277931,404763,535972,0,27717,913018
2022,61,412040,佐賀県,多久市,4,2,決算収支の状況,2,令和3年度,15583139,14852737,730402,172610,557792,445417,355150,0,0,800567
2022,61,412058,佐賀県,伊万里市,4,2,決算収支の状況,2,令和3年度,34703467,33934310,769157,47445,721712,398736,786979,0,0,1185715
2022,61,412066,佐賀県,武雄市,4,2,決算収支の状況,2,令和3年度,33568209,30958555,2609654,1011222,1598432,1182813,56050,0,384240,854623
2022,61,412074,佐賀県,鹿島市,4,2,決算収支の状況,2,令和3年度,17975659,17543490,432169,125443,306726,54583,227000,0,53870,227713
2022,61,412082,佐賀県,小城市,4,2,決算収支の状況,2,令和3年度,25282209,24539030,743179,349726,393453,-12292,370491,70,0,358269
2022,61,412091,佐賀県,嬉野市,4,2,決算収支の状況,2,令和3年度,21253578,20033797,1219781,339715,880066,227496,332376,0,0,559872
2022,61,412104,佐賀県,神埼市,4,2,決算収支の状況,2,令和3年度,19554179,18455414,1098765,262749,836016,511257,174793,0,0,686050
2022,61,413275,佐賀県,吉野ヶ里町,5,2,決算収支の状況,2,令和3年度,10739901,10322710,417191,29635,387556,335527,83085,0,0,418612
2022,61,413411,佐賀県,基山町,5,2,決算収支の状況,2,令和3年度,9559925,9262060,297865,23445,274420,79729,417031,2236,0,498996
2022,61,413453,佐賀県,上峰町,5,2,決算収支の状況,2,令和3年度,14736986,14401809,335177,154843,180334,-24074,334200,0,14686,295440
2022,61,413461,佐賀県,みやき町,5,2,決算収支の状況,2,令和3年度,23071671,22381213,690458,58615,631843,-158665,167555,0,45967,-37077
2022,61,413879,佐賀県,玄海町,5,2,決算収支の状況,2,令和3年度,9569837,9166975,402862,17810,385052,212507,304335,0,0,516842
2022,61,414018,佐賀県,有田町,5,2,決算収支の状況,2,令和3年度,13532788,12962411,570377,86539,483838,175618,157386,0,0,333004
2022,61,414239,佐賀県,大町町,5,2,決算収支の状況,2,令和3年度,6967229,6663285,303944,127087,176857,120121,229,0,30000,90350
2022,61,414247,佐賀県,江北町,5,2,決算収支の状況,2,令和3年度,7442793,7035496,407297,141673,265624,56164,3782,0,100000,-40054
2022,61,414255,佐賀県,白石町,5,2,決算収支の状況,2,令和3年度,16786857,16126062,660795,100155,560640,124218,219742,0,195615,148345
2022,61,414417,佐賀県,太良町,5,2,決算収支の状況,2,令和3年度,8670383,8335186,335197,49229,285968,151794,1104,0,0,152898
2022,61,418129,佐賀県,天山地区共同衛生処理場組合,6,2,決算収支の状況,2,令和3年度,341831,324684,17147,0,17147,-8326,0,0,0,-8326
2022,61,418137,佐賀県,杵島地区衛生処理組合,6,2,決算収支の状況,2,令和3年度,2286454,1937978,348476,324940,23536,7998,15,0,0,8013
2022,61,418145,佐賀県,鹿島・藤津地区衛生施設組合,6,2,決算収支の状況,2,令和3年度,417008,403883,13125,0,13125,-5793,0,0,0,-5793
2022,61,418277,佐賀県,佐賀県競馬組合,7,2,決算収支の状況,2,令和3年度,0,0,0,0,0,0,0,0,0,0
2022,61,418293,佐賀県,有田磁石場組合,6,2,決算収支の状況,2,令和3年度,5370,3880,1490,0,1490,-234,220,0,0,-14
2022,61,418307,佐賀県,杵藤地区広域市町村圏組合,6,2,決算収支の状況,2,令和3年度,4024678,3946623,78055,0,78055,-22600,72728,0,0,50128
2022,61,418315,佐賀県,鳥栖・三養基地区消防事務組合,6,2,決算収支の状況,2,令和3年度,1520131,1503800,16331,0,16331,117,8174,0,50605,-42314
2022,61,418331,佐賀県,天山地区共同斎場組合,6,2,決算収支の状況,2,令和3年度,67704,61783,5921,0,5921,1232,0,0,0,1232
2022,61,418340,佐賀県,伊万里・有田地区医療福祉組合,6,2,決算収支の状況,2,令和3年度,1001,589,412,0,412,147,0,0,0,147
2022,61,418404,佐賀県,脊振共同塵芥処理組合,6,2,決算収支の状況,2,令和3年度,790885,784143,6742,0,6742,-7979,17,0,7428,-15390
2022,61,418412,佐賀県,鳥栖地区広域市町村圏組合,6,2,決算収支の状況,2,令和3年度,97474,97050,424,0,424,-267,0,0,0,-267
2022,61,418510,佐賀県,伊万里・有田地区衛生組合,6,2,決算収支の状況,2,令和3年度,315602,290852,24750,0,24750,5856,0,0,0,5856
2022,61,418536,佐賀県,三養基西部葬祭組合,6,2,決算収支の状況,2,令和3年度,84045,79072,4973,0,4973,-2211,3594,0,0,1383
2022,61,418561,佐賀県,佐賀中部広域連合,6,2,決算収支の状況,2,令和3年度,5726811,5609743,117068,0,117068,4343,57788,0,49499,12632
2022,61,418579,佐賀県,三神地区環境事務組合,6,2,決算収支の状況,2,令和3年度,408675,384227,24448,1,24447,1279,11685,0,12000,964
2022,61,418587,佐賀県,鳥栖・三養基西部環境施設組合,6,2,決算収支の状況,2,令和3年度,1515701,1485968,29733,0,29733,-19463,0,0,0,-19463
2022,61,418595,佐賀県,佐賀県後期高齢者医療広域連合,7,2,決算収支の状況,2,令和3年度,122628,119263,3365,0,3365,-2236,0,0,0,-2236
2022,61,418609,佐賀県,佐賀県市町総合事務組合,6,2,決算収支の状況,2,令和3年度,3730729,3507443,223286,0,223286,-129050,1098625,0,5300,964275
2022,61,418617,佐賀県,佐賀県西部広域環境組合,6,2,決算収支の状況,2,令和3年度,2883082,2856911,26171,0,26171,-109911,0,0,0,-109911
2022,61,418625,佐賀県,伊万里・有田消防組合,6,2,決算収支の状況,2,令和3年度,1496122,1435136,60986,94,60892,-20525,0,0,0,-20525
2022,61,418633,佐賀県,天山地区共同環境組合,6,2,決算収支の状況,2,令和3年度,309509,316866,-7357,0,-7357,-14754,0,0,0,-14754
2022,61,418641,佐賀県,神埼市・吉野ヶ里町葬祭組合,6,2,決算収支の状況,2,令和3年度,79602,74723,4879,0,4879,-20195,0,0,0,-20195
2022,61,418650,佐賀県,佐賀県東部環境施設組合,6,2,決算収支の状況,2,令和3年度,714021,704804,9217,0,9217,-20200,0,0,0,-20200
2022,61,418668,佐賀県,多久小城医療組合,6,2,決算収支の状況,2,令和3年度,14953,13855,1098,0,1098,1098,0,0,0,1098
2022,61,422011,長崎県,長崎市,8,2,決算収支の状況,2,令和3年度,262301512,255100662,7200850,4295875,2904975,155970,2271559,0,1347141,1080388
2022,61,422029,長崎県,佐世保市,8,2,決算収支の状況,2,令和3年度,144680447,138657544,6022903,1396820,4626083,-5898,2321961,8000,1264360,1059703
2022,61,422037,長崎県,島原市,4,2,決算収支の状況,2,令和3年度,25782652,25232384,550268,108363,441905,139938,154671,0,0,294609
2022,61,422045,長崎県,諫早市,3,2,決算収支の状況,2,令和3年度,76130322,73827277,2303045,685865,1617180,610272,1804818,0,908915,1506175
2022,61,422053,長崎県,大村市,4,2,決算収支の状況,2,令和3年度,62691244,58527441,4163803,1695929,2467874,1513289,477778,0,0,1991067
2022,61,422070,長崎県,平戸市,4,2,決算収支の状況,2,令和3年度,28711069,27859868,851201,217213,633988,502619,423449,396700,0,1322768
2022,61,422088,長崎県,松浦市,4,2,決算収支の状況,2,令和3年度,20461142,19570524,890618,206359,684259,130528,800940,0,0,931468
2022,61,422096,長崎県,対馬市,4,2,決算収支の状況,2,令和3年度,34746724,33427613,1319111,504581,814530,170773,100,0,59662,111211
2022,61,422100,長崎県,壱岐市,4,2,決算収支の状況,2,令和3年度,24628870,23803541,825329,79433,745896,293350,250192,0,0,543542
2022,61,422118,長崎県,五島市,4,2,決算収支の状況,2,令和3年度,36114258,34910292,1203966,497050,706916,-652585,685091,253850,569251,-282895
2022,61,422126,長崎県,西海市,4,2,決算収支の状況,2,令和3年度,26141003,24689991,1451012,268610,1182402,339262,421589,958578,745145,974284
2022,61,422134,長崎県,雲仙市,4,2,決算収支の状況,2,令和3年度,36885841,35274231,1611610,493445,1118165,-366644,619,959275,0,593250
2022,61,422142,長崎県,南島原市,4,2,決算収支の状況,2,令和3年度,38180497,35988300,2192197,504514,1687683,-185907,658,2400720,6515,2208956
2022,61,423076,長崎県,長与町,5,2,決算収支の状況,2,令和3年度,17277433,15930911,1346522,188754,1157768,218884,146,0,568797,-349767
2022,61,423084,長崎県,時津町,5,2,決算収支の状況,2,令和3年度,14771742,13882138,889604,312653,576951,325823,14,0,0,325837
2022,61,423211,長崎県,東彼杵町,5,2,決算収支の状況,2,令和3年度,6761298,6459626,301672,170228,131444,-12767,1179,0,0,-11588
2022,61,423220,長崎県,川棚町,5,2,決算収支の状況,2,令和3年度,8270922,7959021,311901,51201,260700,49011,50247,0,0,99258
2022,61,423238,長崎県,波佐見町,5,2,決算収支の状況,2,令和3年度,10314895,10089885,225010,177496,47514,-25580,1349,0,0,-24231
2022,61,423831,長崎県,小値賀町,5,2,決算収支の状況,2,令和3年度,4305196,4026193,279003,128464,150539,36122,12035,0,0,48157
2022,61,423912,長崎県,佐々町,5,2,決算収支の状況,2,令和3年度,8236017,7873784,362233,22452,339781,62787,305239,0,78020,290006
2022,61,424111,長崎県,新上五島町,5,2,決算収支の状況,2,令和3年度,18525350,17958353,566997,143708,423289,161222,140046,982547,140000,1143815
2022,61,428175,長崎県,東彼地区保健福祉組合,6,2,決算収支の状況,2,令和3年度,1215766,1174847,40919,0,40919,-216,0,0,0,-216
2022,61,428426,長崎県,県央地域広域市町村圏組合,6,2,決算収支の状況,2,令和3年度,3940365,3733137,207228,3355,203873,21720,1,0,0,21721
2022,61,428434,長崎県,島原地域広域市町村圏組合,6,2,決算収支の状況,2,令和3年度,2445165,2422631,22534,0,22534,-3269,2,0,0,-3267
2022,61,428639,長崎県,雲仙・南島原保健組合（普通会計分）,6,2,決算収支の状況,2,令和3年度,447692,444878,2814,0,2814,90,0,0,0,90
2022,61,428663,長崎県,長崎県市町村総合事務組合,6,2,決算収支の状況,2,令和3年度,7375589,6809135,566454,0,566454,269672,0,0,0,269672
2022,61,428671,長崎県,県央県南広域環境組合,6,2,決算収支の状況,2,令和3年度,6775989,6394800,381189,172174,209015,-295126,825,0,20000,-314301
2022,61,428728,長崎県,北松北部環境組合,6,2,決算収支の状況,2,令和3年度,1297941,1268171,29770,7834,21936,2220,0,0,0,2220
2022,61,428752,長崎県,長崎県後期高齢者医療広域連合,7,2,決算収支の状況,2,令和3年度,266314,253697,12617,0,12617,-6120,101265,0,60285,34860
2022,61,428761,長崎県,長与・時津環境施設組合,6,2,決算収支の状況,2,令和3年度,797941,758586,39355,0,39355,2598,0,0,36757,-34159
2022,61,431001,熊本県,熊本市,1,2,決算収支の状況,2,令和3年度,430551321,420269419,10281902,3609294,6672608,1116367,3343851,0,3340000,1120218
2022,61,432024,熊本県,八代市,3,2,決算収支の状況,2,令和3年度,84024679,82346251,1678428,149571,1528857,232560,1500164,3770,0,1736494
2022,61,432032,熊本県,人吉市,4,2,決算収支の状況,2,令和3年度,32444672,31984116,460556,147521,313035,-883610,400004,0,0,-483606
2022,61,432041,熊本県,荒尾市,4,2,決算収支の状況,2,令和3年度,28998019,28275364,722655,211971,510684,433904,39380,0,0,473284
2022,61,432059,熊本県,水俣市,4,2,決算収支の状況,2,令和3年度,21126476,19967017,1159459,62633,1096826,781844,557,0,0,782401
2022,61,432067,熊本県,玉名市,4,2,決算収支の状況,2,令和3年度,36272179,34318243,1953936,110699,1843237,992833,443459,0,339557,1096735
2022,61,432083,熊本県,山鹿市,4,2,決算収支の状況,2,令和3年度,33108351,30606435,2501916,160283,2341633,1099758,81644,0,0,1181402
2022,61,432105,熊本県,菊池市,4,2,決算収支の状況,2,令和3年度,32105748,31029216,1076532,377769,698763,660023,1149302,0,18736,1790589
2022,61,432113,熊本県,宇土市,4,2,決算収支の状況,2,令和3年度,22281080,20888518,1392562,276922,1115640,505178,3443,0,0,508621
2022,61,432121,熊本県,上天草市,4,2,決算収支の状況,2,令和3年度,22639593,21373166,1266427,309841,956586,152770,881345,22245,0,1056360
2022,61,432130,熊本県,宇城市,4,2,決算収支の状況,2,令和3年度,37608565,36440534,1168031,289988,878043,17809,1941,0,0,19750
2022,61,432148,熊本県,阿蘇市,4,2,決算収支の状況,2,令和3年度,20351465,18624727,1726738,392254,1334484,240668,200237,0,0,440905
2022,61,432156,熊本県,天草市,4,2,決算収支の状況,2,令和3年度,63371505,59785430,3586075,120969,3465106,501182,1875167,0,0,2376349
2022,61,432164,熊本県,合志市,4,2,決算収支の状況,2,令和3年度,28524547,26816308,1708239,422315,1285924,-70641,682967,0,240885,371441
2022,61,433489,熊本県,美里町,5,2,決算収支の状況,2,令和3年度,8660238,8123928,536310,254531,281779,77472,112914,0,120000,70386
2022,61,433641,熊本県,玉東町,5,2,決算収支の状況,2,令和3年度,5824655,5733125,91530,40864,50666,-158473,23,0,40000,-198450
2022,61,433675,熊本県,南関町,5,2,決算収支の状況,2,令和3年度,8470497,8258918,211579,4388,207191,89751,90010,0,0,179761
2022,61,433683,熊本県,長洲町,5,2,決算収支の状況,2,令和3年度,8919970,8627119,292851,13473,279378,201825,332246,0,100000,434071
2022,61,433691,熊本県,和水町,5,2,決算収支の状況,2,令和3年度,10046031,8705425,1340606,85146,1255460,687714,201083,0,423000,465797
2022,61,434035,熊本県,大津町,5,2,決算収支の状況,2,令和3年度,20909908,19562212,1347696,203543,1144153,474155,311109,0,300000,485264
2022,61,434043,熊本県,菊陽町,5,2,決算収支の状況,2,令和3年度,20906196,19850903,1055293,371707,683586,270302,310150,0,0,580452
2022,61,434230,熊本県,南小国町,5,2,決算収支の状況,2,令和3年度,6430247,5786255,643992,186726,457266,-88163,556769,0,0,468606
2022,61,434248,熊本県,小国町,5,2,決算収支の状況,2,令和3年度,8824694,7976146,848548,523394,325154,-12978,182160,0,100000,69182
2022,61,434256,熊本県,産山村,5,2,決算収支の状況,2,令和3年度,2762558,2613483,149075,16016,133059,110782,144125,0,100000,154907
2022,61,434281,熊本県,高森町,5,2,決算収支の状況,2,令和3年度,9604820,9380353,224467,53077,171390,19051,377195,0,0,396246
2022,61,434329,熊本県,西原村,5,2,決算収支の状況,2,令和3年度,8191565,7382317,809248,199012,610236,276669,167144,0,0,443813
2022,61,434337,熊本県,南阿蘇村,5,2,決算収支の状況,2,令和3年度,14496297,13748794,747503,43590,703913,207871,2198,121468,248000,83537
2022,61,434418,熊本県,御船町,5,2,決算収支の状況,2,令和3年度,14582083,13680456,901627,86829,814798,386775,395213,1143,63945,719186
2022,61,434426,熊本県,嘉島町,5,2,決算収支の状況,2,令和3年度,8381984,7678236,703748,669401,34347,-189499,393437,0,180000,23938
2022,61,434434,熊本県,益城町,5,2,決算収支の状況,2,令和3年度,25100320,23889497,1210823,278617,932206,-280109,601,0,0,-279508
2022,61,434442,熊本県,甲佐町,5,2,決算収支の状況,2,令和3年度,9620030,8882715,737315,14740,722575,234388,25931,0,160048,100271
2022,61,434477,熊本県,山都町,5,2,決算収支の状況,2,令和3年度,17378409,15938424,1439985,551710,888275,504059,219,0,45174,459104
2022,61,434680,熊本県,氷川町,5,2,決算収支の状況,2,令和3年度,8047123,7346109,701014,30335,670679,260369,211556,0,449242,22683
2022,61,434825,熊本県,芦北町,5,2,決算収支の状況,2,令和3年度,18221466,17015219,1206247,123425,1082822,530314,426,0,0,530740
2022,61,434841,熊本県,津奈木町,5,2,決算収支の状況,2,令和3年度,4718534,4533481,185053,77994,107059,-26954,2016,0,0,-24938
2022,61,435015,熊本県,錦町,5,2,決算収支の状況,2,令和3年度,9419220,9093191,326029,126672,199357,10621,211010,0,0,221631
2022,61,435058,熊本県,多良木町,5,2,決算収支の状況,2,令和3年度,8882570,8368475,514095,46370,467725,134987,1668,0,0,136655
2022,61,435066,熊本県,湯前町,5,2,決算収支の状況,2,令和3年度,4503135,4009448,493687,142932,350755,1749,999,0,0,2748
2022,61,435074,熊本県,水上村,5,2,決算収支の状況,2,令和3年度,5125371,4394197,731174,26128,705046,-65676,4958,0,7539,-68257
2022,61,435104,熊本県,相良村,5,2,決算収支の状況,2,令和3年度,5601085,5357601,243484,240874,2610,-134468,306381,0,0,171913
2022,61,435112,熊本県,五木村,5,2,決算収支の状況,2,令和3年度,3326308,2942710,383598,44211,339387,22060,20014,0,30000,12074
2022,61,435121,熊本県,山江村,5,2,決算収支の状況,2,令和3年度,5222295,4524670,697625,32230,665395,43849,211616,0,80000,175465
2022,61,435139,熊本県,球磨村,5,2,決算収支の状況,2,令和3年度,11114969,9896892,1218077,341081,876996,644801,302369,0,346000,601170
2022,61,435147,熊本県,あさぎり町,5,2,決算収支の状況,2,令和3年度,15212947,14352074,860873,188520,672353,-352518,522868,0,1747000,-1576650
2022,61,435317,熊本県,苓北町,5,2,決算収支の状況,2,令和3年度,5710938,5528074,182864,29278,153586,32843,304817,0,0,337660
2022,61,438022,熊本県,熊本県市町村総合事務組合,6,2,決算収支の状況,2,令和3年度,8289157,7157300,1131857,0,1131857,-270347,0,0,0,-270347
2022,61,438120,熊本県,玉名市玉東町病院設立組合,6,2,決算収支の状況,2,令和3年度,1165492,1163986,1506,0,1506,-478,0,0,0,-478
2022,61,438162,熊本県,菊池養生園保健組合,6,2,決算収支の状況,2,令和3年度,560774,513060,47714,0,47714,10001,50003,0,0,60004
2022,61,438545,熊本県,菊池環境保全組合,6,2,決算収支の状況,2,令和3年度,5488182,5315771,172411,0,172411,133020,200003,0,0,333023
2022,61,438570,熊本県,御船地区衛生施設組合,6,2,決算収支の状況,2,令和3年度,210770,183869,26901,0,26901,957,5049,0,10000,-3994
2022,61,439142,熊本県,大津町・西原村原野組合,6,2,決算収支の状況,2,令和3年度,1591,1010,581,0,581,394,0,0,0,394
2022,61,439291,熊本県,氷川町及び八代市中学校組合,6,2,決算収支の状況,2,令和3年度,102756,99873,2883,0,2883,-721,0,0,0,-721
2022,61,439355,熊本県,上天草衛生施設組合,6,2,決算収支の状況,2,令和3年度,174463,158865,15598,0,15598,1430,5,0,0,1435
2022,61,439371,熊本県,御船町甲佐町衛生施設組合,6,2,決算収支の状況,2,令和3年度,323843,286712,37131,0,37131,7951,13,0,40000,-32036
2022,61,439495,熊本県,益城、嘉島、西原環境衛生施設組合,6,2,決算収支の状況,2,令和3年度,591979,557915,34064,0,34064,-16571,39382,0,10000,12811
2022,61,439541,熊本県,山鹿植木広域行政事務組合,6,2,決算収支の状況,2,令和3年度,582659,501376,81283,0,81283,2776,0,0,0,2776
2022,61,439649,熊本県,人吉下球磨消防組合,6,2,決算収支の状況,2,令和3年度,1132753,1112872,19881,2516,17365,11216,2005,0,0,13221
2022,61,439657,熊本県,上益城消防組合,6,2,決算収支の状況,2,令和3年度,917056,900496,16560,0,16560,-3360,14,0,0,-3346
2022,61,439665,熊本県,上球磨消防組合,6,2,決算収支の状況,2,令和3年度,644540,627636,16904,0,16904,-14072,1,0,0,-14071
2022,61,439738,熊本県,八代広域行政事務組合,6,2,決算収支の状況,2,令和3年度,2381123,2301484,79639,98,79541,-22724,0,0,0,-22724
2022,61,439746,熊本県,八代生活環境事務組合（普通会計分）,6,2,決算収支の状況,2,令和3年度,480259,414315,65944,0,65944,2097,0,0,0,2097
2022,61,439851,熊本県,阿蘇広域行政事務組合,6,2,決算収支の状況,2,令和3年度,3702337,3653517,48820,0,48820,-8528,4890,0,0,-3638
2022,61,439860,熊本県,人吉球磨広域行政組合,6,2,決算収支の状況,2,令和3年度,2386490,2205059,181431,0,181431,-602937,0,0,0,-602937
2022,61,439916,熊本県,有明広域行政事務組合,6,2,決算収支の状況,2,令和3年度,4700520,4562977,137543,0,137543,-58859,2,0,23809,-82666
2022,61,439932,熊本県,水俣芦北広域行政事務組合,6,2,決算収支の状況,2,令和3年度,2146690,2086191,60499,0,60499,-25668,0,0,0,-25668
2022,61,439959,熊本県,宇城広域連合,6,2,決算収支の状況,2,令和3年度,4719270,4409852,309418,138482,170936,-113888,0,0,0,-113888
2022,61,439967,熊本県,菊池広域連合,6,2,決算収支の状況,2,令和3年度,2555240,2448501,106739,0,106739,13089,71,0,2480,10680
2022,61,439975,熊本県,上益城広域連合,6,2,決算収支の状況,2,令和3年度,195935,184039,11896,0,11896,-21591,0,0,1100,-22691
2022,61,439983,熊本県,天草広域連合,6,2,決算収支の状況,2,令和3年度,3613091,3324254,288837,103110,185727,38776,73599,0,0,112375
2022,61,439991,熊本県,熊本県後期高齢者医療広域連合,7,2,決算収支の状況,2,令和3年度,128069,116856,11213,0,11213,-24752,0,0,0,-24752
2022,61,442011,大分県,大分市,8,2,決算収支の状況,2,令和3年度,211871280,204473548,7397732,794836,6602896,3606937,2064,0,550000,3059001
2022,61,442020,大分県,別府市,3,2,決算収支の状況,2,令和3年度,62357558,60661089,1696469,652115,1044354,250890,649850,0,0,900740
2022,61,442038,大分県,中津市,4,2,決算収支の状況,2,令和3年度,48078217,45384160,2694057,130005,2564052,1352842,11243,0,258660,1105425
2022,61,442046,大分県,日田市,4,2,決算収支の状況,2,令和3年度,44381226,42472703,1908523,367679,1540844,1023033,13159,0,0,1036192
2022,61,442054,大分県,佐伯市,4,2,決算収支の状況,2,令和3年度,48513108,47499941,1013167,129338,883829,197307,588972,0,0,786279
2022,61,442062,大分県,臼杵市,4,2,決算収支の状況,2,令和3年度,24417575,23950836,466739,88147,378592,16030,210846,0,220000,6876
2022,61,442071,大分県,津久見市,4,2,決算収支の状況,2,令和3年度,11405663,11034578,371085,47031,324054,21267,160000,0,0,181267
2022,61,442089,大分県,竹田市,4,2,決算収支の状況,2,令和3年度,21417104,20182013,1235091,88405,1146686,742306,4844,0,0,747150
2022,61,442097,大分県,豊後高田市,4,2,決算収支の状況,2,令和3年度,17466497,16746473,720024,21999,698025,341873,197946,0,0,539819
2022,61,442101,大分県,杵築市,4,2,決算収支の状況,2,令和3年度,21674174,21051728,622446,51747,570699,125002,209048,523300,0,857350
2022,61,442119,大分県,宇佐市,4,2,決算収支の状況,2,令和3年度,35095564,33473651,1621913,236620,1385293,445590,68641,0,369276,144955
2022,61,442127,大分県,豊後大野市,4,2,決算収支の状況,2,令和3年度,29510794,27767935,1742859,348729,1394130,523403,21205,3990,364049,184549
2022,61,442135,大分県,由布市,4,2,決算収支の状況,2,令和3年度,23092068,22654214,437854,335448,102406,-576633,263833,0,0,-312800
2022,61,442143,大分県,国東市,4,2,決算収支の状況,2,令和3年度,26793635,25947381,846254,153413,692841,120753,822086,0,0,942839
2022,61,443221,大分県,姫島村,5,2,決算収支の状況,2,令和3年度,2941875,2594971,346904,1066,345838,-5383,178191,0,178191,-5383
2022,61,443417,大分県,日出町,5,2,決算収支の状況,2,令和3年度,13768864,13158107,610757,69225,541532,347064,251069,0,0,598133
2022,61,444618,大分県,九重町,5,2,決算収支の状況,2,令和3年度,9638369,8703500,934869,304183,630686,116912,1249,0,0,118161
2022,61,444626,大分県,玖珠町,5,2,決算収支の状況,2,令和3年度,11450866,11128261,322605,32712,289893,-259796,1197,0,159521,-418120
2022,61,448125,大分県,大分県退職手当組合,6,2,決算収支の状況,2,令和3年度,1837778,1752587,85191,0,85191,-38452,8155,0,0,-30297
2022,61,448133,大分県,大分県消防補償等組合,6,2,決算収支の状況,2,令和3年度,332608,331823,785,0,785,170,8,0,2000,-1822
2022,61,448222,大分県,大分県交通災害共済組合,7,2,決算収支の状況,2,令和3年度,0,0,0,0,0,0,0,0,0,0
2022,61,448354,大分県,杵築速見環境浄化組合,6,2,決算収支の状況,2,令和3年度,271204,264965,6239,0,6239,1557,4783,0,0,6340
2022,61,448362,大分県,別杵速見地域広域市町村圏事務組合,6,2,決算収支の状況,2,令和3年度,1778467,1778467,0,0,0,0,51,0,84507,-84456
2022,61,448389,大分県,杵築速見消防組合,6,2,決算収支の状況,2,令和3年度,1325534,1293872,31662,0,31662,2372,14651,0,4891,12132
2022,61,448451,大分県,大分県市町村会館管理組合,6,2,決算収支の状況,2,令和3年度,64770,56278,8492,0,8492,-2405,16000,0,0,13595
2022,61,448575,大分県,臼津広域連合,6,2,決算収支の状況,2,令和3年度,101679,97743,3936,0,3936,-2990,0,0,0,-2990
2022,61,448591,大分県,大分県後期高齢者医療広域連合,7,2,決算収支の状況,2,令和3年度,363319,230520,132799,0,132799,-274,133284,0,122334,10676
2022,61,448605,大分県,日田玖珠広域消防組合,6,2,決算収支の状況,2,令和3年度,1117343,1106699,10644,0,10644,-1956,6073,0,0,4117
2022,61,448613,大分県,玖珠九重行政事務組合,6,2,決算収支の状況,2,令和3年度,676147,647404,28743,0,28743,3635,0,0,0,3635
2022,61,448621,大分県,宇佐・高田・国東広域事務組合,6,2,決算収支の状況,2,令和3年度,150215,136623,13592,0,13592,-5017,0,0,0,-5017
2022,61,452017,宮崎県,宮崎市,8,2,決算収支の状況,2,令和3年度,209007439,198063169,10944270,6075601,4868669,1695773,239335,0,0,1935108
2022,61,452025,宮崎県,都城市,3,2,決算収支の状況,2,令和3年度,125233935,121907101,3326834,1832569,1494265,26446,1471626,0,855520,642552
2022,61,452033,宮崎県,延岡市,3,2,決算収支の状況,2,令和3年度,75934099,71960873,3973226,1429241,2543985,434430,1069603,0,1069603,434430
2022,61,452041,宮崎県,日南市,4,2,決算収支の状況,2,令和3年度,38285538,37068377,1217161,213111,1004050,471034,918774,0,0,1389808
2022,61,452050,宮崎県,小林市,4,2,決算収支の状況,2,令和3年度,32491507,31405574,1085933,162434,923499,473651,204092,0,0,677743
2022,61,452068,宮崎県,日向市,4,2,決算収支の状況,2,令和3年度,35739605,34794758,944847,229971,714876,87745,911,0,100000,-11344
2022,61,452076,宮崎県,串間市,4,2,決算収支の状況,2,令和3年度,14895200,14328862,566338,26166,540172,273701,137674,0,0,411375
2022,61,452084,宮崎県,西都市,4,2,決算収支の状況,2,令和3年度,25744758,24793895,950863,226090,724773,2003,140100,0,0,142103
2022,61,452092,宮崎県,えびの市,4,2,決算収支の状況,2,令和3年度,15845725,14965042,880683,184466,696217,162725,266787,0,0,429512
2022,61,453412,宮崎県,三股町,5,2,決算収支の状況,2,令和3年度,13707741,13109583,598158,110637,487521,102709,192987,0,190000,105696
2022,61,453617,宮崎県,高原町,5,2,決算収支の状況,2,令和3年度,7773986,7596835,177151,19475,157676,64996,264064,0,0,329060
2022,61,453820,宮崎県,国富町,5,2,決算収支の状況,2,令和3年度,11151481,10714135,437346,14858,422488,56274,439251,0,280000,215525
2022,61,453838,宮崎県,綾町,5,2,決算収支の状況,2,令和3年度,6176112,5930525,245587,20266,225321,29063,332900,0,0,361963
2022,61,454010,宮崎県,高鍋町,5,2,決算収支の状況,2,令和3年度,12457254,11805217,652037,157790,494247,236738,517531,0,187749,566520
2022,61,454028,宮崎県,新富町,5,2,決算収支の状況,2,令和3年度,13623335,13254475,368860,88118,280742,45633,118463,0,72126,91970
2022,61,454036,宮崎県,西米良村,5,2,決算収支の状況,2,令和3年度,3489001,3222618,266383,172237,94146,-9787,352224,0,0,342437
2022,61,454044,宮崎県,木城町,5,2,決算収支の状況,2,令和3年度,6144939,5886579,258360,49949,208411,-40399,0,0,277736,-318135
2022,61,454052,宮崎県,川南町,5,2,決算収支の状況,2,令和3年度,12949130,12378711,570419,280320,290099,67480,519163,0,719163,-132520
2022,61,454061,宮崎県,都農町,5,2,決算収支の状況,2,令和3年度,30079217,28769888,1309329,813213,496116,216713,250560,0,313946,153327
2022,61,454214,宮崎県,門川町,5,2,決算収支の状況,2,令和3年度,11370552,10653973,716579,179727,536852,119145,852043,0,700000,271188
2022,61,454290,宮崎県,諸塚村,5,2,決算収支の状況,2,令和3年度,3789031,3652759,136272,56252,80020,14463,660,0,0,15123
2022,61,454303,宮崎県,椎葉村,5,2,決算収支の状況,2,令和3年度,6765389,6448266,317123,154278,162845,-1153,30230,0,0,29077
2022,61,454311,宮崎県,美郷町,5,2,決算収支の状況,2,令和3年度,9202469,8854369,348100,100719,247381,89080,229,0,0,89309
2022,61,454419,宮崎県,高千穂町,5,2,決算収支の状況,2,令和3年度,10201649,9791555,410094,86095,323999,248743,152622,0,0,401365
2022,61,454427,宮崎県,日之影町,5,2,決算収支の状況,2,令和3年度,5722390,5550481,171909,119953,51956,-1875,26,0,0,-1849
2022,61,454435,宮崎県,五ケ瀬町,5,2,決算収支の状況,2,令和3年度,5040519,4954638,85881,37113,48768,19885,2556,0,0,22441
2022,61,458112,宮崎県,高鍋・木城衛生組合,6,2,決算収支の状況,2,令和3年度,120914,113845,7069,0,7069,-6938,7004,0,0,66
2022,61,458121,宮崎県,川南都農衛生組合,6,2,決算収支の状況,2,令和3年度,109002,103056,5946,0,5946,-2367,4315,0,0,1948
2022,61,458155,宮崎県,宮崎県北部広域行政事務組合,6,2,決算収支の状況,2,令和3年度,31437,26842,4595,0,4595,496,0,0,0,496
2022,61,458252,宮崎県,西臼杵広域行政事務組合,6,2,決算収支の状況,2,令和3年度,976358,965572,10786,0,10786,-12176,1,0,5666,-17841
2022,61,458279,宮崎県,宮崎県東児湯消防組合,6,2,決算収支の状況,2,令和3年度,1064230,1052040,12190,0,12190,-4807,20885,0,0,16078
2022,61,458309,宮崎県,西諸広域行政事務組合,6,2,決算収支の状況,2,令和3年度,1298823,1249428,49395,0,49395,-7813,0,0,0,-7813
2022,61,458325,宮崎県,入郷地区衛生組合,6,2,決算収支の状況,2,令和3年度,106418,97509,8909,0,8909,-4221,3500,0,0,-721
2022,61,458333,宮崎県,日南串間広域不燃物処理組合,6,2,決算収支の状況,2,令和3年度,219656,189594,30062,0,30062,20472,0,0,0,20472
2022,61,458368,宮崎県,西都児湯環境整備事務組合,6,2,決算収支の状況,2,令和3年度,1133574,1057879,75695,3960,71735,6380,261094,0,0,267474
2022,61,458414,宮崎県,宮崎県市町村総合事務組合（普通会計分）,6,2,決算収支の状況,2,令和3年度,1956279,1803949,152330,0,152330,14149,2900,0,20500,-3451
2022,61,458422,宮崎県,宮崎県市町村総合事務組合（事業会計分）,7,2,決算収支の状況,2,令和3年度,0,0,0,0,0,0,0,0,0,0
2022,61,458449,宮崎県,日向東臼杵広域連合,6,2,決算収支の状況,2,令和3年度,629674,615644,14030,0,14030,-1496,0,0,5000,-6496
2022,61,458457,宮崎県,宮崎県後期高齢者医療広域連合,7,2,決算収支の状況,2,令和3年度,124216,118224,5992,0,5992,510,5483,0,5483,510
2022,61,462012,鹿児島県,鹿児島市,8,2,決算収支の状況,2,令和3年度,305428183,294612280,10815903,1636080,9179823,4670818,649998,0,0,5320816
2022,61,462039,鹿児島県,鹿屋市,3,2,決算収支の状況,2,令和3年度,65661408,62682331,2979077,488549,2490528,-209096,1354422,0,1007245,138081
2022,61,462047,鹿児島県,枕崎市,4,2,決算収支の状況,2,令和3年度,17191592,16439797,751795,41803,709992,289080,378700,14211,0,681991
2022,61,462063,鹿児島県,阿久根市,4,2,決算収支の状況,2,令和3年度,14794033,14038714,755319,21036,734283,158990,293279,101676,210357,343588
2022,61,462080,鹿児島県,出水市,4,2,決算収支の状況,2,令和3年度,31648906,30100650,1548256,181357,1366899,567833,2500,0,0,570333
2022,61,462101,鹿児島県,指宿市,4,2,決算収支の状況,2,令和3年度,30306889,28867591,1439298,128525,1310773,367900,77979,0,63194,382685
2022,61,462136,鹿児島県,西之表市,4,2,決算収支の状況,2,令和3年度,12117581,11861618,255963,12947,243016,-34219,580333,0,234998,311116
2022,61,462144,鹿児島県,垂水市,4,2,決算収支の状況,2,令和3年度,13249428,12804155,445273,11965,433308,162064,385230,0,0,547294
2022,61,462152,鹿児島県,薩摩川内市,4,2,決算収支の状況,2,令和3年度,65616051,62227799,3388252,517262,2870990,697112,2003416,0,1702386,998142
2022,61,462161,鹿児島県,日置市,4,2,決算収支の状況,2,令和3年度,32424845,31070536,1354309,150166,1204143,335541,564493,0,0,900034
2022,61,462179,鹿児島県,曽於市,4,2,決算収支の状況,2,令和3年度,31234891,30164879,1070012,287469,782543,218766,367998,231182,333729,484217
2022,61,462187,鹿児島県,霧島市,3,2,決算収支の状況,2,令和3年度,75877917,71881452,3996465,859194,3137271,435914,1655130,0,1668485,422559
2022,61,462195,鹿児島県,いちき串木野市,4,2,決算収支の状況,2,令和3年度,18796088,17969413,826675,40246,786429,186527,54844,0,0,241371
2022,61,462209,鹿児島県,南さつま市,4,2,決算収支の状況,2,令和3年度,31908067,30691101,1216966,79823,1137143,28294,144529,371991,0,544814
2022,61,462217,鹿児島県,志布志市,4,2,決算収支の状況,2,令和3年度,34099447,33393763,705684,35468,670216,240624,301775,0,0,542399
2022,61,462225,鹿児島県,奄美市,4,2,決算収支の状況,2,令和3年度,41936735,40956571,980164,29477,950687,-615,2006,0,56008,-54617
2022,61,462233,鹿児島県,南九州市,4,2,決算収支の状況,2,令和3年度,27156935,26325644,831291,215043,616248,-21749,6693,0,0,-15056
2022,61,462241,鹿児島県,伊佐市,4,2,決算収支の状況,2,令和3年度,20750796,19051416,1699380,439703,1259677,609192,337200,0,0,946392
2022,61,462250,鹿児島県,姶良市,4,2,決算収支の状況,2,令和3年度,38547300,37083801,1463499,57071,1406428,797963,486800,0,0,1284763
2022,61,463035,鹿児島県,三島村,5,2,決算収支の状況,2,令和3年度,2753952,2446468,307484,10371,297113,268095,14130,0,0,282225
2022,61,463043,鹿児島県,十島村,5,2,決算収支の状況,2,令和3年度,6136384,6007323,129061,63168,65893,-3970,124122,0,42650,77502
2022,61,463922,鹿児島県,さつま町,5,2,決算収支の状況,2,令和3年度,17791071,16482243,1308828,154562,1154266,285485,404863,0,800000,-109652
2022,61,464040,鹿児島県,長島町,5,2,決算収支の状況,2,令和3年度,13120292,12361326,758966,50637,708329,171257,100000,0,0,271257
2022,61,464520,鹿児島県,湧水町,5,2,決算収支の状況,2,令和3年度,10924432,10459843,464589,36031,428558,66972,122710,0,0,189682
2022,61,464686,鹿児島県,大崎町,5,2,決算収支の状況,2,令和3年度,13819752,13194093,625659,92748,532911,50230,4612,0,15000,39842
2022,61,464821,鹿児島県,東串良町,5,2,決算収支の状況,2,令和3年度,6940715,6629160,311555,17610,293945,60025,117837,0,0,177862
2022,61,464902,鹿児島県,錦江町,5,2,決算収支の状況,2,令和3年度,7306293,7185455,120838,4471,116367,-8213,64421,0,0,56208
2022,61,464911,鹿児島県,南大隅町,5,2,決算収支の状況,2,令和3年度,8395765,8099866,295899,9371,286528,-11596,1700,0,3582,-13478
2022,61,464929,鹿児島県,肝付町,5,2,決算収支の状況,2,令和3年度,11716447,11171459,544988,0,544988,10500,310129,0,90000,230629
2022,61,465011,鹿児島県,中種子町,5,2,決算収支の状況,2,令和3年度,8361256,8302948,58308,12411,45897,-4438,8756,0,0,4318
2022,61,465020,鹿児島県,南種子町,5,2,決算収支の状況,2,令和3年度,6183982,6111839,72143,20012,52131,28798,127394,0,0,156192
2022,61,465054,鹿児島県,屋久島町,5,2,決算収支の状況,2,令和3年度,13699100,12619032,1080068,849852,230216,-89360,161477,0,292922,-220805
2022,61,465232,鹿児島県,大和村,5,2,決算収支の状況,2,令和3年度,3730667,3564983,165684,85987,79697,-31907,405000,26488,248000,151581
2022,61,465241,鹿児島県,宇検村,5,2,決算収支の状況,2,令和3年度,3997859,3734749,263110,27550,235560,49376,10103,0,0,59479
2022,61,465259,鹿児島県,瀬戸内町,5,2,決算収支の状況,2,令和3年度,11896685,11100739,795946,72782,723164,217313,252926,0,0,470239
2022,61,465275,鹿児島県,龍郷町,5,2,決算収支の状況,2,令和3年度,7188713,7045543,143170,51611,91559,9585,371,0,0,9956
2022,61,465291,鹿児島県,喜界町,5,2,決算収支の状況,2,令和3年度,8112470,7912359,200111,106194,93917,4400,1044,0,0,5444
2022,61,465305,鹿児島県,徳之島町,5,2,決算収支の状況,2,令和3年度,11300653,10568125,732528,249231,483297,284568,801,0,0,285369
2022,61,465313,鹿児島県,天城町,5,2,決算収支の状況,2,令和3年度,8093585,7694179,399406,102660,296746,26269,540792,8481,419865,155677
2022,61,465321,鹿児島県,伊仙町,5,2,決算収支の状況,2,令和3年度,7499025,7244235,254790,195777,59013,24455,0,0,0,24455
2022,61,465330,鹿児島県,和泊町,5,2,決算収支の状況,2,令和3年度,7580616,7456358,124258,70273,53985,-4867,164158,0,0,159291
2022,61,465348,鹿児島県,知名町,5,2,決算収支の状況,2,令和3年度,6876118,6612262,263856,49572,214284,66104,67060,0,0,133164
2022,61,465356,鹿児島県,与論町,5,2,決算収支の状況,2,令和3年度,5764465,5438900,325565,119954,205611,-129394,88,0,129479,-258785
2022,61,468045,鹿児島県,鹿児島県市町村総合事務組合,6,2,決算収支の状況,2,令和3年度,12283860,11939377,344483,0,344483,-219438,1,0,0,-219437
2022,61,468088,鹿児島県,いちき串木野市・日置市衛生処理組合,6,2,決算収支の状況,2,令和3年度,345204,327109,18095,0,18095,-4914,6439,0,0,1525
2022,61,468118,鹿児島県,南薩地区衛生管理組合,6,2,決算収支の状況,2,令和3年度,1348504,1259983,88521,9999,78522,1748,0,0,0,1748
2022,61,468487,鹿児島県,指宿南九州消防組合,6,2,決算収支の状況,2,令和3年度,1912724,1883941,28783,0,28783,8432,11,0,0,8443
2022,61,468541,鹿児島県,指宿広域市町村圏組合,6,2,決算収支の状況,2,令和3年度,1011224,994853,16371,0,16371,8837,0,0,1709,7128
2022,61,468550,鹿児島県,曽於北部衛生処理組合,6,2,決算収支の状況,2,令和3年度,116821,111401,5420,0,5420,-3644,0,0,0,-3644
2022,61,468614,鹿児島県,南大隅衛生管理組合,6,2,決算収支の状況,2,令和3年度,105384,102532,2852,0,2852,-4266,128,0,0,-4138
2022,61,468703,鹿児島県,中南衛生管理組合,6,2,決算収支の状況,2,令和3年度,239092,231546,7546,0,7546,-6750,0,0,0,-6750
2022,61,468720,鹿児島県,大島地区衛生組合,6,2,決算収支の状況,2,令和3年度,910007,869652,40355,0,40355,-6290,0,0,0,-6290
2022,61,468797,鹿児島県,阿久根地区消防組合,6,2,決算収支の状況,2,令和3年度,595936,588908,7028,0,7028,-1668,0,0,0,-1668
2022,61,468801,鹿児島県,伊佐湧水消防組合,6,2,決算収支の状況,2,令和3年度,792099,778534,13565,0,13565,-2927,8504,0,0,5577
2022,61,468878,鹿児島県,沖永良部衛生管理組合,6,2,決算収支の状況,2,令和3年度,234316,234286,30,0,30,-8,10164,0,0,10156
2022,61,468908,鹿児島県,伊佐北姶良環境管理組合,6,2,決算収支の状況,2,令和3年度,648270,610231,38039,0,38039,13305,0,0,0,13305
2022,61,468916,鹿児島県,大隅曽於地区消防組合,6,2,決算収支の状況,2,令和3年度,1069946,1056101,13845,0,13845,4269,34,0,28171,-23868
2022,61,468924,鹿児島県,大隅肝属地区消防組合,6,2,決算収支の状況,2,令和3年度,2019541,1944345,75196,57700,17496,4885,6086,0,0,10971
2022,61,468941,鹿児島県,伊佐北姶良火葬場管理組合,6,2,決算収支の状況,2,令和3年度,45779,43297,2482,0,2482,-330,0,0,0,-330
2022,61,469033,鹿児島県,沖永良部与論地区広域事務組合,6,2,決算収支の状況,2,令和3年度,507410,501748,5662,2497,3165,-1659,20,0,0,-1639
2022,61,469041,鹿児島県,北薩広域行政事務組合,6,2,決算収支の状況,2,令和3年度,770859,746983,23876,0,23876,-20306,0,0,0,-20306
2022,61,469068,鹿児島県,徳之島地区消防組合,6,2,決算収支の状況,2,令和3年度,446629,442698,3931,0,3931,504,2245,0,0,2749
2022,61,469084,鹿児島県,曽於南部厚生事務組合,6,2,決算収支の状況,2,令和3年度,422304,370181,52123,0,52123,7281,16777,0,0,24058
2022,61,469114,鹿児島県,熊毛地区消防組合,6,2,決算収支の状況,2,令和3年度,975885,946981,28904,2021,26883,770,5000,0,0,5770
2022,61,469122,鹿児島県,大島地区消防組合,6,2,決算収支の状況,2,令和3年度,1497515,1477553,19962,0,19962,1199,5471,0,0,6670
2022,61,469157,鹿児島県,奄美群島広域事務組合,6,2,決算収支の状況,2,令和3年度,477371,444212,33159,0,33159,2335,10420,0,7792,4963
2022,61,469190,鹿児島県,南薩介護保険事務組合,6,2,決算収支の状況,2,令和3年度,233198,216677,16521,0,16521,-4519,0,0,0,-4519
2022,61,469211,鹿児島県,姶良・伊佐地区介護保険組合,6,2,決算収支の状況,2,令和3年度,131232,90987,40245,0,40245,393,0,0,0,393
2022,61,469220,鹿児島県,曽於地区介護保険組合,6,2,決算収支の状況,2,令和3年度,151796,135041,16755,0,16755,4459,5000,0,0,9459
2022,61,469246,鹿児島県,種子島地区広域事務組合,6,2,決算収支の状況,2,令和3年度,717187,703560,13627,0,13627,-4033,0,0,0,-4033
2022,61,469254,鹿児島県,徳之島地区介護保険組合,6,2,決算収支の状況,2,令和3年度,49594,40992,8602,0,8602,3654,0,0,0,3654
2022,61,469262,鹿児島県,奄美大島地区介護保険一部事務組合,6,2,決算収支の状況,2,令和3年度,52888,47801,5087,0,5087,1572,0,0,0,1572
2022,61,469289,鹿児島県,大隅肝属広域事務組合,6,2,決算収支の状況,2,令和3年度,1821706,1769814,51892,0,51892,-12643,64789,0,37992,14154
2022,61,469297,鹿児島県,徳之島愛ランド広域連合,6,2,決算収支の状況,2,令和3年度,551164,500783,50381,0,50381,32204,0,0,0,32204
2022,61,469319,鹿児島県,鹿児島県後期高齢者医療広域連合,7,2,決算収支の状況,2,令和3年度,88693,84069,4624,0,4624,-497,0,0,0,-497
2022,61,472018,沖縄県,那覇市,8,2,決算収支の状況,2,令和3年度,182556310,171159091,11397219,4918963,6478256,-1606784,4042582,1321929,647522,3110205
2022,61,472051,沖縄県,宜野湾市,3,2,決算収支の状況,2,令和3年度,54387359,52605916,1781443,358094,1423349,-29275,767001,0,0,737726
2022,61,472077,沖縄県,石垣市,4,2,決算収支の状況,2,令和3年度,41519591,40180544,1339047,545808,793239,640176,60001,17218,100000,617395
2022,61,472085,沖縄県,浦添市,3,2,決算収支の状況,2,令和3年度,61451010,58814487,2636523,426270,2210253,923292,630000,0,0,1553292
2022,61,472093,沖縄県,名護市,4,2,決算収支の状況,2,令和3年度,46691761,44395013,2296748,342928,1953820,778781,1426411,0,956671,1248521
2022,61,472107,沖縄県,糸満市,4,2,決算収支の状況,2,令和3年度,32879661,31944500,935161,113791,821370,333814,0,0,0,333814
2022,61,472115,沖縄県,沖縄市,3,2,決算収支の状況,2,令和3年度,86021992,82992341,3029651,1978604,1051047,-2040921,1558234,0,528986,-1011673
2022,61,472123,沖縄県,豊見城市,4,2,決算収支の状況,2,令和3年度,31619996,29783428,1836568,626802,1209766,922014,154313,0,0,1076327
2022,61,472131,沖縄県,うるま市,3,2,決算収支の状況,2,令和3年度,75607630,72172177,3435453,428329,3007124,-53948,1568777,0,520795,994034
2022,61,472140,沖縄県,宮古島市,4,2,決算収支の状況,2,令和3年度,46481773,44134337,2347436,268971,2078465,37834,1512124,0,2179830,-629872
2022,61,472158,沖縄県,南城市,4,2,決算収支の状況,2,令和3年度,28920981,27322471,1598510,318978,1279532,-208614,1849914,226002,948652,918650
2022,61,473014,沖縄県,国頭村,5,2,決算収支の状況,2,令和3年度,7122960,6467902,655058,64135,590923,343115,150005,0,0,493120
2022,61,473022,沖縄県,大宜味村,5,2,決算収支の状況,2,令和3年度,4723781,4274458,449323,91622,357701,135376,151320,0,292351,-5655
2022,61,473031,沖縄県,東村,5,2,決算収支の状況,2,令和3年度,3425252,3209628,215624,28123,187501,70221,58640,0,0,128861
2022,61,473065,沖縄県,今帰仁村,5,2,決算収支の状況,2,令和3年度,8709178,7827694,881484,209192,672292,360007,345259,0,286560,418706
2022,61,473081,沖縄県,本部町,5,2,決算収支の状況,2,令和3年度,11161250,10675316,485934,35774,450160,279807,34,0,0,279841
2022,61,473111,沖縄県,恩納村,5,2,決算収支の状況,2,令和3年度,11794535,11113691,680844,139476,541368,228525,58,0,459547,-230964
2022,61,473138,沖縄県,宜野座村,5,2,決算収支の状況,2,令和3年度,10535586,10303145,232441,180335,52106,-38476,397126,0,233775,124875
2022,61,473146,沖縄県,金武町,5,2,決算収支の状況,2,令和3年度,12198365,11897857,300508,216891,83617,-124091,6,0,3393,-127478
2022,61,473154,沖縄県,伊江村,5,2,決算収支の状況,2,令和3年度,9394090,9275849,118241,74350,43891,-79710,139162,0,200000,-140548
2022,61,473243,沖縄県,読谷村,5,2,決算収支の状況,2,令和3年度,20184960,19570915,614045,151313,462732,-61563,312000,0,220000,30437
2022,61,473251,沖縄県,嘉手納町,5,2,決算収支の状況,2,令和3年度,12217077,11889729,327348,80698,246650,-57724,15255,0,52704,-95173
2022,61,473260,沖縄県,北谷町,5,2,決算収支の状況,2,令和3年度,18696580,17368765,1327815,341202,986613,267698,359511,0,263665,363544
2022,61,473278,沖縄県,北中城村,5,2,決算収支の状況,2,令和3年度,9747197,9373559,373638,54017,319621,165441,77090,0,42362,200169
2022,61,473286,沖縄県,中城村,5,2,決算収支の状況,2,令和3年度,10640317,10221079,419238,85436,333802,-17066,290357,0,174422,98869
2022,61,473294,沖縄県,西原町,5,2,決算収支の状況,2,令和3年度,15615069,14975519,639550,58742,580808,149156,505924,0,267357,387723
2022,61,473481,沖縄県,与那原町,5,2,決算収支の状況,2,令和3年度,10244890,9780467,464423,30383,434040,322757,160697,0,0,483454
2022,61,473502,沖縄県,南風原町,5,2,決算収支の状況,2,令和3年度,18062295,17695756,366539,91908,274631,102817,936309,0,127728,911398
2022,61,473537,沖縄県,渡嘉敷村,5,2,決算収支の状況,2,令和3年度,1759745,1586662,173083,36111,136972,3194,110023,0,24568,88649
2022,61,473545,沖縄県,座間味村,5,2,決算収支の状況,2,令和3年度,2084220,1886074,198146,46438,151708,64030,217201,0,125246,155985
2022,61,473553,沖縄県,粟国村,5,2,決算収支の状況,2,令和3年度,2425628,2193690,231938,46870,185068,130166,295697,0,260905,164958
2022,61,473561,沖縄県,渡名喜村,5,2,決算収支の状況,2,令和3年度,1344395,1232408,111987,31098,80889,13092,40000,0,9566,43526
2022,61,473570,沖縄県,南大東村,5,2,決算収支の状況,2,令和3年度,4002757,3526045,476712,170395,306317,187277,100694,0,0,287971
2022,61,473588,沖縄県,北大東村,5,2,決算収支の状況,2,令和3年度,2865820,2738403,127417,41869,85548,55125,222198,0,25033,252290
2022,61,473596,沖縄県,伊平屋村,5,2,決算収支の状況,2,令和3年度,3251954,2909036,342918,47082,295836,12071,141883,0,161069,-7115
2022,61,473600,沖縄県,伊是名村,5,2,決算収支の状況,2,令和3年度,3650357,3507617,142740,9565,133175,-204452,186000,72587,0,54135
2022,61,473618,沖縄県,久米島町,5,2,決算収支の状況,2,令和3年度,9429896,8920392,509504,62652,446852,-211915,1144613,0,167879,764819
2022,61,473626,沖縄県,八重瀬町,5,2,決算収支の状況,2,令和3年度,18015832,17114694,901138,59250,841888,164418,1093976,0,448930,809464
2022,61,473758,沖縄県,多良間村,5,2,決算収支の状況,2,令和3年度,4210176,3987435,222741,51871,170870,-50184,620194,0,668708,-98698
2022,61,473812,沖縄県,竹富町,5,2,決算収支の状況,2,令和3年度,12911626,12205074,706552,188916,517636,208396,193096,0,0,401492
2022,61,473821,沖縄県,与那国町,5,2,決算収支の状況,2,令和3年度,4832382,4259031,573351,155845,417506,133861,180467,0,200000,114328
2022,61,478032,沖縄県,倉浜衛生施設組合,6,2,決算収支の状況,2,令和3年度,4272567,4172521,100046,21560,78486,1105,144455,0,29995,115565
2022,61,478075,沖縄県,沖縄県市町村自治会館管理組合,6,2,決算収支の状況,2,令和3年度,170997,151127,19870,0,19870,11564,8312,0,27000,-7124
2022,61,478091,沖縄県,本部町今帰仁村清掃施設組合,6,2,決算収支の状況,2,令和3年度,534890,515748,19142,13000,6142,-518,0,0,0,-518
2022,61,478113,沖縄県,本部町・今帰仁村消防組合,6,2,決算収支の状況,2,令和3年度,477470,468364,9106,0,9106,2099,1000,0,0,3099
2022,61,478156,沖縄県,沖縄県市町村総合事務組合,6,2,決算収支の状況,2,令和3年度,7670420,7159248,511172,0,511172,130287,0,0,0,130287
2022,61,478181,沖縄県,島尻消防組合,6,2,決算収支の状況,2,令和3年度,1112332,1103902,8430,1162,7268,-2700,9280,0,27165,-20585
2022,61,478199,沖縄県,東部消防組合,6,2,決算収支の状況,2,令和3年度,2375151,2335387,39764,37006,2758,-114784,47340,0,11955,-79399
2022,61,478229,沖縄県,中城村北中城村清掃事務組合,6,2,決算収支の状況,2,令和3年度,491514,481627,9887,0,9887,-25892,0,0,0,-25892
2022,61,478237,沖縄県,中部衛生施設組合,6,2,決算収支の状況,2,令和3年度,245032,160182,84850,75000,9850,-3483,15625,0,75000,-62858
2022,61,478245,沖縄県,中城北中城消防組合,6,2,決算収支の状況,2,令和3年度,808450,785796,22654,2090,20564,-2376,11470,0,36246,-27152
2022,61,478253,沖縄県,金武地区消防衛生組合,6,2,決算収支の状況,2,令和3年度,968132,932413,35719,0,35719,-7000,0,0,0,-7000
2022,61,478296,沖縄県,国頭地区行政事務組合,6,2,決算収支の状況,2,令和3年度,636386,628621,7765,540,7225,-297,0,0,231,-528
2022,61,478300,沖縄県,南部広域行政組合,6,2,決算収支の状況,2,令和3年度,3107135,2895854,211281,115586,95695,39443,187459,0,158423,68479
2022,61,478351,沖縄県,中部広域市町村圏事務組合,6,2,決算収支の状況,2,令和3年度,245075,203614,41461,0,41461,-5448,3899,0,0,-1549
2022,61,478369,沖縄県,八重山広域市町村圏事務組合,6,2,決算収支の状況,2,令和3年度,508092,110910,397182,384560,12622,8393,2021,0,2550,7864
2022,61,478377,沖縄県,南部広域市町村圏事務組合,6,2,決算収支の状況,2,令和3年度,1464092,1402961,61131,7887,53244,-1263,749,0,4000,-4514
2022,61,478385,沖縄県,北部広域市町村圏事務組合,6,2,決算収支の状況,2,令和3年度,2722304,2710365,11939,3388,8551,-3142,16920,0,35214,-21436
2022,61,478393,沖縄県,比謝川行政事務組合,6,2,決算収支の状況,2,令和3年度,2359194,2291815,67379,19514,47865,2413,85809,0,15898,72324
2022,61,478407,沖縄県,中部北環境施設組合,6,2,決算収支の状況,2,令和3年度,1606185,1546893,59292,0,59292,7127,26145,0,0,33272
2022,61,478423,沖縄県,那覇市・南風原町環境施設組合,6,2,決算収支の状況,2,令和3年度,3421714,3216173,205541,39942,165599,50171,57714,0,57714,50171
2022,61,478431,沖縄県,那覇港管理組合,6,2,決算収支の状況,2,令和3年度,4088101,3726494,361607,164671,196936,102602,94333,0,270383,-73448
2022,61,478440,沖縄県,沖縄県介護保険広域連合,6,2,決算収支の状況,2,令和3年度,1168536,1125143,43393,0,43393,-3774,84941,0,0,81167
2022,61,478458,沖縄県,沖縄県後期高齢者医療広域連合,7,2,決算収支の状況,2,令和3年度,164771,130197,34574,0,34574,-6138,0,0,0,-6138
2022,61,合計(全国),,,,2,決算収支の状況,2,令和3年度,71912638915,68989591158,2923047757,593355139,2329692618,631289645,956635542,131566972,463025812,1256466347
